time,subj_course_id,sec_code,sec_id,prof,available,waitlist,total,enrolled_ct
1739697606708,AAS 10R,A01,807278,Butler; Elizabeth Annette,28,0,34,6
1739697606708,AAS 10R,A02,807279,Butler; Elizabeth Annette,30,0,34,4
1739697607737,AAS 170R,A00,807281,Butler; Elizabeth Annette,26,0,28,2
1739697608773,AESE 261,A00,804942,Staff,30,0,30,0
1739697609802,AESE 278D,A00,804945,Staff,30,0,30,0
1739697610827,AESE 278E,A00,804981,Staff,30,0,30,0
1739697611852,AESE 279A,A00,804985,Staff,30,0,30,0
1739697612878,ANAR 100,A00,872378,Dunseth; Zachary Clark,19,0,20,1
1739697613910,ANAR 104,A01,803045,Shtienberg; Gilad,24,0,25,1
1739697613910,ANAR 104,A02,803066,Shtienberg; Gilad,0,0,0,0
1739697614934,ANAR 111,A00,803067,Dunseth; Zachary Clark,25,0,25,0
1739697615963,ANAR 138,A00,803079,Algaze; Guillermo,12,0,15,3
1739697616993,ANAR 155,A00,803081,Braswell; Geoffrey E.,19,0,25,6
1739697618018,ANBI 111,A00,803085,Staff,22,0,25,3
1739697619044,ANBI 116,A00,803087,Wilder; Linnea Lorene,149,0,150,1
1739697620070,ANBI 139,A00,870761,Gagneux; Pascal,138,0,145,7
1739697621099,ANBI 144,A00,803091,Wilder; Linnea Lorene,70,0,75,5
1739697622126,ANBI 149,A00,803093,Non; Amy L,20,0,20,0
1739697623155,ANBI 174,A00,803096,Strum; Shirley C.,15,0,15,0
1739697624182,ANES 296,001,866120,Suresh; Preetham John,4,0,5,1
1739697624182,ANES 296,002,866141,Staff,5,0,5,0
1739697624182,ANES 296,003,866168,Staff,5,0,5,0
1739697625212,ANSC 100,A00,803098,Bialecki; Jon Anthony,23,0,25,2
1739697625212,ANSC 100,B00,871150,Rabinowitz; Dan,20,0,20,0
1739697626236,ANSC 101,A00,803099,Sloane; Julia Kathryn,35,0,40,5
1739697627261,ANSC 117,A00,803100,Martin Sandino; Amanda Maria Yoland,16,0,18,2
1739697628286,ANSC 134,A00,803104,Petterson; John C.,25,0,25,0
1739697629310,ANSC 137,A00,803105,Stewart; Alexander B,39,0,40,1
1739697630335,ANSC 147,A00,803106,Stewart; Alexander B,36,0,40,4
1739697631359,ANSC 148,A00,803110,Schonberg; Jeffrey,45,0,46,1
1739697632389,ANSC 173,A00,803119,Brenner; Suzanne A,10,0,12,2
1739697633415,ANSC 180,A00,803121,Hankins; Joseph D.,22,0,25,3
1739697634442,ANSC 191,A00,803124,Yeh; Rihan Wen Xin,11,0,12,1
1739697635477,ANTH 2,A01,803000,Marchetto; Maria Carolina,32,0,33,1
1739697635477,ANTH 2,A02,803001,Marchetto; Maria Carolina,32,0,33,1
1739697635477,ANTH 2,A03,803005,Marchetto; Maria Carolina,30,0,33,3
1739697635477,ANTH 2,A04,803006,Marchetto; Maria Carolina,30,0,33,3
1739697635477,ANTH 2,A05,803007,Marchetto; Maria Carolina,33,0,33,0
1739697635477,ANTH 2,A06,803008,Marchetto; Maria Carolina,31,0,31,0
1739697636508,ANTH 3,A01,803012,Algaze; Guillermo,30,0,30,0
1739697636508,ANTH 3,A02,803013,Algaze; Guillermo,30,0,30,0
1739697636508,ANTH 3,A03,803015,Algaze; Guillermo,30,0,30,0
1739697636508,ANTH 3,A04,803016,Algaze; Guillermo,30,0,30,0
1739697637536,ANTH 4,A01,803020,Yeh; Rihan Wen Xin,27,0,30,3
1739697637536,ANTH 4,A02,803021,Yeh; Rihan Wen Xin,30,0,30,0
1739697637536,ANTH 4,A03,803022,Yeh; Rihan Wen Xin,30,0,30,0
1739697637536,ANTH 4,A04,803024,Yeh; Rihan Wen Xin,30,0,30,0
1739697638567,ANTH 10,A00,803025,Stewart; Alexander B,73,0,80,7
1739697639597,ANTH 21,A01,803027,Stone; Annika Britt,38,0,40,2
1739697639597,ANTH 21,A02,803030,Stone; Annika Britt,36,0,40,4
1739697639597,ANTH 21,A03,803031,Stone; Annika Britt,39,0,40,1
1739697639597,ANTH 21,A04,803032,Stone; Annika Britt,39,0,40,1
1739697640623,ANTH 23,A01,803034,Stone; Annika Britt,39,0,40,1
1739697640623,ANTH 23,A02,803036,Stone; Annika Britt,39,0,40,1
1739697640623,ANTH 23,A03,803037,Stone; Annika Britt,40,0,40,0
1739697640623,ANTH 23,A04,803038,Stone; Annika Britt,40,0,40,0
1739697641661,ANTH 87,A00,875928,Staff,20,0,20,0
1739697642687,ANTH 103,A00,803126,Hankins; Joseph D.,98,0,100,2
1739697643716,ANTH 105,A00,803130,Rabinowitz; Dan,73,0,75,2
1739697644741,ANTH 109,A00,803133,Staff,38,0,40,2
1739697645769,ANTH 110,A00,803135,Staff,15,0,20,5
1739697646795,ANTH 128B,A01,803139,Lewis; Leslie R,12,0,12,0
1739697647821,ANTH 196C,A00,803147,Varma; Saiba,20,0,20,0
1739697648856,ANTH 198,001,886925,Varma; Saiba,15,0,15,0
1739697649884,ANTH 200,A00,803150,Pedersen; David,15,0,15,0
1739697650925,ANTH 230,A00,889211,Gagneux; Pascal,17,0,20,3
1739697651955,ANTH 272,A00,803155,Gere; Catherina M.,9,0,10,1
1739697652979,ANTH 273,A00,803158,McKenzie; Kerry V.,10,0,10,0
1739697654004,ANTH 288,A00,803189,Braswell; Geoffrey E.,25,0,25,0
1739697655037,ANTH 295,001,887807,Algaze; Guillermo,3,0,3,0
1739697655037,ANTH 295,002,887809,Braswell; Geoffrey E.,3,0,3,0
1739697655037,ANTH 295,003,887890,Brenner; Suzanne A,3,0,3,0
1739697655037,ANTH 295,004,887891,Csordas; Thomas J.,3,0,3,0
1739697655037,ANTH 295,005,887909,Fox; Patrick Keolu Ozer,3,0,3,0
1739697655037,ANTH 295,006,887940,Gagneux; Pascal,3,0,3,0
1739697655037,ANTH 295,007,887941,Goldstein; Paul S,3,0,3,0
1739697655037,ANTH 295,008,887942,Hankins; Joseph D.,3,0,3,0
1739697655037,ANTH 295,009,887948,Jassal; Aftab,3,0,3,0
1739697655037,ANTH 295,010,887949,Jenkins; Janis A.,3,0,3,0
1739697655037,ANTH 295,011,887950,Jimenez Cano; Nayeli Guada,3,0,3,0
1739697655037,ANTH 295,012,887951,Kaiser; Bronwyn Nicole,3,0,3,0
1739697655037,ANTH 295,013,887955,Kang; Byung Chu,3,0,3,0
1739697655037,ANTH 295,014,887957,Marchetto; Maria Carolina,3,0,3,0
1739697655037,ANTH 295,015,887960,Non; Amy L,3,0,3,0
1739697655037,ANTH 295,016,887961,Pedersen; David,3,0,3,0
1739697655037,ANTH 295,017,887962,Rivera-Collazo; Isabel C,3,0,3,0
1739697655037,ANTH 295,018,887963,Varma; Saiba,3,0,3,0
1739697655037,ANTH 295,019,887969,Yeh; Rihan Wen Xin,3,0,3,0
1739697656067,ANTH 296,001,888015,Braswell; Geoffrey E.,3,0,3,0
1739697656067,ANTH 296,002,888024,Marchetto; Maria Carolina,3,0,3,0
1739697656067,ANTH 296,003,888035,Rivera-Collazo; Isabel C,3,0,3,0
1739697656067,ANTH 296,004,888050,Varma; Saiba,3,0,3,0
1739697656067,ANTH 296,005,888055,Algaze; Guillermo,3,0,3,0
1739697656067,ANTH 296,006,888067,Brenner; Suzanne A,3,0,3,0
1739697656067,ANTH 296,007,888075,Csordas; Thomas J.,3,0,3,0
1739697656067,ANTH 296,008,888081,Fox; Patrick Keolu Ozer,3,0,3,0
1739697656067,ANTH 296,009,888084,Gagneux; Pascal,3,0,3,0
1739697656067,ANTH 296,010,888086,Goldstein; Paul S,2,0,3,1
1739697656067,ANTH 296,011,888089,Hankins; Joseph D.,3,0,3,0
1739697656067,ANTH 296,012,888093,Jassal; Aftab,3,0,3,0
1739697656067,ANTH 296,013,888095,Jenkins; Janis A.,3,0,3,0
1739697656067,ANTH 296,014,888099,Jimenez Cano; Nayeli Guada,3,0,3,0
1739697656067,ANTH 296,015,888101,Kaiser; Bronwyn Nicole,3,0,3,0
1739697656067,ANTH 296,016,888102,Kang; Byung Chu,3,0,3,0
1739697656067,ANTH 296,017,888106,Levy; Thomas E,3,0,3,0
1739697656067,ANTH 296,018,888109,Non; Amy L,3,0,3,0
1739697656067,ANTH 296,019,888111,Pedersen; David,3,0,3,0
1739697656067,ANTH 296,020,888112,Postero; Nancy Grey,3,0,3,0
1739697656067,ANTH 296,021,888116,Semendeferi; Ekaterini,3,0,3,0
1739697656067,ANTH 296,022,888118,Yeh; Rihan Wen Xin,3,0,3,0
1739697657099,ASTR 2,A01,803214,Nadler; Ethan Oliver,296,0,300,4
1739697658126,ASTR 15,A01,803221,Wright; Shelley Adams,47,0,50,3
1739697659155,ASTR 18,A01,803234,Arnold; Kam S,30,0,30,0
1739697660181,ASTR 60,A01,803300,Burgasser; Adam Jonathan,14,0,15,1
1739697660181,ASTR 60,A02,803301,Burgasser; Adam Jonathan,15,0,15,0
1739697660181,ASTR 60,A03,803302,Burgasser; Adam Jonathan,15,0,15,0
1739697660181,ASTR 60,A04,803303,Burgasser; Adam Jonathan,15,0,15,0
1739697661210,ASTR 87,A00,871154,Burgasser; Adam Jonathan,20,0,20,0
1739697662236,ASTR 103,A01,803305,Diamond; Patrick H,30,0,30,0
1739697663260,ASTR 106,A01,803307,Boggs; Steven Edward,30,0,30,0
1739697664289,ASTR 123,A01,803343,Keres; Dusan,35,0,39,4
1739697665316,ASTR 154,A01,803345,Hosseinzadeh; Griffin Alex,40,0,40,0
1739697666343,ASTR 211,A00,803346,Broekgaarden; Floor Suzan,12,0,15,3
1739697667373,ASTR 250,A00,803347,Theissen; Christopher Alexander & Hosseinzadeh; Griffin Alex,26,0,30,4
1739697668401,ASTR 251,A00,803359,Theissen; Christopher Alexander & Hosseinzadeh; Griffin Alex,28,0,30,2
1739697669427,AUD 236,A00,804989,Harris; Jeffrey Paul,5,0,5,0
1739697670454,AUD 260,A01,804994,Zettner; Erika,13,0,13,0
1739697671477,AUD 272,A00,804997,Zettner; Erika,13,0,13,0
1739697672505,AUD 275,A00,805001,Zettner; Erika,13,0,13,0
1739697673530,AUD 284,A00,805004,Zettner; Erika,13,0,13,0
1739697674555,AUD 291,A00,805008,Zettner; Erika,13,0,13,0
1739697675583,AUD 296,A00,805013,Zettner; Erika,6,0,6,0
1739697676614,AWP 3,001,802590,O'Neil; Courtney L,9,0,9,0
1739697676614,AWP 3,002,802591,O'Neil; Courtney L,9,0,9,0
1739697676614,AWP 3,003,802592,Kolodezh; Samuel,8,0,9,1
1739697676614,AWP 3,004,802593,Zimmerman; Guy,9,0,9,0
1739697676614,AWP 3,005,802594,Vaughn; Kelsey Sara,9,0,9,0
1739697676614,AWP 3,006,802595,Vaughn; Kelsey Sara,9,0,9,0
1739697676614,AWP 3,007,802597,Given; William Allan,9,0,9,0
1739697677641,AWP 4A,A00,802601,Ajo; Frances Margaret,10,0,10,0
1739697677641,AWP 4A,B00,802602,Ajo; Frances Margaret,9,0,10,1
1739697677641,AWP 4A,C00,880738,Bauer; Holly Jean,10,0,10,0
1739697678677,AWP 4B,001,802603,Steinberg; Stacy A,0,0,0,0
1739697678677,AWP 4B,002,802604,Steinberg; Stacy A,0,0,0,2
1739697678677,AWP 4B,003,802605,Gilmore; Lauren Monica,0,0,0,1
1739697678677,AWP 4B,004,802606,Gilmore; Lauren Monica,0,0,0,0
1739697678677,AWP 4B,007,802609,Bolin; Jillian,0,0,0,0
1739697678677,AWP 4B,008,802610,Bolin; Jillian,0,0,0,0
1739697678677,AWP 4B,009,802611,Zroka; Amy Liane,0,0,0,0
1739697678677,AWP 4B,010,802612,Zroka; Amy Liane,0,0,0,0
1739697678677,AWP 4B,011,802614,Christie; Veronica Ann,0,0,0,0
1739697678677,AWP 4B,012,802672,Christie; Veronica Ann,0,0,0,0
1739697678677,AWP 4B,013,802673,Jones; William Jadie,0,0,0,0
1739697678677,AWP 4B,014,802676,Jones; William Jadie,0,0,0,1
1739697678677,AWP 4B,015,802677,Heiser; Jerrod A,0,0,0,0
1739697678677,AWP 4B,016,802679,Heiser; Jerrod A,0,0,0,1
1739697678677,AWP 4B,017,802683,Bourdeau; Joseph Albert,0,0,0,0
1739697678677,AWP 4B,018,802684,Bourdeau; Joseph Albert,0,0,0,1
1739697678677,AWP 4B,019,802690,Wilson; Natalie Ann,0,0,0,0
1739697678677,AWP 4B,020,802691,Wilson; Natalie Ann,0,0,0,0
1739697678677,AWP 4B,021,802692,Stanton; Jennifer K,0,0,0,0
1739697678677,AWP 4B,022,802693,Stanton; Jennifer K,0,0,0,1
1739697678677,AWP 4B,023,802696,Riggle; Amanda L,0,0,0,1
1739697678677,AWP 4B,024,802699,Riggle; Amanda L,0,0,0,0
1739697678677,AWP 4B,025,802702,Homenick; Erik Christopher,0,0,0,0
1739697678677,AWP 4B,026,802703,Homenick; Erik Christopher,0,0,0,0
1739697678677,AWP 4B,027,802705,Ornelas Jr.; David Paul,0,0,0,0
1739697678677,AWP 4B,028,802706,Grant; Melinda G,0,0,0,0
1739697678677,AWP 4B,029,802707,Grant; Melinda G,0,0,0,0
1739697678677,AWP 4B,030,802708,Ornelas Jr.; David Paul,0,0,0,0
1739697678677,AWP 4B,031,802709,Falcon; Jennifer A,0,0,0,0
1739697678677,AWP 4B,032,802710,Falcon; Jennifer A,0,0,0,0
1739697678677,AWP 4B,033,802711,Westerfeld; Kevin John,0,0,0,0
1739697678677,AWP 4B,034,802712,Tiernan; Christa Michelle,0,0,0,0
1739697678677,AWP 4B,035,802714,Tiernan; Christa Michelle,0,0,0,0
1739697678677,AWP 4B,036,802980,Westerfeld; Kevin John,0,0,0,0
1739697678677,AWP 4B,038,802982,Gardella; Alexander Drew,0,0,0,0
1739697678677,AWP 4B,039,802983,Gardella; Alexander Drew,0,0,0,0
1739697678677,AWP 4B,040,802985,Coulter; Jane Elisabeth,0,0,0,0
1739697678677,AWP 4B,041,802986,Spicer; Jacqueline,0,0,0,0
1739697678677,AWP 4B,042,802987,Spicer; Jacqueline,0,0,0,0
1739697678677,AWP 4B,043,802989,Tsurska Svetina; Olena,0,0,0,0
1739697678677,AWP 4B,044,802990,Tsurska Svetina; Olena,0,0,0,1
1739697678677,AWP 4B,045,802991,Chandler; Bailee Daniele,0,0,0,0
1739697678677,AWP 4B,046,802993,Chandler; Bailee Daniele,0,0,0,1
1739697678677,AWP 4B,047,802994,Hall; Graham T,0,0,0,0
1739697678677,AWP 4B,048,802995,Hall; Graham T,0,0,0,0
1739697679707,AWP 10R,001,871136,Gocsik; Karen Marie,13,0,15,2
1739697680735,BENG 87,A00,886240,Sah; Robert Lie-Yuan,20,0,20,0
1739697680735,BENG 87,B00,886257,Sah; Robert Lie-Yuan,20,0,20,0
1739697681766,BENG 100,A01,805026,Alexandrov; Ludmil B,30,0,30,0
1739697681766,BENG 100,A02,805028,Alexandrov; Ludmil B,29,0,30,1
1739697681766,BENG 100,A03,805030,Alexandrov; Ludmil B,30,0,30,0
1739697681766,BENG 100,A04,805031,Alexandrov; Ludmil B,29,0,30,1
1739697682793,BENG 102,A00,805032,Chapelin; Fanny,52,0,56,4
1739697683825,BENG 103B,A00,805039,Fraley; Stephanie I.,116,0,120,4
1739697684852,BENG 112B,A01,805055,Shi; Lingyan,22,0,23,1
1739697684852,BENG 112B,A02,805056,Shi; Lingyan,20,0,23,3
1739697685880,BENG 125,A01,805058,Hasty; Jeff M,14,0,32,18
1739697685880,BENG 125,A02,805059,Hasty; Jeff M,31,0,32,1
1739697685880,BENG 125,A03,805060,Hasty; Jeff M,31,0,32,1
1739697685880,BENG 125,A04,805102,Hasty; Jeff M,32,0,32,0
1739697685880,BENG 125,A05,805109,Hasty; Jeff M,19,0,32,13
1739697686904,BENG 130,A00,805118,Kravets; Vira V.,37,0,40,3
1739697687936,BENG 134,A01,805171,Smarr; Benjamin,34,0,40,6
1739697688962,BENG 140B,A01,805175,Cabrales; Pedro,27,0,30,3
1739697688962,BENG 140B,A02,805176,Cabrales; Pedro,29,0,30,1
1739697688962,BENG 140B,A03,805177,Cabrales; Pedro,28,0,30,2
1739697689988,BENG 160,A50,805180,Aguado; Brian Alberto,18,0,25,7
1739697689988,BENG 160,A51,805181,Aguado; Brian Alberto,23,0,25,2
1739697689988,BENG 160,A52,805182,Aguado; Brian Alberto,25,0,25,0
1739697691015,BENG 168,A01,805184,Khojah; Reem I,30,0,30,0
1739697692041,BENG 172,A50,805187,Cabrales; Pedro & Sah; Robert Lie-Yuan,13,0,20,7
1739697692041,BENG 172,A51,805188,Cabrales; Pedro & Sah; Robert Lie-Yuan,19,0,20,1
1739697693068,BENG 182,A01,805190,Bafna; Vineet,29,0,35,6
1739697694100,BENG 186A,A01,805192,Kwon; Ester Jihae,0,0,25,25
1739697694100,BENG 186A,A02,805193,Kwon; Ester Jihae,23,0,25,2
1739697694100,BENG 186A,A04,805195,Kwon; Ester Jihae,17,0,25,8
1739697695127,BENG 186B,A01,805230,Aran; Kiana,39,0,40,1
1739697696162,BENG 187A,A00,805231,Taylor Amos; Alyssa C,152,0,170,18
1739697697189,BENG 187D,A00,805243,Taylor Amos; Alyssa C,34,0,60,26
1739697697189,BENG 187D,B00,805249,Taylor Amos; Alyssa C,50,0,60,10
1739697697189,BENG 187D,C00,805286,Taylor Amos; Alyssa C,41,0,60,19
1739697698219,BENG 190,A00,872568,Khojah; Reem I,24,0,40,16
1739697699246,BENG 193,A00,805288,Engler; Adam J.,0,0,0,0
1739697700270,BENG 196,A00,803380,Engler; Adam J.,9999,0,9999,0
1739697701351,BENG 197,A00,803381,Engler; Adam J.,9999,0,9999,0
1739697702378,BENG 203,A00,805307,Bafna; Vineet & Zhong; Sheng,20,0,20,0
1739697703408,BENG 207,A00,805308,Kwon; Ester Jihae,1,0,40,39
1739697703408,BENG 207,B00,805309,Taylor Amos; Alyssa C,0,0,30,30
1739697703408,BENG 207,C00,805310,Spang; Martin Thomas,15,0,40,25
1739697704439,BENG 209,A00,805311,Scholtes Acevedo; Claire,30,0,30,0
1739697705464,BENG 213,A00,805312,Palsson; Bernhard O.,16,0,20,4
1739697706492,BENG 224,A00,805313,Prado; Gustavo Rotelli,0,0,20,30
1739697707517,BENG 226,A01,805315,Staff,74,0,140,66
1739697708545,BENG 227,A00,805316,Fraley; Stephanie I.,42,0,120,78
1739697709574,BENG 230C,A00,805318,King; Kevin R,59,0,90,31
1739697710600,BENG 232,A01,805320,Sah; Robert Lie-Yuan,16,0,70,54
1739697711629,BENG 233,A00,805364,Shah; Sameer B,21,0,50,29
1739697712656,BENG 234,A00,805365,Silva; Gabriel,22,0,70,48
1739697713682,BENG 235,A00,805366,Bintu; Bogdan,18,0,40,22
1739697714709,BENG 276,A00,805367,Mc Culloch; Andrew Douglas,0,0,0,0
1739697715737,BENG 280C,A01,805370,McVeigh; Elliot R.,37,0,56,19
1739697716764,BENG 281,A00,805371,Smarr; Benjamin,40,0,110,70
1739697717793,BENG 283,A00,805372,Ghassemian; Majid & Sanchez Roige; Alexandra & Chavez; Alejandro,5,0,5,0
1739697718820,BENG 285,A00,805374,Alexandrov; Ludmil B,8,0,8,0
1739697719848,BENG 292,A01,805387,Ross; Camille,20,0,20,0
1739697720873,BENG 294C,A00,805396,Engler; Adam J.,0,0,0,0
1739697721899,BENG 295,A00,803924,Watson; John Thomas,9999,0,9999,0
1739697722928,BGGN 205,A00,851551,Daugherty; Matthew Dorton,53,0,60,7
1739697723956,BGGN 207,A01,851553,Ross; Camille,0,0,0,0
1739697724980,BGGN 215,A00,851554,Petrie; Katherine Lynn,0,0,30,30
1739697726008,BGGN 232,A00,851556,Briggs; Steven & Troemel; Emily Ruth,0,0,30,30
1739697727035,BGGN 239,A01,851558,Kronenberg; Mitchell E.,22,0,30,8
1739697728062,BGGN 240,A01,851560,Aoi; Mikio C,1,0,5,4
1739697728062,BGGN 240,A02,851561,Aoi; Mikio C,5,0,5,0
1739697728062,BGGN 240,A03,851562,Aoi; Mikio C,2,0,5,3
1739697728062,BGGN 240,A04,851564,Aoi; Mikio C,4,0,5,1
1739697729089,BGGN 249C,A00,851566,Miller; Cory T.,0,0,0,0
1739697730115,BGGN 255,A00,851567,Root; Cory Matthew,9,0,30,21
1739697731148,BGGN 267,A01,851569,Benna; Marcus K & Aljadeff; Johnatan,0,0,2,2
1739697731148,BGGN 267,A02,851570,Benna; Marcus K & Aljadeff; Johnatan,2,0,2,0
1739697731148,BGGN 267,A03,851571,Benna; Marcus K & Aljadeff; Johnatan,1,0,1,0
1739697731148,BGGN 267,A04,851572,Benna; Marcus K & Aljadeff; Johnatan,1,0,1,0
1739697732361,BGGN 271,001,881551,Ackerman; Susan,9999,0,9999,0
1739697732361,BGGN 271,002,881552,Akbari; Omar Sultan,9997,0,9999,2
1739697732361,BGGN 271,003,881553,Allen; Nicola J,9998,0,9999,1
1739697732361,BGGN 271,004,881554,Alperin; Mariann,9998,0,9999,1
1739697732361,BGGN 271,005,881555,Antal; Corina Elena,9999,0,9999,0
1739697732361,BGGN 271,006,881561,Boss; Gerard R.,9998,0,9999,1
1739697732361,BGGN 271,007,881562,Bouvet; Michael,9999,0,9999,0
1739697732361,BGGN 271,008,881563,Breen; Ellen C.,9999,0,9999,0
1739697732361,BGGN 271,009,881564,Bui; Jack D,9999,0,9999,0
1739697732361,BGGN 271,010,881565,Burnett; Lindsey,9998,0,9999,1
1739697732361,BGGN 271,011,881566,Caffrey; Conor,9998,0,9999,1
1739697732361,BGGN 271,012,881567,Castle; Michael James,9998,0,9999,1
1739697732361,BGGN 271,013,881568,Chang; John Tzu-yu,9999,0,9999,0
1739697732361,BGGN 271,014,881569,Cheng; Christine Shiang-Ling,9999,0,9999,0
1739697732361,BGGN 271,015,881612,Cheresh; David A.,9997,0,9999,2
1739697732361,BGGN 271,016,881616,Cherqui; Stephanie,9999,0,9999,0
1739697732361,BGGN 271,017,881620,Chu; Hiutung,9998,0,9999,1
1739697732361,BGGN 271,018,881627,Church; Kellie Breen,9999,0,9999,0
1739697732361,BGGN 271,019,881637,Cleland; Elsa Eleanor,9998,0,9999,1
1739697732361,BGGN 271,020,881638,Croker; Ben Adam,9999,0,9999,0
1739697732361,BGGN 271,021,881639,Crotty Alexander; Laura E,9997,0,9999,2
1739697732361,BGGN 271,022,881640,Daugherty; Matthew Dorton,9999,0,9999,0
1739697732361,BGGN 271,023,881641,De Silva; Shermin,9998,0,9999,1
1739697732361,BGGN 271,024,881642,Dhar; Debanjan,9999,0,9999,0
1739697732361,BGGN 271,025,881643,Doherty; Taylor Alan,9998,0,9999,1
1739697732361,BGGN 271,026,881644,Dore; Kim Bohemie,9998,0,9999,1
1739697732361,BGGN 271,027,881645,Dulawa; Stephanie Carole,9999,0,9999,0
1739697732361,BGGN 271,028,881646,Farley; Emma Kristen,9998,0,9999,1
1739697732361,BGGN 271,029,881647,Feng; Gen-Sheng,9998,0,9999,1
1739697732361,BGGN 271,030,881648,Fisch; Kathleen Marie,9995,0,9999,4
1739697732361,BGGN 271,031,881649,George; Olivier,9998,0,9999,1
1739697732361,BGGN 271,032,881650,Ghosh; Pradipta,9998,0,9999,1
1739697732361,BGGN 271,033,881651,Glasgow; Stacey Marie,9997,0,9999,2
1739697732361,BGGN 271,034,881652,Golden; James W,9999,0,9999,0
1739697732361,BGGN 271,035,881653,Gonzalez Gamboa; Ivonne,9999,0,9999,0
1739697732361,BGGN 271,036,881654,Goren; Alon M,9999,0,9999,0
1739697732361,BGGN 271,037,881655,Guatelli; John C,9998,0,9999,1
1739697732361,BGGN 271,038,881656,Guma; Monica,9999,0,9999,0
1739697732361,BGGN 271,039,881657,Gustafsson; Asa Birgitta,9998,0,9999,1
1739697732361,BGGN 271,040,881658,Hamdoun; Amr,9999,0,9999,0
1739697732361,BGGN 271,041,881659,Hao; Nan,9999,0,9999,0
1739697732361,BGGN 271,042,881660,Hasty; Jeff M,9998,0,9999,1
1739697732361,BGGN 271,043,881661,Jiang; Qingfei,9999,0,9999,0
1739697732361,BGGN 271,044,881664,Jin; Yishi,9998,0,9999,1
1739697732361,BGGN 271,045,881665,Joiner; William J.,9999,0,9999,0
1739697732361,BGGN 271,046,881666,Joshi; Shweta,9998,0,9999,1
1739697732361,BGGN 271,047,881667,Ju; Won-Kyu,9998,0,9999,1
1739697732361,BGGN 271,048,881668,Jun; Suckjoon,9999,0,9999,0
1739697732361,BGGN 271,049,881669,Kaech; Susan Michelle,9999,0,9999,0
1739697732361,BGGN 271,050,881670,Kauffman; Alexander,9997,0,9999,2
1739697732361,BGGN 271,051,881672,Koloski; Miranda Jane,9998,0,9999,1
1739697732361,BGGN 271,052,881673,Komiyama; Takaki,9998,0,9999,1
1739697732361,BGGN 271,053,881674,Kronenberg; Mitchell E.,9999,0,9999,0
1739697732361,BGGN 271,054,881675,Kufareva; Irina,9998,0,9999,1
1739697732361,BGGN 271,055,881676,Lee; Yun Sok,9999,0,9999,0
1739697732361,BGGN 271,056,881677,Leutgeb; Stefan,9999,0,9999,0
1739697732361,BGGN 271,057,881678,Li; Willis Xiaowei,9998,0,9999,1
1739697732361,BGGN 271,058,881679,Lim; Byungkook,9999,0,9999,0
1739697732361,BGGN 271,059,881680,Lo; Stanley M.,9998,0,9999,1
1739697732361,BGGN 271,060,881681,Lopez Ramirez; Miguel Alej,9999,0,9999,0
1739697732361,BGGN 271,061,881740,Lu; Li-Fan,9999,0,9999,0
1739697732361,BGGN 271,062,881741,Lu; Pengzhe,9998,0,9999,1
1739697732361,BGGN 271,063,881743,Lyons; Deirdre Colleen,9998,0,9999,1
1739697732361,BGGN 271,064,881744,Lyumkis; Dmitry Evgenievich,9999,0,9999,0
1739697732361,BGGN 271,065,881746,McConville; Patrick James,9999,0,9999,0
1739697732361,BGGN 271,066,881749,Mertens; Jerome Stefan,9997,0,9999,2
1739697732361,BGGN 271,067,881751,Morris; Gerald P,9999,0,9999,0
1739697732361,BGGN 271,068,881752,Muroyama; Andrew David,9999,0,9999,0
1739697732361,BGGN 271,069,881757,Murre; Cornelis,9999,0,9999,0
1739697732361,BGGN 271,070,881758,Nieh; James Charles,9997,0,9999,2
1739697732361,BGGN 271,071,881759,Niwa; Maho,9999,0,9999,0
1739697732361,BGGN 271,072,881760,Parast; Mana,9999,0,9999,0
1739697732361,BGGN 271,073,881761,Perry; Michael William,9999,0,9999,0
1739697732361,BGGN 271,074,881762,Pillus; Lorraine,9998,0,9999,1
1739697732361,BGGN 271,075,881765,Pogliano; Joseph,9998,0,9999,1
1739697732361,BGGN 271,076,881767,Pruneda-Paz; Jose L.,9999,0,9999,0
1739697732361,BGGN 271,077,881768,Rana; Tariq,9999,0,9999,0
1739697732361,BGGN 271,078,881769,Rao; Anjana,9999,0,9999,0
1739697732361,BGGN 271,079,881771,Raz; Eyal,9998,0,9999,1
1739697732361,BGGN 271,080,881772,Ren; Bing,9999,0,9999,0
1739697732361,BGGN 271,081,881775,Rifkin; Scott,9998,0,9999,1
1739697732361,BGGN 271,082,881777,Risbrough; Victoria Blythe,9999,0,9999,0
1739697732361,BGGN 271,083,881778,Rose; Noah Hartmann,9999,0,9999,0
1739697732361,BGGN 271,084,881779,Saier; Milton H.,9998,0,9999,1
1739697732361,BGGN 271,085,881781,Saltiel; Alan,9997,0,9999,2
1739697732361,BGGN 271,086,881782,Sanchez-Lopez; Elsa,9998,0,9999,1
1739697732361,BGGN 271,087,881784,Schroeder; Julian I,9999,0,9999,0
1739697732361,BGGN 271,088,881794,Sebat; Lilia Mikhailovna,9998,0,9999,1
1739697732361,BGGN 271,089,881796,Sen; George L,9999,0,9999,0
1739697732361,BGGN 271,090,881797,Shaner; Nathan C.,9999,0,9999,0
1739697732361,BGGN 271,091,881804,Shurin; Jonathan,9998,0,9999,1
1739697732361,BGGN 271,092,881819,Sicklick; Jason Keith,9999,0,9999,0
1739697732361,BGGN 271,093,881908,Signer; Robert,9999,0,9999,0
1739697732361,BGGN 271,094,881909,Simonson; Tatum Sasha Summ,9999,0,9999,0
1739697732361,BGGN 271,095,881923,Steinmetz; Nicole F,9999,0,9999,0
1739697732361,BGGN 271,096,881924,Su; Chih-Ying,9999,0,9999,0
1739697732361,BGGN 271,097,881936,Telese; Francesca,9999,0,9999,0
1739697732361,BGGN 271,098,881955,Towers; Christina Garlingt,9998,0,9999,1
1739697732361,BGGN 271,099,881956,Wahlin; Karl Jonas,9997,0,9999,2
1739697732361,BGGN 271,100,882046,Webster; Nicholas J G,9998,0,9999,1
1739697732361,BGGN 271,101,882047,Weiskopf; Daniela,9999,0,9999,0
1739697732361,BGGN 271,102,882130,Welsbie; Derek,9999,0,9999,0
1739697732361,BGGN 271,103,882167,Wildonger; Jill Cathleen,9999,0,9999,0
1739697732361,BGGN 271,104,882168,Yeo; Eugene Wei-Ming,9998,0,9999,1
1739697732361,BGGN 271,105,882175,Ying; Wei,9998,0,9999,1
1739697732361,BGGN 271,106,882196,Young; Jared W.,9998,0,9999,1
1739697732361,BGGN 271,107,882235,Zage; Peter,9999,0,9999,0
1739697732361,BGGN 271,108,882236,Zengler; Karsten B,9999,0,9999,0
1739697732361,BGGN 271,109,882237,Zhang; Jin,9999,0,9999,0
1739697732361,BGGN 271,110,882238,Zhao; Yunde,9999,0,9999,0
1739697732361,BGGN 271,111,882239,Zheng; Ye,9998,0,9999,1
1739697732361,BGGN 271,112,882288,Zhou; Huilin,9999,0,9999,0
1739697732361,BGGN 271,113,882289,Zou; Yimin,9998,0,9999,1
1739697732361,BGGN 271,114,882290,Zuniga; Elina I,9999,0,9999,0
1739697733515,BGGN 273,A01,851574,Mueller; Liam O'Connor,13,0,50,37
1739697734543,BGGN 275,A00,851577,Flagg; Matthew Paul,0,0,0,5
1739697735570,BGGN 276,A00,851578,Flagg; Matthew Paul,0,0,0,5
1739697736601,BGGN 292,A00,851579,Shiau; Andrew K,35,0,35,0
1739697737631,BGGN 293,A00,851580,Wilhelm; James E.,0,0,0,5
1739697738656,BGGN 295,A00,851581,Juavinett; Ashley Lauren,0,0,30,30
1739697739682,BGJC 204,A00,851584,Lu; Li-Fan & Chang; John Tzu-yu,9991,0,9999,8
1739697740783,BGRD 200,001,883698,Ackerman; Susan,9999,0,9999,0
1739697740783,BGRD 200,002,883700,Akbari; Omar Sultan,9998,0,9999,1
1739697740783,BGRD 200,003,883710,Allen; Eric,9999,0,9999,0
1739697740783,BGRD 200,004,883736,Allen; Nicola J,9998,0,9999,1
1739697740783,BGRD 200,005,883737,Alperin; Mariann,9998,0,9999,1
1739697740783,BGRD 200,006,883765,Amaro; Rommie E,9999,0,9999,0
1739697740783,BGRD 200,007,883766,Antal; Corina Elena,9999,0,9999,0
1739697740783,BGRD 200,008,883827,Asahina; Kenta,9999,0,9999,0
1739697740783,BGRD 200,009,883879,Augustine; Vineet,9999,0,9999,0
1739697740783,BGRD 200,010,883881,Ayres; Janelle Samantha,9998,0,9999,1
1739697740783,BGRD 200,011,883883,Banghart; Matthew Ryan,9999,0,9999,0
1739697740783,BGRD 200,012,883884,Barton; Andrew David,9999,0,9999,0
1739697740783,BGRD 200,013,883886,Benna; Marcus K,9999,0,9999,0
1739697740783,BGRD 200,014,883887,Bennett; Eric J,9998,0,9999,1
1739697740783,BGRD 200,015,883888,Biering; Scott B,9999,0,9999,0
1739697740783,BGRD 200,016,883890,Bloodgood; Brenda Laurie,9999,0,9999,0
1739697740783,BGRD 200,017,883891,Boss; Gerard R.,9999,0,9999,0
1739697740783,BGRD 200,018,883893,Bouvet; Michael,9999,0,9999,0
1739697740783,BGRD 200,019,883894,Breen; Ellen C.,9999,0,9999,0
1739697740783,BGRD 200,020,883895,Briggs; Steven,9999,0,9999,0
1739697740783,BGRD 200,021,883896,Bui; Jack D,9999,0,9999,0
1739697740783,BGRD 200,022,883897,Burnett; Lindsey,9998,0,9999,1
1739697740783,BGRD 200,023,883899,Caffrey; Conor,9998,0,9999,1
1739697740783,BGRD 200,024,883908,Callaway; Edward M,9999,0,9999,0
1739697740783,BGRD 200,025,883911,Castle; Michael James,9999,0,9999,0
1739697740783,BGRD 200,026,883915,Chaim; Isaac,9998,0,9999,1
1739697740783,BGRD 200,027,883916,Chang; John Tzu-yu,9999,0,9999,0
1739697740783,BGRD 200,028,883917,Chen; Xu,9999,0,9999,0
1739697740783,BGRD 200,029,883919,Cheng; Christine Shiang-Ling,9999,0,9999,0
1739697740783,BGRD 200,030,883921,Cheresh; David A.,9997,0,9999,2
1739697740783,BGRD 200,031,883924,Cherqui; Stephanie,9999,0,9999,0
1739697740783,BGRD 200,032,883929,Chu; Hiutung,9998,0,9999,1
1739697740783,BGRD 200,033,883931,Church; Kellie Breen,9999,0,9999,0
1739697740783,BGRD 200,034,883933,Cleland; Elsa Eleanor,9998,0,9999,1
1739697740783,BGRD 200,035,883934,Cooper; Kimberly Lynn,9999,0,9999,0
1739697740783,BGRD 200,036,883935,Coufal; Nicole Gabriele,9999,0,9999,0
1739697740783,BGRD 200,037,883938,Croker; Ben Adam,9999,0,9999,0
1739697740783,BGRD 200,038,883939,Crotty Alexander; Laura E,9997,0,9999,2
1739697740783,BGRD 200,039,883940,Daugherty; Matthew Dorton,9999,0,9999,0
1739697740783,BGRD 200,040,883941,De Silva; Shermin,9998,0,9999,1
1739697740783,BGRD 200,041,883946,Desai; Arshad,9999,0,9999,0
1739697740783,BGRD 200,042,883949,Dhar; Debanjan,9999,0,9999,0
1739697740783,BGRD 200,043,883993,Dickinson; Alexandra Jazz,9999,0,9999,0
1739697740783,BGRD 200,044,884003,Dixon; Jesse,9999,0,9999,0
1739697740783,BGRD 200,045,884008,Doherty; Taylor Alan,9998,0,9999,1
1739697740783,BGRD 200,046,884028,Dore; Kim Bohemie,9998,0,9999,1
1739697740783,BGRD 200,047,884082,Dulawa; Stephanie Carole,9999,0,9999,0
1739697740783,BGRD 200,048,884084,Ecker; Joseph R,9999,0,9999,0
1739697740783,BGRD 200,049,884107,Engle; Dannielle D,9999,0,9999,0
1739697740783,BGRD 200,050,884337,Ernst; Andreas,9999,0,9999,0
1739697740783,BGRD 200,051,884338,Esko; Jeffrey D.,9999,0,9999,0
1739697740783,BGRD 200,052,884339,Farley; Emma Kristen,9998,0,9999,1
1739697740783,BGRD 200,053,884340,Feldstein; Ariel E,9999,0,9999,0
1739697740783,BGRD 200,054,884341,Feng; Gen-Sheng,9998,0,9999,1
1739697740783,BGRD 200,055,884342,Fisch; Kathleen Marie,9995,0,9999,4
1739697740783,BGRD 200,056,884343,Friedman; Rick Adam,9999,0,9999,0
1739697740783,BGRD 200,057,884344,Furnari; Frank,9999,0,9999,0
1739697740783,BGRD 200,058,884345,Gage; Fred H,9999,0,9999,0
1739697740783,BGRD 200,059,884346,George; Olivier,9998,0,9999,1
1739697740783,BGRD 200,060,884347,Ghosh; Pradipta,9998,0,9999,1
1739697740783,BGRD 200,061,884348,Glasgow; Stacey Marie,9997,0,9999,2
1739697740783,BGRD 200,062,884349,Glass; Christopher,9999,0,9999,0
1739697740783,BGRD 200,063,884350,Golden; James W,9999,0,9999,0
1739697740783,BGRD 200,064,884352,Golden; Susan S.,9999,0,9999,0
1739697740783,BGRD 200,065,884354,Gonzalez Gamboa; Ivonne,9999,0,9999,0
1739697740783,BGRD 200,066,884355,Goren; Alon M,9999,0,9999,0
1739697740783,BGRD 200,067,884356,Guatelli; John C,9998,0,9999,1
1739697740783,BGRD 200,068,884357,Guma; Monica,9999,0,9999,0
1739697740783,BGRD 200,069,884360,Gustafsson; Asa Birgitta,9998,0,9999,1
1739697740783,BGRD 200,070,884361,Gutkind; Jorge Silvio,9999,0,9999,0
1739697740783,BGRD 200,071,884362,Hamdoun; Amr,9999,0,9999,0
1739697740783,BGRD 200,072,884364,Hampton; Randolph Y.,9999,0,9999,0
1739697740783,BGRD 200,073,884367,Hao; Nan,9999,0,9999,0
1739697740783,BGRD 200,074,884368,Hargreaves; Diana Clare,9999,0,9999,0
1739697740783,BGRD 200,075,884369,Hasty; Jeff M,9998,0,9999,1
1739697740783,BGRD 200,076,884370,Hollern; Daniel Patrick,9999,0,9999,0
1739697740783,BGRD 200,077,884372,Holway; David A.,9999,0,9999,0
1739697740783,BGRD 200,078,884374,Huffaker; Alisa,9999,0,9999,0
1739697740783,BGRD 200,079,884375,Hui; Enfu,9999,0,9999,0
1739697740783,BGRD 200,080,884376,Hwa; Terence T.,9999,0,9999,0
1739697740783,BGRD 200,081,884377,Ideker; Trey,9999,0,9999,0
1739697740783,BGRD 200,082,884378,Jackrel; Sara,9998,0,9999,1
1739697740783,BGRD 200,083,884380,Jiang; Qingfei,9999,0,9999,0
1739697740783,BGRD 200,084,884382,Jin; Yishi,9998,0,9999,1
1739697740783,BGRD 200,085,884384,Joiner; William J.,9999,0,9999,0
1739697740783,BGRD 200,086,884385,Joshi; Shweta,9998,0,9999,1
1739697740783,BGRD 200,087,884386,Ju; Won-Kyu,9998,0,9999,1
1739697740783,BGRD 200,088,884387,Jun; Suckjoon,9999,0,9999,0
1739697740783,BGRD 200,089,884388,Kadonaga; James T,9999,0,9999,0
1739697740783,BGRD 200,090,884389,Kaech; Susan Michelle,9999,0,9999,0
1739697740783,BGRD 200,091,884391,Kauffman; Alexander,9997,0,9999,2
1739697740783,BGRD 200,092,884392,Kleinfeld; David,9999,0,9999,0
1739697740783,BGRD 200,093,884393,Knight; Robin,9999,0,9999,0
1739697740783,BGRD 200,094,884394,Koloski; Miranda Jane,9998,0,9999,1
1739697740783,BGRD 200,095,884395,Komiyama; Takaki,9998,0,9999,1
1739697740783,BGRD 200,096,884396,Kosuri; Pallav,9999,0,9999,0
1739697740783,BGRD 200,097,884397,Kronenberg; Mitchell E.,9999,0,9999,0
1739697740783,BGRD 200,099,884400,Kryazhimskiy; Sergey A,9999,0,9999,0
1739697740783,BGRD 200,100,884401,Kufareva; Irina,9998,0,9999,1
1739697740783,BGRD 200,101,884402,Lee; Kuo Fen,9999,0,9999,0
1739697740783,BGRD 200,102,884403,Lee; Yun Sok,9999,0,9999,0
1739697740783,BGRD 200,103,884404,Leutgeb; Jill K.,9999,0,9999,0
1739697740783,BGRD 200,104,884405,Leutgeb; Stefan,9999,0,9999,0
1739697740783,BGRD 200,105,884406,Li; Willis Xiaowei,9998,0,9999,1
1739697740783,BGRD 200,106,884407,Lim; Byungkook,9998,0,9999,1
1739697740783,BGRD 200,107,884410,Lo; Stanley M.,9998,0,9999,1
1739697740783,BGRD 200,108,884414,Looger; Loren Lee,9999,0,9999,0
1739697740783,BGRD 200,109,884415,Lopez Ramirez; Miguel Alej,9999,0,9999,0
1739697740783,BGRD 200,110,884416,Lovett-Barron; Matthew Rod,9999,0,9999,0
1739697740783,BGRD 200,111,884418,Lu; Li-Fan,9998,0,9999,1
1739697740783,BGRD 200,112,884419,Lu; Pengzhe,9998,0,9999,1
1739697740783,BGRD 200,113,884421,Lykke-Andersen; Jens,9999,0,9999,0
1739697740783,BGRD 200,114,884423,Lyons; Deirdre Colleen,9998,0,9999,1
1739697740783,BGRD 200,115,884424,Lyumkis; Dmitry Evgenievich,9999,0,9999,0
1739697740783,BGRD 200,116,884425,Manor; Uri,9999,0,9999,0
1739697740783,BGRD 200,117,884426,Mayfield; Stephen P.,9998,0,9999,1
1739697740783,BGRD 200,118,884427,McConville; Patrick James,9999,0,9999,0
1739697740783,BGRD 200,119,884428,McDonnell; Lisa Marie,9999,0,9999,0
1739697740783,BGRD 200,120,884429,Mertens; Jerome Stefan,9997,0,9999,2
1739697740783,BGRD 200,121,884430,Meyer; Justin Raymond,9999,0,9999,0
1739697740783,BGRD 200,122,884431,Morris; Gerald P,9999,0,9999,0
1739697740783,BGRD 200,123,884432,Mueller; Lena,9999,0,9999,0
1739697740783,BGRD 200,124,884433,Muotri; Alysson,9999,0,9999,0
1739697740783,BGRD 200,125,884434,Muroyama; Andrew David,9997,0,9999,2
1739697740783,BGRD 200,126,884435,Murre; Cornelis,9999,0,9999,0
1739697740783,BGRD 200,127,884436,Neal; Sonya E,9999,0,9999,0
1739697740783,BGRD 200,128,884438,Nieh; James Charles,9997,0,9999,2
1739697740783,BGRD 200,129,884441,Nimmerjahn; Axel,9999,0,9999,0
1739697740783,BGRD 200,130,884444,Niwa; Maho,9999,0,9999,0
1739697740783,BGRD 200,131,884445,Nizet; Victor F.,9998,0,9999,1
1739697740783,BGRD 200,132,884446,Oegema; Karen,9999,0,9999,0
1739697740783,BGRD 200,133,884447,Panda; Satchidananda,9999,0,9999,0
1739697740783,BGRD 200,134,884448,Parast; Mana,9999,0,9999,0
1739697740783,BGRD 200,135,884449,Pasquinelli; Amy,9998,0,9999,1
1739697740783,BGRD 200,136,884450,Pekkurnaz Banghart; Gulcin,9999,0,9999,0
1739697740783,BGRD 200,137,884451,Perry; Michael William,9999,0,9999,0
1739697740783,BGRD 200,138,884452,Pillus; Lorraine,9998,0,9999,1
1739697740783,BGRD 200,139,884454,Pogliano; Joseph,9998,0,9999,1
1739697740783,BGRD 200,140,884456,Pogliano; Kit J.,9999,0,9999,0
1739697740783,BGRD 200,141,884457,Pride; David Tevis,9999,0,9999,0
1739697740783,BGRD 200,142,884458,Pruneda-Paz; Jose L.,9999,0,9999,0
1739697740783,BGRD 200,143,884459,Ramanan; Deepshika,9998,0,9999,1
1739697740783,BGRD 200,144,884460,Rana; Tariq,9999,0,9999,0
1739697740783,BGRD 200,145,884461,Rao; Anjana,9999,0,9999,0
1739697740783,BGRD 200,146,884462,Raz; Eyal,9998,0,9999,1
1739697740783,BGRD 200,147,884464,Reck-Peterson; Samara L,9999,0,9999,0
1739697740783,BGRD 200,148,884468,Ren; Bing,9999,0,9999,0
1739697740783,BGRD 200,149,884469,Rennison; Diana,9999,0,9999,0
1739697740783,BGRD 200,150,884471,Reyes De Barboza; Nabora S,9999,0,9999,0
1739697740783,BGRD 200,151,884472,Rifkin; Scott,9998,0,9999,1
1739697740783,BGRD 200,152,884482,Risbrough; Victoria Blythe,9999,0,9999,0
1739697740783,BGRD 200,153,884484,Rivera; Fabian Chavez,9999,0,9999,0
1739697740783,BGRD 200,154,884486,Rohner; Patrick Thomas,9999,0,9999,0
1739697740783,BGRD 200,155,884488,Rose; Noah Hartmann,9999,0,9999,0
1739697740783,BGRD 200,156,884491,Rosenfeld; Michael G,9999,0,9999,0
1739697740783,BGRD 200,157,884493,Russell; Alistair B,9999,0,9999,0
1739697740783,BGRD 200,158,884494,Saier; Milton H.,9998,0,9999,1
1739697740783,BGRD 200,159,884496,Saltiel; Alan,9997,0,9999,2
1739697740783,BGRD 200,160,884498,Sanchez-Lopez; Elsa,9999,0,9999,0
1739697740783,BGRD 200,161,884502,Saphire; Erica Ollmann,9999,0,9999,0
1739697740783,BGRD 200,162,884504,Schroeder; Julian I,9999,0,9999,0
1739697740783,BGRD 200,163,884508,Sebat; Lilia Mikhailovna,9998,0,9999,1
1739697740783,BGRD 200,164,884510,Sen; George L,9999,0,9999,0
1739697740783,BGRD 200,165,884513,Shah; Sameer B,9999,0,9999,0
1739697740783,BGRD 200,166,884515,Shaner; Nathan C.,9999,0,9999,0
1739697740783,BGRD 200,167,884517,Sharpee; Tatyana,9999,0,9999,0
1739697740783,BGRD 200,168,884519,Shaw; Reuben,9998,0,9999,1
1739697740783,BGRD 200,169,884522,Shurin; Jonathan,9998,0,9999,1
1739697740783,BGRD 200,170,884524,Sicklick; Jason Keith,9999,0,9999,0
1739697740783,BGRD 200,171,884526,Signer; Robert,9999,0,9999,0
1739697740783,BGRD 200,172,884530,Simonson; Tatum Sasha Summ,9999,0,9999,0
1739697740783,BGRD 200,173,884533,Soncin; Francesca,9999,0,9999,0
1739697740783,BGRD 200,174,884535,Steinmetz; Nicole F,9999,0,9999,0
1739697740783,BGRD 200,175,884536,Su; Chih-Ying,9999,0,9999,0
1739697740783,BGRD 200,176,884537,Suel; Gurol Mehmet,9999,0,9999,0
1739697740783,BGRD 200,177,884538,Sun; Xin,9999,0,9999,0
1739697740783,BGRD 200,178,884540,Telese; Francesca,9999,0,9999,0
1739697740783,BGRD 200,179,884543,Towers; Christina Garlingt,9998,0,9999,1
1739697740783,BGRD 200,180,884544,Traver; David,9999,0,9999,0
1739697740783,BGRD 200,181,884545,Troemel; Emily Ruth,9999,0,9999,0
1739697740783,BGRD 200,182,884546,Valdez-Jasso; Daniela,9999,0,9999,0
1739697740783,BGRD 200,183,884549,Vijayanand; Pandurangan,9999,0,9999,0
1739697740783,BGRD 200,184,884552,Villa Rodriguez; Elizabeth,9999,0,9999,0
1739697740783,BGRD 200,185,884553,Wahlin; Karl Jonas,9997,0,9999,2
1739697740783,BGRD 200,186,884555,Wang; Jean Yin Jen,9998,0,9999,1
1739697740783,BGRD 200,187,884556,Webster; Nicholas J G,9998,0,9999,1
1739697740783,BGRD 200,188,884557,Welsbie; Derek,9999,0,9999,0
1739697740783,BGRD 200,189,884600,Wildonger; Jill Cathleen,9998,0,9999,1
1739697740783,BGRD 200,190,884644,Winzeler; Elizabeth A,9998,0,9999,1
1739697740783,BGRD 200,191,884686,Yaksh; Tony L.,9999,0,9999,0
1739697740783,BGRD 200,192,884695,Yelon; Deborah,9999,0,9999,0
1739697740783,BGRD 200,193,884698,Yeo; Eugene Wei-Ming,9998,0,9999,1
1739697740783,BGRD 200,194,884706,Ying; Wei,9998,0,9999,1
1739697740783,BGRD 200,195,884707,Young; Jared W.,9998,0,9999,1
1739697740783,BGRD 200,196,884737,Zage; Peter,9999,0,9999,0
1739697740783,BGRD 200,197,884740,Zengler; Karsten B,9999,0,9999,0
1739697740783,BGRD 200,198,884749,Zhang; Dong-Er,9999,0,9999,0
1739697740783,BGRD 200,199,884750,Zhang; Jin,9999,0,9999,0
1739697740783,BGRD 200,200,884751,Zhao; Yunde,9999,0,9999,0
1739697740783,BGRD 200,201,884766,Zheng; Binhai,9999,0,9999,0
1739697740783,BGRD 200,202,884774,Zheng; Ye,9998,0,9999,1
1739697740783,BGRD 200,203,884849,Zhou; Huilin,9999,0,9999,0
1739697740783,BGRD 200,204,884894,Zou; Yimin,9998,0,9999,1
1739697740783,BGRD 200,205,884895,Zuniga; Elina I,9999,0,9999,0
1739697741812,BGSE 200,A00,851586,Tour; Ella & Petrie; Katherine Lynn,9989,0,9999,10
1739697742837,BGSE 205,A00,851588,Bennett; Eric J,46,0,50,4
1739697742837,BGSE 205,C00,851589,Bennett; Eric J,43,0,50,7
1739697742837,BGSE 205,D00,851590,Bennett; Eric J,48,0,50,2
1739697742837,BGSE 205,E00,851591,Bennett; Eric J,49,0,50,1
1739697743867,BIBC 102,A01,864157,Hampton; Randolph Y.,48,0,73,25
1739697743867,BIBC 102,A02,864159,Hampton; Randolph Y.,66,0,73,7
1739697743867,BIBC 102,A03,864171,Hampton; Randolph Y.,69,0,73,4
1739697743867,BIBC 102,A04,864227,Hampton; Randolph Y.,63,0,73,10
1739697744895,BIBC 103,A01,850483,Coleman; Aaron B.,19,0,24,5
1739697744895,BIBC 103,A02,850484,Coleman; Aaron B.,24,0,24,0
1739697744895,BIBC 103,B01,850487,Coleman; Aaron B.,21,0,24,3
1739697744895,BIBC 103,B02,850489,Coleman; Aaron B.,24,0,24,0
1739697744895,BIBC 103,C01,850492,Burg; Michael,15,0,24,9
1739697744895,BIBC 103,C02,850493,Burg; Michael,23,0,24,1
1739697745921,BIBC 104,A01,850495,Zhao; Yunde,49,0,50,1
1739697745921,BIBC 104,A02,850496,Zhao; Yunde,50,0,50,0
1739697745921,BIBC 104,A03,850500,Zhao; Yunde,48,0,50,2
1739697745921,BIBC 104,A04,850501,Zhao; Yunde,48,0,50,2
1739697746946,BIBC 194,A00,850502,Ernst; Andreas,20,0,32,12
1739697746946,BIBC 194,B00,850503,Saier; Milton H.,21,0,32,11
1739697747982,BICD 100,A01,864248,Biering; Scott B,70,0,73,3
1739697747982,BICD 100,A02,864249,Biering; Scott B,72,0,73,1
1739697747982,BICD 100,A03,864274,Biering; Scott B,73,0,73,0
1739697747982,BICD 100,A04,864287,Biering; Scott B,70,0,73,3
1739697747982,BICD 100,B01,864290,Reinagel; Pam,70,0,73,3
1739697747982,BICD 100,B02,864291,Reinagel; Pam,72,0,73,1
1739697747982,BICD 100,B03,864294,Reinagel; Pam,72,0,73,1
1739697747982,BICD 100,B04,864299,Reinagel; Pam,73,0,73,0
1739697747982,BICD 100,C01,864303,Nguyen; Vu Quang,72,0,73,1
1739697747982,BICD 100,C02,864314,Nguyen; Vu Quang,71,0,73,2
1739697747982,BICD 100,C03,864347,Nguyen; Vu Quang,72,0,73,1
1739697747982,BICD 100,C04,864362,Nguyen; Vu Quang,73,0,73,0
1739697749011,BICD 110,A01,850512,Ernst; Andreas,42,0,73,31
1739697749011,BICD 110,A02,850513,Ernst; Andreas,53,0,73,20
1739697749011,BICD 110,A03,850516,Ernst; Andreas,61,0,73,12
1739697749011,BICD 110,A04,850518,Ernst; Andreas,53,0,73,20
1739697750039,BICD 123,A01,850521,Zhao; Yunde,29,0,36,7
1739697751066,BICD 140,A01,850561,Lu; Li-Fan,50,0,61,11
1739697751066,BICD 140,A02,850563,Lu; Li-Fan,58,0,61,3
1739697751066,BICD 140,A03,850569,Lu; Li-Fan,57,0,61,4
1739697751066,BICD 140,A04,850577,Lu; Li-Fan,60,0,62,2
1739697752092,BICD 158,A01,850601,Bier; Ethan,29,0,36,7
1739697752092,BICD 158,A02,850644,Bier; Ethan,32,0,36,4
1739697752092,BICD 158,A03,850655,Bier; Ethan,33,0,36,3
1739697752092,BICD 158,A04,850656,Bier; Ethan,36,0,37,1
1739697753126,BIEB 121,A00,850668,Butler; Shannon Rhey,25,0,32,7
1739697753126,BIEB 121,B00,850674,Butler; Shannon Rhey,21,0,32,11
1739697754152,BIEB 146,A01,850680,Petrie; Katherine Lynn,91,0,99,8
1739697754152,BIEB 146,A02,850682,Petrie; Katherine Lynn,81,0,99,18
1739697754152,BIEB 146,A03,850684,Petrie; Katherine Lynn,95,0,99,4
1739697754152,BIEB 146,A04,850687,Petrie; Katherine Lynn,94,0,98,4
1739697755177,BIEB 148,A01,850691,Rose; Noah Hartmann,25,0,36,11
1739697755177,BIEB 148,A02,850706,Rose; Noah Hartmann,34,0,36,2
1739697755177,BIEB 148,A03,850778,Rose; Noah Hartmann,34,0,36,2
1739697755177,BIEB 148,A04,850779,Rose; Noah Hartmann,26,0,36,10
1739697756206,BIEB 152,A01,850784,Wodarz; Dominik Franz Xave,70,0,75,5
1739697756206,BIEB 152,A02,850785,Wodarz; Dominik Franz Xave,73,0,75,2
1739697756206,BIEB 152,A03,850786,Wodarz; Dominik Franz Xave,69,0,75,6
1739697756206,BIEB 152,A04,850789,Wodarz; Dominik Franz Xave,68,0,75,7
1739697757238,BIEB 154,A01,850792,Stockwell; Sarah R,15,0,15,0
1739697757238,BIEB 154,A02,850795,Stockwell; Sarah R,15,0,15,0
1739697757238,BIEB 154,A03,850796,Stockwell; Sarah R,13,0,15,2
1739697757238,BIEB 154,A04,850854,Stockwell; Sarah R,15,0,15,0
1739697758264,BIEB 159,A00,850856,Jackrel; Sara,33,0,36,3
1739697759288,BIEB 164,A01,850859,De Silva; Shermin,47,0,50,3
1739697759288,BIEB 164,A02,850862,De Silva; Shermin,42,0,50,8
1739697759288,BIEB 164,A03,850863,De Silva; Shermin,45,0,50,5
1739697759288,BIEB 164,A04,850865,De Silva; Shermin,45,0,50,5
1739697760316,BILD 1,A01,860138,Patrick; Gentry,62,0,62,0
1739697760316,BILD 1,A02,860253,Patrick; Gentry,61,0,62,1
1739697760316,BILD 1,A03,860277,Patrick; Gentry,61,0,62,1
1739697760316,BILD 1,A04,860281,Patrick; Gentry,61,0,64,3
1739697760316,BILD 1,B01,860381,Gonzalez Gamboa; Ivonne,51,0,62,11
1739697760316,BILD 1,B02,860382,Gonzalez Gamboa; Ivonne,61,0,62,1
1739697760316,BILD 1,B03,860383,Gonzalez Gamboa; Ivonne,59,0,62,3
1739697760316,BILD 1,B04,860384,Gonzalez Gamboa; Ivonne,63,0,64,1
1739697760316,BILD 1,C01,860385,Cooper; Andrew Michael,61,0,62,1
1739697760316,BILD 1,C02,860386,Cooper; Andrew Michael,59,0,62,3
1739697760316,BILD 1,C03,860387,Cooper; Andrew Michael,62,0,62,0
1739697760316,BILD 1,C04,860388,Cooper; Andrew Michael,64,0,64,0
1739697761349,BILD 2,A01,860389,Reyes Gonzalez; Catalina,87,0,99,12
1739697761349,BILD 2,A02,860390,Reyes Gonzalez; Catalina,96,0,99,3
1739697761349,BILD 2,A03,860391,Reyes Gonzalez; Catalina,99,0,99,0
1739697761349,BILD 2,A04,860392,Reyes Gonzalez; Catalina,98,0,98,0
1739697762377,BILD 3,A01,860393,Stockwell; Sarah R,68,0,70,2
1739697762377,BILD 3,A02,860394,Stockwell; Sarah R,66,0,70,4
1739697762377,BILD 3,A03,860395,Stockwell; Sarah R,69,0,70,1
1739697762377,BILD 3,A04,860396,Stockwell; Sarah R,66,0,68,2
1739697762377,BILD 3,B01,860397,Hammond; LaTisha Marie,48,0,63,15
1739697762377,BILD 3,B02,860398,Hammond; LaTisha Marie,54,0,60,6
1739697762377,BILD 3,B03,860399,Hammond; LaTisha Marie,57,0,60,3
1739697762377,BILD 3,B04,860400,Hammond; LaTisha Marie,60,0,62,2
1739697762377,BILD 3,C01,860401,Hammond; LaTisha Marie,60,0,62,2
1739697762377,BILD 3,C02,860402,Hammond; LaTisha Marie,58,0,63,5
1739697762377,BILD 3,C03,860403,Hammond; LaTisha Marie,59,0,60,1
1739697762377,BILD 3,C04,860404,Hammond; LaTisha Marie,60,0,60,0
1739697763410,BILD 4,A01,850172,Ochoa Mikrut; Stacy Daniel,22,0,24,2
1739697763410,BILD 4,A02,850250,Ochoa Mikrut; Stacy Daniel,24,0,24,0
1739697763410,BILD 4,A03,850251,Ochoa Mikrut; Stacy Daniel,22,0,24,2
1739697763410,BILD 4,A04,850252,Ochoa Mikrut; Stacy Daniel,23,0,24,1
1739697763410,BILD 4,A05,850253,Ochoa Mikrut; Stacy Daniel,24,0,24,0
1739697763410,BILD 4,A06,850254,Ochoa Mikrut; Stacy Daniel,24,0,24,0
1739697763410,BILD 4,A07,850255,Ochoa Mikrut; Stacy Daniel,24,0,24,0
1739697763410,BILD 4,A08,850257,Ochoa Mikrut; Stacy Daniel,23,0,24,1
1739697763410,BILD 4,B01,850259,Reuther; Keefe,18,0,24,6
1739697763410,BILD 4,B02,850260,Reuther; Keefe,22,0,24,2
1739697763410,BILD 4,B03,850261,Reuther; Keefe,24,0,24,0
1739697763410,BILD 4,B04,850263,Reuther; Keefe,22,0,24,2
1739697763410,BILD 4,B05,850264,Reuther; Keefe,23,0,24,1
1739697763410,BILD 4,B06,850265,Reuther; Keefe,24,0,24,0
1739697763410,BILD 4,B07,850266,Reuther; Keefe,24,0,24,0
1739697763410,BILD 4,B08,850267,Reuther; Keefe,24,0,24,0
1739697763410,BILD 4,C01,850269,Gonzalez Gamboa; Ivonne,19,0,24,5
1739697763410,BILD 4,C02,850270,Gonzalez Gamboa; Ivonne,24,0,24,0
1739697763410,BILD 4,C03,850271,Gonzalez Gamboa; Ivonne,24,0,24,0
1739697763410,BILD 4,C04,850273,Gonzalez Gamboa; Ivonne,24,0,24,0
1739697763410,BILD 4,C05,850283,Gonzalez Gamboa; Ivonne,23,0,24,1
1739697763410,BILD 4,C06,850329,Gonzalez Gamboa; Ivonne,23,0,24,1
1739697763410,BILD 4,C07,850331,Gonzalez Gamboa; Ivonne,24,0,24,0
1739697763410,BILD 4,C08,850336,Gonzalez Gamboa; Ivonne,23,0,24,1
1739697764444,BILD 5,A01,860586,Reuther; Keefe,63,0,65,2
1739697764444,BILD 5,A02,860597,Reuther; Keefe,62,0,65,3
1739697764444,BILD 5,A03,860600,Reuther; Keefe,65,0,65,0
1739697764444,BILD 5,A04,860672,Reuther; Keefe,64,0,65,1
1739697764444,BILD 5,B01,860673,Yang; Mingyu,65,0,65,0
1739697764444,BILD 5,B02,860681,Yang; Mingyu,64,0,65,1
1739697764444,BILD 5,B03,860686,Yang; Mingyu,65,0,65,0
1739697764444,BILD 5,B04,860687,Yang; Mingyu,65,0,65,0
1739697764444,BILD 5,C01,860694,Day; Christopher D,62,0,65,3
1739697764444,BILD 5,C02,860697,Day; Christopher D,65,0,65,0
1739697764444,BILD 5,C03,860709,Day; Christopher D,63,0,65,2
1739697764444,BILD 5,C04,860714,Day; Christopher D,65,0,65,0
1739697765474,BILD 30,A01,850343,Madigan; Cressida Ariana,28,0,28,0
1739697765474,BILD 30,A02,850344,Madigan; Cressida Ariana,28,0,28,0
1739697765474,BILD 30,A03,850345,Madigan; Cressida Ariana,26,0,28,2
1739697765474,BILD 30,A04,850349,Madigan; Cressida Ariana,30,0,31,1
1739697766498,BILD 88,A00,850480,Kurle; Carolyn M.,20,0,20,0
1739697767524,BIMM 100,A01,860726,Farley; Emma Kristen,35,0,48,13
1739697767524,BIMM 100,A02,860737,Farley; Emma Kristen,43,0,48,5
1739697767524,BIMM 100,A03,860771,Farley; Emma Kristen,46,0,48,2
1739697767524,BIMM 100,A04,860812,Farley; Emma Kristen,45,0,48,3
1739697767524,BIMM 100,B01,860817,Wildonger; Jill Cathleen,35,0,48,13
1739697767524,BIMM 100,B02,860838,Wildonger; Jill Cathleen,38,0,48,10
1739697767524,BIMM 100,B03,860839,Wildonger; Jill Cathleen,44,0,48,4
1739697767524,BIMM 100,B04,860840,Wildonger; Jill Cathleen,46,0,48,2
1739697768561,BIMM 101,A01,850871,Meaders; Clara Leigh,0,0,24,24
1739697768561,BIMM 101,A02,850872,Meaders; Clara Leigh,3,0,24,21
1739697768561,BIMM 101,B01,850876,Day; Christopher D,23,0,24,1
1739697768561,BIMM 101,B02,850877,Day; Christopher D,22,0,24,2
1739697768561,BIMM 101,C01,850880,Cooper; Andrew Michael,17,0,24,7
1739697768561,BIMM 101,C02,850887,Cooper; Andrew Michael,22,0,24,2
1739697768561,BIMM 101,D01,850890,Grossman; Emily N,19,0,24,5
1739697768561,BIMM 101,D02,850894,Grossman; Emily N,21,0,24,3
1739697768561,BIMM 101,E01,850897,Grossman; Emily N,19,0,24,5
1739697768561,BIMM 101,E02,850900,Grossman; Emily N,22,0,24,2
1739697768561,BIMM 101,F01,850906,Rusert; Jessica Marie,21,0,24,3
1739697768561,BIMM 101,F02,850910,Rusert; Jessica Marie,24,0,24,0
1739697768561,BIMM 101,G01,850920,Rusert; Jessica Marie,20,0,24,4
1739697768561,BIMM 101,G02,850921,Rusert; Jessica Marie,24,0,24,0
1739697769589,BIMM 118,A01,850923,David; Michael,26,0,29,3
1739697769589,BIMM 118,A02,850926,David; Michael,27,0,29,2
1739697769589,BIMM 118,A03,850927,David; Michael,25,0,29,4
1739697769589,BIMM 118,A04,850928,David; Michael,27,0,28,1
1739697770618,BIMM 120,A01,850932,Saier; Milton H.,78,0,87,9
1739697770618,BIMM 120,A02,850934,Saier; Milton H.,71,0,87,16
1739697770618,BIMM 120,A03,850986,Saier; Milton H.,81,0,87,6
1739697770618,BIMM 120,A04,851000,Saier; Milton H.,84,0,87,3
1739697771647,BIMM 121,A01,851020,Gustafson-Brown; Cindy,18,0,24,6
1739697771647,BIMM 121,A02,851023,Gustafson-Brown; Cindy,23,0,24,1
1739697771647,BIMM 121,B01,851032,Gustafson-Brown; Cindy,15,0,24,9
1739697771647,BIMM 121,B02,851058,Gustafson-Brown; Cindy,19,0,24,5
1739697771647,BIMM 121,C01,851077,Staff,2,0,24,22
1739697771647,BIMM 121,C02,851081,Staff,19,0,24,5
1739697771647,BIMM 121,D01,851152,Staff,15,0,24,9
1739697771647,BIMM 121,D02,851169,Staff,23,0,24,1
1739697772673,BIMM 134,A01,851210,Burg; Michael,95,0,103,8
1739697772673,BIMM 134,A02,851211,Burg; Michael,93,0,103,10
1739697772673,BIMM 134,A03,851212,Burg; Michael,93,0,103,10
1739697772673,BIMM 134,A04,851213,Burg; Michael,95,0,101,6
1739697773701,BIMM 143,A01,851215,Grant; Barry J,28,0,40,12
1739697773701,BIMM 143,B01,851218,Bozinovic; Goran,38,0,40,2
1739697773701,BIMM 143,C01,851220,Bozinovic; Goran,40,0,40,0
1739697774726,BIMM 182,A01,851597,Bafna; Vineet,31,0,50,19
1739697775755,BIMM 194,A00,851222,Russell; Alistair B,23,0,32,9
1739697776781,BIOM 202,A01,806511,Sheikh; Farah,21,0,40,19
1739697777809,BIOM 218,A00,806606,Gagneux; Pascal,10,0,12,2
1739697778836,BIOM 219,A00,806612,Ross; Camille,1,0,1,0
1739697779866,BIOM 222,A00,872553,Esko; Jeffrey D.,0,0,0,0
1739697780891,BIOM 229,A00,806613,Gagneux; Pascal,12,0,12,0
1739697781916,BIOM 231,A00,881485,Daneman; Richard & Newton; Alexandra C.,0,0,0,0
1739697781916,BIOM 231,B00,881487,Staff,0,0,0,0
1739697781916,BIOM 231,C00,881488,Schoeneberg; Johannes,0,0,0,0
1739697782943,BIOM 234,A00,881480,Newton; Alexandra C.,0,0,0,0
1739697783969,BIOM 242,A00,806624,Hamilton; Bruce Alan,0,0,0,0
1739697784996,BIOM 246,A00,872559,Gordts; Philip & Lewis; Amanda Lark & Godula; Kamil & Gagneux; Pascal & Esko; Jeffrey D. & Bode; Lars,0,0,0,0
1739697786026,BIOM 252,A00,806625,Ayyagari; Radha,7,0,20,13
1739697787051,BIOM 283,A00,806628,Ghassemian; Majid,0,0,0,0
1739697788076,BIOM 295,A00,806638,Joiner; William J.,0,0,0,0
1739697789104,BIPN 100,A01,860405,Augustine; Vineet,32,0,36,4
1739697789104,BIPN 100,A02,860406,Augustine; Vineet,35,0,36,1
1739697789104,BIPN 100,A03,860407,Augustine; Vineet,35,0,36,1
1739697789104,BIPN 100,A04,860408,Augustine; Vineet,36,0,37,1
1739697789104,BIPN 100,B01,860409,George; Monique Leana,27,0,36,9
1739697789104,BIPN 100,B02,860410,George; Monique Leana,33,0,36,3
1739697789104,BIPN 100,B03,860411,George; Monique Leana,31,0,36,5
1739697789104,BIPN 100,B04,860412,George; Monique Leana,31,0,37,6
1739697789104,BIPN 100,C01,860413,Maita; Isabella Vincenza,36,0,36,0
1739697789104,BIPN 100,C02,860414,Maita; Isabella Vincenza,35,0,36,1
1739697789104,BIPN 100,C03,860415,Maita; Isabella Vincenza,33,0,36,3
1739697789104,BIPN 100,C04,860416,Maita; Isabella Vincenza,36,0,37,1
1739697789104,BIPN 100,D01,860417,Marino; Marc J,47,0,50,3
1739697789104,BIPN 100,D02,860418,Marino; Marc J,48,0,50,2
1739697789104,BIPN 100,D03,860419,Marino; Marc J,48,0,50,2
1739697789104,BIPN 100,D04,860420,Marino; Marc J,50,0,50,0
1739697789104,BIPN 100,E01,860421,Yang; Mingyu,36,0,36,0
1739697789104,BIPN 100,E02,860422,Yang; Mingyu,34,0,36,2
1739697789104,BIPN 100,E03,860423,Yang; Mingyu,36,0,36,0
1739697789104,BIPN 100,E04,860424,Yang; Mingyu,37,0,37,0
1739697790135,BIPN 102,A01,851476,Reyes Gonzalez; Catalina,45,0,54,9
1739697790135,BIPN 102,A02,851477,Reyes Gonzalez; Catalina,48,0,54,6
1739697790135,BIPN 102,A03,851478,Reyes Gonzalez; Catalina,53,0,54,1
1739697790135,BIPN 102,A04,851479,Reyes Gonzalez; Catalina,51,0,54,3
1739697791160,BIPN 105,A01,851482,Armour; Jon Christopher,13,0,21,8
1739697791160,BIPN 105,A02,851483,Armour; Jon Christopher,20,0,21,1
1739697791160,BIPN 105,B01,851487,Armour; Jon Christopher,10,0,21,11
1739697791160,BIPN 105,B02,851488,Armour; Jon Christopher,20,0,21,1
1739697792187,BIPN 140,A01,851492,Owens; Melinda Tsao-Ying,37,0,40,3
1739697792187,BIPN 140,A02,851493,Owens; Melinda Tsao-Ying,38,0,40,2
1739697792187,BIPN 140,A03,851494,Owens; Melinda Tsao-Ying,39,0,40,1
1739697792187,BIPN 140,A04,851495,Owens; Melinda Tsao-Ying,32,0,38,6
1739697793216,BIPN 144,A01,851498,Zou; Yimin,35,0,40,5
1739697793216,BIPN 144,A02,851499,Zou; Yimin,35,0,40,5
1739697793216,BIPN 144,A03,851500,Zou; Yimin,40,0,40,0
1739697793216,BIPN 144,A04,851501,Zou; Yimin,37,0,38,1
1739697794241,BIPN 145,A01,851505,Maita; Isabella Vincenza,33,0,42,9
1739697794241,BIPN 145,B01,851507,Juavinett; Ashley Lauren,36,0,42,6
1739697794241,BIPN 145,C01,851512,Marino; Marc J,34,0,42,8
1739697795266,BIPN 147,A01,851516,Sejnowski; Terrence J,5,0,16,11
1739697795266,BIPN 147,A02,851517,Sejnowski; Terrence J,16,0,16,0
1739697795266,BIPN 147,A03,851520,Sejnowski; Terrence J,13,0,16,3
1739697795266,BIPN 147,A04,851521,Sejnowski; Terrence J,14,0,16,2
1739697796293,BIPN 152,A01,860841,Halpain; Shelley,32,0,44,12
1739697796293,BIPN 152,A02,860842,Halpain; Shelley,43,0,44,1
1739697796293,BIPN 152,A03,860843,Halpain; Shelley,42,0,44,2
1739697796293,BIPN 152,A04,860844,Halpain; Shelley,40,0,43,3
1739697797318,BIPN 162,A01,851524,Aoi; Mikio C,7,0,8,1
1739697797318,BIPN 162,A02,851525,Aoi; Mikio C,7,0,8,1
1739697797318,BIPN 162,A03,851527,Aoi; Mikio C,6,0,8,2
1739697797318,BIPN 162,A04,851529,Aoi; Mikio C,6,0,6,0
1739697798345,BIPN 164,A01,851531,Benna; Marcus K & Aljadeff; Johnatan,13,0,14,1
1739697798345,BIPN 164,A02,851532,Benna; Marcus K & Aljadeff; Johnatan,13,0,14,1
1739697798345,BIPN 164,A03,851533,Benna; Marcus K & Aljadeff; Johnatan,13,0,14,1
1739697798345,BIPN 164,A04,851535,Benna; Marcus K & Aljadeff; Johnatan,12,0,12,0
1739697799370,BIPN 194,A00,851536,Glasgow; Stacey Marie,29,0,32,3
1739697799370,BIPN 194,B00,851537,Augustine; Vineet,28,0,32,4
1739697799370,BIPN 194,C00,851539,Reinagel; Pam,31,0,32,1
1739697800395,BISP 170,A00,851540,French; Kathleen Ann,28,0,30,2
1739697801421,BISP 182,A00,869152,Pogliano; Joseph,9999,0,9999,0
1739697802451,BISP 194,A00,851542,Greenspan; Ralph J.,10,0,32,22
1739697802451,BISP 194,B00,851543,Nguyen; Vu Quang,25,0,32,7
1739697802451,BISP 194,C00,869153,Patrick; Gentry,23,0,32,9
1739697803476,BNFO 281,A00,805637,Gaasterland; Theresa,94,0,100,6
1739697804502,BNFO 283,A00,805640,Chavez; Alejandro & D'Antonio; Matteo,48,0,50,2
1739697804502,BNFO 283,B00,805642,Carter; Hannah Kathryn & Sanchez Roige; Alexandra,47,0,50,3
1739697805585,BNFO 285,A00,805666,Alexandrov; Ludmil B,6,0,8,2
1739697806611,BNFO 294,A01,805680,Ross; Camille,49,0,50,1
1739697807668,CAT 3,A01,813335,Marchisotto; Jennifer Anne,16,0,16,0
1739697807668,CAT 3,A02,813336,Marchisotto; Jennifer Anne,16,0,16,0
1739697807668,CAT 3,A03,813341,Marchisotto; Jennifer Anne,8,0,16,8
1739697807668,CAT 3,A04,813343,Marchisotto; Jennifer Anne,12,0,16,4
1739697807668,CAT 3,A05,813345,Marchisotto; Jennifer Anne,16,0,16,0
1739697807668,CAT 3,A06,813346,Marchisotto; Jennifer Anne,12,0,16,4
1739697807668,CAT 3,A07,813347,Marchisotto; Jennifer Anne,15,0,16,1
1739697807668,CAT 3,A08,813349,Marchisotto; Jennifer Anne,15,0,16,1
1739697807668,CAT 3,A09,813350,Marchisotto; Jennifer Anne,16,0,16,0
1739697807668,CAT 3,A10,813365,Marchisotto; Jennifer Anne,15,0,16,1
1739697807668,CAT 3,A11,813366,Marchisotto; Jennifer Anne,5,0,16,11
1739697807668,CAT 3,A12,813384,Marchisotto; Jennifer Anne,16,0,16,0
1739697807668,CAT 3,A13,813385,Marchisotto; Jennifer Anne,16,0,16,0
1739697807668,CAT 3,A14,813434,Marchisotto; Jennifer Anne,15,0,16,1
1739697807668,CAT 3,B01,813444,Popko; Elizabeth Ashley,16,0,16,0
1739697807668,CAT 3,B02,813445,Popko; Elizabeth Ashley,12,0,16,4
1739697807668,CAT 3,B03,813464,Popko; Elizabeth Ashley,14,0,16,2
1739697807668,CAT 3,B04,813465,Popko; Elizabeth Ashley,7,0,16,9
1739697807668,CAT 3,B05,813466,Popko; Elizabeth Ashley,12,0,16,4
1739697807668,CAT 3,B06,813475,Popko; Elizabeth Ashley,13,0,16,3
1739697807668,CAT 3,B07,813531,Popko; Elizabeth Ashley,15,0,16,1
1739697807668,CAT 3,B08,813538,Popko; Elizabeth Ashley,15,0,16,1
1739697807668,CAT 3,B09,813539,Popko; Elizabeth Ashley,11,0,16,5
1739697807668,CAT 3,B10,813543,Popko; Elizabeth Ashley,12,0,16,4
1739697807668,CAT 3,B11,813545,Popko; Elizabeth Ashley,16,0,16,0
1739697807668,CAT 3,B12,813551,Popko; Elizabeth Ashley,16,0,16,0
1739697807668,CAT 3,B13,813552,Popko; Elizabeth Ashley,15,0,16,1
1739697807668,CAT 3,B14,813554,Popko; Elizabeth Ashley,16,0,16,0
1739697807668,CAT 3,B15,813556,Popko; Elizabeth Ashley,16,0,16,0
1739697807668,CAT 3,B16,813558,Popko; Elizabeth Ashley,16,0,16,0
1739697807668,CAT 3,C01,813564,Glaser; Amelia,15,0,16,1
1739697807668,CAT 3,C02,813578,Glaser; Amelia,13,0,16,3
1739697807668,CAT 3,C03,813602,Glaser; Amelia,4,0,16,12
1739697807668,CAT 3,C04,813604,Glaser; Amelia,3,0,16,13
1739697807668,CAT 3,C05,813606,Glaser; Amelia,14,0,16,2
1739697807668,CAT 3,C06,813607,Glaser; Amelia,14,0,16,2
1739697807668,CAT 3,C07,813609,Glaser; Amelia,14,0,16,2
1739697807668,CAT 3,C08,813611,Glaser; Amelia,16,0,16,0
1739697807668,CAT 3,C09,813613,Glaser; Amelia,15,0,16,1
1739697807668,CAT 3,C10,813614,Glaser; Amelia,13,0,16,3
1739697807668,CAT 3,C11,813617,Glaser; Amelia,14,0,16,2
1739697807668,CAT 3,C12,813618,Glaser; Amelia,16,0,16,0
1739697807668,CAT 3,C13,813622,Glaser; Amelia,15,0,16,1
1739697807668,CAT 3,C14,813623,Glaser; Amelia,15,0,16,1
1739697807668,CAT 3,D01,813625,Bigham; David Joseph,11,0,16,5
1739697807668,CAT 3,D02,813627,Bigham; David Joseph,8,0,16,8
1739697807668,CAT 3,D03,813632,Bigham; David Joseph,15,0,16,1
1739697807668,CAT 3,D04,813637,Bigham; David Joseph,15,0,16,1
1739697807668,CAT 3,D05,813641,Bigham; David Joseph,16,0,16,0
1739697807668,CAT 3,D06,813642,Bigham; David Joseph,15,0,16,1
1739697807668,CAT 3,D07,813644,Bigham; David Joseph,15,0,16,1
1739697807668,CAT 3,D08,813645,Bigham; David Joseph,15,0,16,1
1739697807668,CAT 3,D09,813648,Bigham; David Joseph,15,0,16,1
1739697807668,CAT 3,D10,813651,Bigham; David Joseph,16,0,16,0
1739697807668,CAT 3,D11,813654,Bigham; David Joseph,16,0,16,0
1739697807668,CAT 3,D12,813656,Bigham; David Joseph,16,0,16,0
1739697807668,CAT 3,D13,813657,Bigham; David Joseph,16,0,16,0
1739697807668,CAT 3,D14,813658,Bigham; David Joseph,16,0,16,0
1739697807668,CAT 3,D15,813662,Bigham; David Joseph,15,0,16,1
1739697807668,CAT 3,D16,813663,Bigham; David Joseph,16,0,16,0
1739697808694,CAT 3CE,A01,813665,Bronstein; Phoebe Malan,25,0,25,0
1739697809726,CAT 87,A00,813667,Bronstein; Phoebe Malan,20,0,20,0
1739697809726,CAT 87,B00,886854,Geibel; William,20,0,20,0
1739697810755,CAT 98,001,881482,Geibel; William,20,0,20,0
1739697811782,CAT 124,A01,813672,Geibel; William,20,0,20,0
1739697811782,CAT 124,B01,813675,Rose; Becca Rae,20,0,20,0
1739697812814,CAT 125,A00,813692,Marchisotto; Jennifer Anne,17,0,20,3
1739697812814,CAT 125,B00,813696,Bigham; David Joseph,18,0,20,2
1739697812814,CAT 125,C00,813698,Vanderschuit; Maya Alysia,20,0,20,0
1739697812814,CAT 125,D00,813700,Vanderschuit; Maya Alysia,20,0,20,0
1739697812814,CAT 125,E00,813703,Vanderschuit; Maya Alysia,20,0,20,0
1739697812814,CAT 125,F00,813711,Morales; Celeste Georgianna,19,0,20,1
1739697812814,CAT 125,G00,813714,Morales; Celeste Georgianna,18,0,20,2
1739697812814,CAT 125,H00,813717,Morales; Celeste Georgianna,20,0,20,0
1739697812814,CAT 125,I00,813720,Rose; Becca Rae,20,0,20,0
1739697812814,CAT 125,J00,813744,Rose; Becca Rae,19,0,20,1
1739697812814,CAT 125,K00,813761,Tosun; Adriana,18,0,20,2
1739697812814,CAT 125,L00,813762,Tosun; Adriana,19,0,20,1
1739697812814,CAT 125,M00,872512,Delaville; Romain,19,0,20,1
1739697812814,CAT 125,N00,872514,Irwin; Matthew Joseph,18,0,20,2
1739697812814,CAT 125,O00,872516,Irwin; Matthew Joseph,20,0,20,0
1739697812814,CAT 125,P00,872517,Irwin; Matthew Joseph,19,0,20,1
1739697813847,CAT 125R,A00,813763,Smith; Lauryn Alissa,17,0,20,3
1739697813847,CAT 125R,B00,813764,Smith; Lauryn Alissa,18,0,20,2
1739697813847,CAT 125R,C00,813765,Smith; Lauryn Alissa,20,0,20,0
1739697813847,CAT 125R,D00,813766,Hyland; Tina Mae,16,0,20,4
1739697813847,CAT 125R,E00,813767,Hyland; Tina Mae,15,0,20,5
1739697813847,CAT 125R,F00,813768,Hyland; Tina Mae,19,0,20,1
1739697813847,CAT 125R,G00,813769,Tosun; Adriana,17,0,20,3
1739697814879,CCE 1,A00,815913,Merryman; Ashley,39,0,40,1
1739697814879,CCE 1,D00,815916,Garcia; Kathryn Mary,39,0,40,1
1739697814879,CCE 1,E00,815918,Labat Ii; Michael Luis,36,0,40,4
1739697814879,CCE 1,F00,815919,Bigley; Michele Heather,39,0,40,1
1739697814879,CCE 1,G00,815921,Santos; Vabianna Daria,40,0,40,0
1739697814879,CCE 1,H00,815922,Lee; Kassandra,39,0,40,1
1739697815911,CCE 3,001,815923,Kenley; Nicole,15,0,20,5
1739697815911,CCE 3,002,815924,Quijada; David,19,0,20,1
1739697815911,CCE 3,003,815926,Crawford; James,20,0,20,0
1739697815911,CCE 3,004,815963,Williams; Danielle,20,0,20,0
1739697815911,CCE 3,005,815964,Merryman; Ashley,20,0,20,0
1739697815911,CCE 3,006,815965,Merryman; Ashley,20,0,20,0
1739697815911,CCE 3,007,815966,Lee; Kassandra,19,0,20,1
1739697815911,CCE 3,008,815967,Lee; Kassandra,20,0,20,0
1739697815911,CCE 3,009,816009,Garcia; Kathryn Mary,19,0,20,1
1739697815911,CCE 3,010,816011,Garcia; Kathryn Mary,19,0,20,1
1739697815911,CCE 3,011,816012,Labat Ii; Michael Luis,18,0,20,2
1739697815911,CCE 3,012,816013,Labat Ii; Michael Luis,20,0,20,0
1739697815911,CCE 3,013,816014,Bigley; Michele Heather,18,0,20,2
1739697815911,CCE 3,014,816015,Santos; Vabianna Daria,20,0,20,0
1739697815911,CCE 3,015,816016,Santos; Vabianna Daria,20,0,20,0
1739697815911,CCE 3,016,889148,Crawford; James,39,0,40,1
1739697816937,CENG 101B,A00,808970,Chen; Shaochen,50,0,50,0
1739697817962,CENG 101C,A00,808971,Li; Yanran,144,0,146,2
1739697818988,CENG 113,A00,808993,Li; Wan-Lu,67,0,70,3
1739697818988,CENG 113,B00,808994,Chen; Zheng,70,0,70,0
1739697820017,CENG 124B,A00,808995,Drews; Aaron,46,0,60,14
1739697820017,CENG 124B,B00,809012,Powell; Alyssa,51,0,60,9
1739697821045,CENG 160,A00,809013,Powell; Alyssa,65,0,70,5
1739697822070,CENG 170,A01,809059,Drews; Aaron,28,0,30,2
1739697823100,CENG 176B,A01,809097,Opatkiewicz; Justin Paul,55,0,60,5
1739697823100,CENG 176B,B01,809104,Shah; Nisarg,47,0,48,1
1739697824123,CENG 205,A00,809106,Jahed Motlagh; Zeinab,41,0,60,19
1739697825149,CENG 260,A00,809107,Powell; Alyssa,30,0,30,0
1739697826173,CENG 273,A00,809114,Shah; Nisarg,23,0,30,7
1739697827204,CGS 2B,A01,812749,Whitley; Leila Marie,23,0,25,2
1739697827204,CGS 2B,A02,812761,Whitley; Leila Marie,24,0,24,0
1739697828231,CGS 87,A00,812765,Wesling; Megan E.,20,0,20,0
1739697829256,CGS 100B,A00,812766,Whitley; Leila Marie,30,0,33,3
1739697830282,CGS 105,A01,812868,Wesling; Megan E.,22,0,23,1
1739697830282,CGS 105,A02,812869,Wesling; Megan E.,22,0,23,1
1739697830282,CGS 105,A03,812872,Wesling; Megan E.,23,0,23,0
1739697831306,CGS 106,A00,812873,Whitley; Leila Marie,46,0,50,4
1739697832332,CGS 112,A00,812902,Cuong; Marisol,30,0,30,0
1739697833361,CGS 114,A00,812906,Cuong; Marisol,20,0,22,2
1739697834388,CGS 117,A00,812907,Martin Sandino; Amanda Maria Yoland,13,0,16,3
1739697835416,CGS 120,A00,812908,Hankins; Joseph D.,21,0,22,1
1739697836443,CGS 121,A00,812916,Martin Sandino; Amanda Maria Yoland,20,0,20,0
1739697837467,CGS 122,A00,812917,Martin Sandino; Amanda Maria Yoland,19,0,20,1
1739697838491,CGS 147,A00,872913,Staff,20,0,20,0
1739697839518,CGS 196B,A00,812923,Taylor-Garcia; Daphne,0,0,0,0
1739697839518,CGS 196B,B00,812971,Hankins; Joseph D.,0,0,0,0
1739697839518,CGS 196B,C00,812978,Perez; Roy,0,0,0,0
1739697840546,CGS 198,001,812980,Anderson; Patrick W.,0,0,0,0
1739697840546,CGS 198,002,813054,Anderson; Patrick W.,0,0,0,0
1739697840546,CGS 198,003,813102,Anderson; Patrick W.,0,0,0,0
1739697840546,CGS 198,004,813257,Anderson; Patrick W.,0,0,0,0
1739697841574,CGS 200,A00,813286,Okonkwo; Holly,0,0,0,0
1739697842600,CHEM 6A,A01,860027,Lam; Tin Yiu,40,0,40,0
1739697842600,CHEM 6A,A02,860042,Lam; Tin Yiu,37,0,40,3
1739697842600,CHEM 6A,A03,860049,Lam; Tin Yiu,35,0,40,5
1739697842600,CHEM 6A,A04,860050,Lam; Tin Yiu,37,0,40,3
1739697842600,CHEM 6A,A05,860051,Lam; Tin Yiu,35,0,40,5
1739697842600,CHEM 6A,A06,860052,Lam; Tin Yiu,40,0,40,0
1739697842600,CHEM 6A,A07,860065,Lam; Tin Yiu,40,0,40,0
1739697842600,CHEM 6A,A08,860068,Lam; Tin Yiu,39,0,40,1
1739697843633,CHEM 6B,A01,859962,Lam; Tin Yiu,39,0,40,1
1739697843633,CHEM 6B,A02,859975,Lam; Tin Yiu,40,0,40,0
1739697843633,CHEM 6B,A03,859990,Lam; Tin Yiu,36,0,40,4
1739697843633,CHEM 6B,A04,859994,Lam; Tin Yiu,39,0,40,1
1739697843633,CHEM 6B,A05,859999,Lam; Tin Yiu,40,0,40,0
1739697843633,CHEM 6B,A06,860019,Lam; Tin Yiu,40,0,40,0
1739697843633,CHEM 6B,A07,860024,Lam; Tin Yiu,40,0,40,0
1739697843633,CHEM 6B,B01,861221,Zajac; Eva L,34,0,40,6
1739697843633,CHEM 6B,B02,861224,Zajac; Eva L,36,0,40,4
1739697843633,CHEM 6B,B03,861229,Zajac; Eva L,39,0,40,1
1739697843633,CHEM 6B,B04,861232,Zajac; Eva L,38,0,40,2
1739697843633,CHEM 6B,B05,861239,Zajac; Eva L,37,0,40,3
1739697843633,CHEM 6B,B06,861240,Zajac; Eva L,36,0,40,4
1739697843633,CHEM 6B,B07,861242,Zajac; Eva L,40,0,40,0
1739697844663,CHEM 6C,A01,861431,Hopkins; Patrycja Anna,35,0,40,5
1739697844663,CHEM 6C,A02,861466,Hopkins; Patrycja Anna,38,0,40,2
1739697844663,CHEM 6C,A03,861467,Hopkins; Patrycja Anna,40,0,40,0
1739697844663,CHEM 6C,A04,861530,Hopkins; Patrycja Anna,40,0,40,0
1739697844663,CHEM 6C,A05,861531,Hopkins; Patrycja Anna,38,0,40,2
1739697844663,CHEM 6C,A06,861622,Hopkins; Patrycja Anna,40,0,40,0
1739697844663,CHEM 6C,A07,861649,Hopkins; Patrycja Anna,39,0,40,1
1739697844663,CHEM 6C,A08,861650,Hopkins; Patrycja Anna,0,0,0,0
1739697844663,CHEM 6C,B01,861651,Zajac; Eva L,31,0,40,9
1739697844663,CHEM 6C,B02,861763,Zajac; Eva L,37,0,40,3
1739697844663,CHEM 6C,B03,861768,Zajac; Eva L,38,0,40,2
1739697844663,CHEM 6C,B04,861770,Zajac; Eva L,38,0,40,2
1739697844663,CHEM 6C,B05,861771,Zajac; Eva L,35,0,40,5
1739697844663,CHEM 6C,B06,861773,Zajac; Eva L,39,0,40,1
1739697844663,CHEM 6C,B07,861777,Zajac; Eva L,40,0,40,0
1739697844663,CHEM 6C,B08,861781,Zajac; Eva L,0,0,0,0
1739697844663,CHEM 6C,D01,859938,Stallings; Dontarie M,39,0,40,1
1739697844663,CHEM 6C,D02,859942,Stallings; Dontarie M,32,0,40,8
1739697844663,CHEM 6C,D03,859943,Stallings; Dontarie M,38,0,40,2
1739697844663,CHEM 6C,D04,859952,Stallings; Dontarie M,38,0,40,2
1739697844663,CHEM 6C,D05,859953,Stallings; Dontarie M,19,0,40,21
1739697844663,CHEM 6C,D06,859959,Stallings; Dontarie M,37,0,40,3
1739697844663,CHEM 6C,D07,859960,Stallings; Dontarie M,37,0,40,3
1739697844663,CHEM 6C,D08,859961,Stallings; Dontarie M,0,0,0,0
1739697844663,CHEM 6C,E01,861810,Debelouchina; Galia T,40,0,40,0
1739697844663,CHEM 6C,E02,861860,Debelouchina; Galia T,40,0,40,0
1739697844663,CHEM 6C,E03,861879,Debelouchina; Galia T,39,0,40,1
1739697844663,CHEM 6C,E04,861880,Debelouchina; Galia T,39,0,40,1
1739697844663,CHEM 6C,E05,861890,Debelouchina; Galia T,39,0,40,1
1739697844663,CHEM 6C,E06,861908,Debelouchina; Galia T,40,0,40,0
1739697844663,CHEM 6C,E07,861910,Debelouchina; Galia T,40,0,40,0
1739697844663,CHEM 6C,E08,861911,Debelouchina; Galia T,0,0,0,0
1739697845689,CHEM 6CH,A01,859928,Tezcan; Faik,39,0,40,1
1739697846717,CHEM 7L,A01,844470,Piercy; Marc Anthony,17,0,24,7
1739697846717,CHEM 7L,A02,844472,Piercy; Marc Anthony,21,0,24,3
1739697846717,CHEM 7L,A03,844473,Piercy; Marc Anthony,22,0,24,2
1739697846717,CHEM 7L,A04,844475,Piercy; Marc Anthony,24,0,24,0
1739697846717,CHEM 7L,A05,844476,Piercy; Marc Anthony,23,0,24,1
1739697846717,CHEM 7L,A06,844482,Piercy; Marc Anthony,22,0,24,2
1739697846717,CHEM 7L,A07,844490,Piercy; Marc Anthony,20,0,24,4
1739697846717,CHEM 7L,A08,844493,Piercy; Marc Anthony,24,0,24,0
1739697846717,CHEM 7L,A09,844496,Piercy; Marc Anthony,23,0,24,1
1739697846717,CHEM 7L,A10,844503,Piercy; Marc Anthony,24,0,24,0
1739697846717,CHEM 7L,B01,844506,Piercy; Marc Anthony,2,0,24,22
1739697846717,CHEM 7L,B02,844508,Piercy; Marc Anthony,23,0,24,1
1739697846717,CHEM 7L,B03,844661,Piercy; Marc Anthony,22,0,24,2
1739697846717,CHEM 7L,B04,844716,Piercy; Marc Anthony,24,0,24,0
1739697846717,CHEM 7L,B05,844717,Piercy; Marc Anthony,21,0,24,3
1739697846717,CHEM 7L,B06,844719,Piercy; Marc Anthony,22,0,24,2
1739697846717,CHEM 7L,B07,844841,Piercy; Marc Anthony,24,0,24,0
1739697846717,CHEM 7L,B08,845021,Piercy; Marc Anthony,23,0,24,1
1739697846717,CHEM 7L,B09,845022,Piercy; Marc Anthony,23,0,24,1
1739697846717,CHEM 7L,B10,845184,Piercy; Marc Anthony,24,0,24,0
1739697847744,CHEM 7LM,A01,845187,Leigh; Brian,24,0,24,0
1739697847744,CHEM 7LM,A02,845321,Leigh; Brian,21,0,21,0
1739697847744,CHEM 7LM,A03,845322,Leigh; Brian,24,0,24,0
1739697847744,CHEM 7LM,A04,845340,Leigh; Brian,19,0,21,2
1739697847744,CHEM 7LM,A05,845350,Leigh; Brian,23,0,24,1
1739697847744,CHEM 7LM,A06,845398,Leigh; Brian,21,0,21,0
1739697847744,CHEM 7LM,A07,845399,Leigh; Brian,18,0,24,6
1739697847744,CHEM 7LM,A08,845406,Leigh; Brian,20,0,21,1
1739697848770,CHEM 11,A01,861914,Albizati; Kim F.,37,0,40,3
1739697848770,CHEM 11,A02,861934,Albizati; Kim F.,38,0,40,2
1739697848770,CHEM 11,A03,861939,Albizati; Kim F.,40,0,40,0
1739697848770,CHEM 11,A04,861940,Albizati; Kim F.,40,0,40,0
1739697848770,CHEM 11,A05,861951,Albizati; Kim F.,36,0,40,4
1739697848770,CHEM 11,A06,861975,Albizati; Kim F.,40,0,40,0
1739697849797,CHEM 40A,A01,861976,Hopkins; Patrycja Anna,32,0,40,8
1739697849797,CHEM 40A,A02,861977,Hopkins; Patrycja Anna,36,0,40,4
1739697849797,CHEM 40A,A03,861978,Hopkins; Patrycja Anna,37,0,40,3
1739697849797,CHEM 40A,A04,862061,Hopkins; Patrycja Anna,38,0,40,2
1739697849797,CHEM 40A,A05,862062,Hopkins; Patrycja Anna,38,0,40,2
1739697849797,CHEM 40A,A06,862063,Hopkins; Patrycja Anna,37,0,40,3
1739697849797,CHEM 40A,A07,862064,Hopkins; Patrycja Anna,39,0,40,1
1739697849797,CHEM 40A,A08,862065,Hopkins; Patrycja Anna,37,0,40,3
1739697850826,CHEM 40B,A01,862066,Weizman; Haim,29,0,40,11
1739697850826,CHEM 40B,A02,862067,Weizman; Haim,38,0,40,2
1739697850826,CHEM 40B,A03,862077,Weizman; Haim,40,0,40,0
1739697850826,CHEM 40B,A04,862085,Weizman; Haim,37,0,40,3
1739697850826,CHEM 40B,A05,862086,Weizman; Haim,34,0,40,6
1739697850826,CHEM 40B,A06,862087,Weizman; Haim,40,0,40,0
1739697850826,CHEM 40B,A07,862088,Weizman; Haim,39,0,40,1
1739697850826,CHEM 40B,A08,862089,Weizman; Haim,0,0,0,0
1739697851850,CHEM 41B,A01,860069,Klosterman; Jeremy K,32,0,40,8
1739697851850,CHEM 41B,A02,860074,Klosterman; Jeremy K,38,0,40,2
1739697851850,CHEM 41B,A03,860081,Klosterman; Jeremy K,39,0,40,1
1739697852880,CHEM 41C,A01,862090,Romero; Nathan A,39,0,40,1
1739697852880,CHEM 41C,A02,862091,Romero; Nathan A,40,0,40,0
1739697852880,CHEM 41C,A03,862092,Romero; Nathan A,39,0,40,1
1739697852880,CHEM 41C,A04,862213,Romero; Nathan A,39,0,40,1
1739697852880,CHEM 41C,A05,862214,Romero; Nathan A,38,0,40,2
1739697852880,CHEM 41C,A06,862215,Romero; Nathan A,40,0,40,0
1739697852880,CHEM 41C,A07,862216,Romero; Nathan A,38,0,40,2
1739697853916,CHEM 43A,A01,845450,Ternansky; Robert J.,15,0,24,9
1739697853916,CHEM 43A,A02,845676,Ternansky; Robert J.,21,0,24,3
1739697853916,CHEM 43A,A03,845679,Ternansky; Robert J.,21,0,24,3
1739697853916,CHEM 43A,A04,845682,Ternansky; Robert J.,23,0,24,1
1739697853916,CHEM 43A,A05,845684,Ternansky; Robert J.,22,0,24,2
1739697853916,CHEM 43A,A06,845686,Ternansky; Robert J.,19,0,24,5
1739697853916,CHEM 43A,A07,845692,Ternansky; Robert J.,22,0,24,2
1739697853916,CHEM 43A,A08,845694,Ternansky; Robert J.,17,0,24,7
1739697853916,CHEM 43A,A09,845697,Ternansky; Robert J.,24,0,24,0
1739697853916,CHEM 43A,A10,845698,Ternansky; Robert J.,23,0,24,1
1739697853916,CHEM 43A,A11,845700,Ternansky; Robert J.,23,0,24,1
1739697853916,CHEM 43A,A12,845702,Ternansky; Robert J.,24,0,24,0
1739697853916,CHEM 43A,A13,845704,Ternansky; Robert J.,22,0,24,2
1739697853916,CHEM 43A,B01,845707,Ternansky; Robert J.,23,0,24,1
1739697853916,CHEM 43A,B02,845712,Ternansky; Robert J.,22,0,24,2
1739697853916,CHEM 43A,B03,845794,Ternansky; Robert J.,14,0,24,10
1739697853916,CHEM 43A,B04,845797,Ternansky; Robert J.,20,0,24,4
1739697853916,CHEM 43A,B05,845800,Ternansky; Robert J.,22,0,24,2
1739697853916,CHEM 43A,B06,845801,Ternansky; Robert J.,20,0,24,4
1739697853916,CHEM 43A,B07,845816,Ternansky; Robert J.,21,0,24,3
1739697853916,CHEM 43A,B08,845817,Ternansky; Robert J.,19,0,24,5
1739697853916,CHEM 43A,B09,845827,Ternansky; Robert J.,23,0,24,1
1739697853916,CHEM 43A,B10,845832,Ternansky; Robert J.,22,0,24,2
1739697853916,CHEM 43A,B11,845866,Ternansky; Robert J.,22,0,24,2
1739697853916,CHEM 43A,B12,845867,Ternansky; Robert J.,21,0,24,3
1739697854943,CHEM 96,A00,845868,Brydges; Stacey,18,0,20,2
1739697855970,CHEM 100A,A01,845921,Staff,0,0,0,0
1739697855970,CHEM 100A,A02,845922,Staff,0,0,0,0
1739697855970,CHEM 100A,A03,845983,Staff,0,0,0,0
1739697855970,CHEM 100A,A04,845984,Staff,0,0,0,0
1739697855970,CHEM 100A,A05,845985,Staff,0,0,0,0
1739697855970,CHEM 100A,A06,845986,Staff,0,0,0,0
1739697856995,CHEM 100B,A01,845988,Pomeroy; Robert S.,27,0,30,3
1739697858021,CHEM 105A,A01,845991,Young; Mark,33,0,40,7
1739697859048,CHEM 108,A01,845993,Mrse; Anthony Adrian,18,0,20,2
1739697859048,CHEM 108,A02,845994,Mrse; Anthony Adrian,18,0,24,6
1739697859048,CHEM 108,B01,845996,Mrse; Anthony Adrian,16,0,20,4
1739697859048,CHEM 108,B02,845997,Mrse; Anthony Adrian,23,0,24,1
1739697860078,CHEM 109,A01,845999,McHugh; Colleen A,11,0,20,9
1739697860078,CHEM 109,A02,846000,McHugh; Colleen A,24,0,24,0
1739697860078,CHEM 109,B01,846002,McHugh; Colleen A,18,0,20,2
1739697860078,CHEM 109,B02,846003,McHugh; Colleen A,23,0,24,1
1739697861105,CHEM 114B,A01,862223,Mishanina; Tatiana V,37,0,40,3
1739697861105,CHEM 114B,A02,862224,Mishanina; Tatiana V,40,0,40,0
1739697861105,CHEM 114B,A03,862225,Mishanina; Tatiana V,40,0,40,0
1739697862136,CHEM 114C,A01,859769,Joseph; Simpson,35,0,40,5
1739697862136,CHEM 114C,A02,859782,Joseph; Simpson,29,0,40,11
1739697862136,CHEM 114C,A03,859790,Joseph; Simpson,25,0,40,15
1739697862136,CHEM 114C,A04,859791,Joseph; Simpson,40,0,40,0
1739697862136,CHEM 114C,A05,859793,Joseph; Simpson,37,0,40,3
1739697862136,CHEM 114C,A06,859804,Joseph; Simpson,37,0,40,3
1739697862136,CHEM 114C,A07,859805,Joseph; Simpson,0,0,0,0
1739697862136,CHEM 114C,A08,859810,Joseph; Simpson,0,0,0,0
1739697863168,CHEM 114D,A00,846006,Ghosh; Gourisankar,19,0,25,6
1739697864194,CHEM 118,A01,862235,Donoghue; Daniel J.,28,0,40,12
1739697864194,CHEM 118,A02,862236,Donoghue; Daniel J.,38,0,40,2
1739697864194,CHEM 118,A03,862238,Donoghue; Daniel J.,28,0,40,12
1739697864194,CHEM 118,A04,862240,Donoghue; Daniel J.,39,0,40,1
1739697864194,CHEM 118,A05,862242,Donoghue; Daniel J.,39,0,40,1
1739697864194,CHEM 118,A06,862243,Donoghue; Daniel J.,39,0,40,1
1739697865222,CHEM 120B,A01,859811,Staff,32,0,40,8
1739697865222,CHEM 120B,A02,859812,Staff,39,0,40,1
1739697865222,CHEM 120B,A03,859813,Staff,0,0,0,0
1739697866252,CHEM 123,A00,846009,Schimpf; Alina M,0,0,0,2
1739697867277,CHEM 125,A00,846010,Tezcan; Faik,17,0,20,3
1739697868307,CHEM 126B,A01,859888,Tauber; Michael,28,0,40,12
1739697868307,CHEM 126B,A02,859927,Tauber; Michael,0,0,0,0
1739697869333,CHEM 132,A01,862270,Tauber; Michael,39,0,40,1
1739697869333,CHEM 132,A02,862271,Tauber; Michael,36,0,40,4
1739697870358,CHEM 135,A01,860846,Xiong; Wei,14,0,15,1
1739697871386,CHEM 143B,A01,846015,Klosterman; Jeremy K,20,0,24,4
1739697871386,CHEM 143B,A02,846016,Klosterman; Jeremy K,15,0,24,9
1739697872413,CHEM 156,A00,846017,Romero; Erik Anthony,29,0,30,1
1739697873438,CHEM 157,A00,846018,Tor; Yitzhak,75,0,80,5
1739697874467,CHEM 158,A00,846020,Molinski; Tadeusz,9,0,10,1
1739697875494,CHEM 167,A01,862285,Deshmukh; Lalit,36,0,40,4
1739697875494,CHEM 167,A02,862286,Deshmukh; Lalit,39,0,40,1
1739697875494,CHEM 167,A03,862287,Deshmukh; Lalit,37,0,40,3
1739697875494,CHEM 167,A04,862288,Deshmukh; Lalit,39,0,40,1
1739697876522,CHEM 173,A00,846023,Young; Mark,36,0,40,4
1739697877549,CHEM 174,A01,851594,Pomeroy; Robert S.,59,0,60,1
1739697878579,CHEM 185,A00,846025,Paesani; Francesco,21,0,26,5
1739697879604,CHEM 188,A00,846026,Brydges; Stacey,20,0,20,0
1739697880630,CHEM 207,A00,846088,Deshmukh; Lalit,23,0,30,7
1739697881655,CHEM 214,A00,846089,Ghosh; Gourisankar,5,0,15,10
1739697882680,CHEM 217,A00,846092,Joseph; Simpson,15,0,30,15
1739697883705,CHEM 225,A00,846095,Tezcan; Faik,6,0,10,4
1739697884731,CHEM 227,A00,846097,Schimpf; Alina M,30,0,30,0
1739697885760,CHEM 229,A00,846100,Stauber; Julia Megan,19,0,20,1
1739697886785,CHEM 235,A01,860847,Xiong; Wei,17,0,20,3
1739697887810,CHEM 236,A00,846106,Kummel; Andrew C,5,0,15,10
1739697888835,CHEM 237,A00,872555,Esko; Jeffrey D.,7,0,7,0
1739697889863,CHEM 250,A00,846107,Weizman; Haim,0,0,0,0
1739697890888,CHEM 256,A00,846108,Romero; Erik Anthony,20,0,20,0
1739697891913,CHEM 257,A00,846109,Tor; Yitzhak,28,0,30,2
1739697892937,CHEM 258,A00,846110,Molinski; Tadeusz,14,0,15,1
1739697893965,CHEM 262,A00,846111,Kubiak; Clifford Paul,26,0,30,4
1739697894993,CHEM 273,A00,846118,Young; Mark,15,0,20,5
1739697896020,CHEM 276,A00,846119,Mc Culloch; Andrew Douglas,4,0,5,1
1739697897047,CHEM 283,A00,846120,Ghassemian; Majid,10,0,10,0
1739697898074,CHEM 285,A00,846121,Paesani; Francesco,19,0,20,1
1739697899100,CHEM 291,A00,846122,Debelouchina; Galia T,20,0,20,0
1739697900127,CHEM 294,A00,846123,Pun; Andrew Brian,48,0,50,2
1739697901150,CHIN 10CD,A01,809156,Liu; Mingming,17,0,17,0
1739697901150,CHIN 10CD,A02,809192,Liu; Mingming,18,0,18,0
1739697902181,CHIN 10CM,A01,809196,Chen; Pei-Chia,15,0,15,0
1739697902181,CHIN 10CM,A02,809197,Chen; Pei-Chia,20,0,20,0
1739697903213,CHIN 10CN,A01,809203,Xu; Li,12,0,14,2
1739697903213,CHIN 10CN,A03,809218,Xu; Li,14,0,14,0
1739697903213,CHIN 10CN,B01,809296,Xu; Li,13,0,14,1
1739697903213,CHIN 10CN,B02,809307,Xu; Li,10,0,14,4
1739697903213,CHIN 10CN,B03,809361,Xu; Li,14,0,14,0
1739697904239,CHIN 20CM,A01,809437,Wang; Xiao,10,0,10,0
1739697904239,CHIN 20CM,A02,809458,Wang; Xiao,10,0,10,0
1739697905271,CHIN 20CN,A01,809462,Anderson; Qin-Hong,12,0,12,0
1739697905271,CHIN 20CN,A02,809463,Anderson; Qin-Hong,12,0,12,0
1739697905271,CHIN 20CN,A03,871383,Anderson; Qin-Hong,12,0,12,0
1739697905271,CHIN 20CN,B01,809488,Anderson; Qin-Hong,12,0,12,0
1739697906295,CHIN 100CM,A00,809489,Anderson; Qin-Hong,23,0,24,1
1739697907319,CHIN 100CN,A00,809490,Chen; Pei-Chia,24,0,24,0
1739697908347,CHIN 169B,A00,809720,Wang; Xiao,20,0,20,0
1739697909426,CHIN 182B,A00,809728,Liu; Mingming,17,0,20,3
1739697910451,CLAS 196B,A00,869154,Myerston Santana; Jacobo,1,0,1,0
1739697911477,CLIN 294C,A00,870690,Wierenga; Christina E & Banks; Sarah Jane,20,0,20,0
1739697912507,CLIN 296,001,870694,Brookman; Lauren Irene,100,0,100,0
1739697912507,CLIN 296,002,870695,Brookman; Lauren Irene,10,0,10,0
1739697912507,CLIN 296,003,870696,Wall; Tamara Lynn,100,0,100,0
1739697913535,CLRE 238R,A00,809924,Mehta; Ravindra L.,9999,0,9999,0
1739697914563,CLRE 254,A00,809952,Vaida; Florin,9999,0,9999,0
1739697915589,CLRE 255,A01,809989,Cuomo; Raphael Eduardo,9999,0,9999,0
1739697916615,CLRE 256,A01,810211,Morris; Sheldon,9999,0,9999,0
1739697917640,CLRE 257,A00,810214,Mehta; Ravindra L.,9999,0,9999,0
1739697918665,CLRE 258,A00,810216,Mehta; Ravindra L.,9999,0,9999,0
1739697919692,CLRE 260,A00,810217,Cuomo; Raphael Eduardo,9999,0,9999,0
1739697920717,CLRE 265,A00,810220,Vaida; Florin,9999,0,9999,0
1739697921742,CLRE 297,001,810222,Cuomo; Raphael Eduardo,9999,0,9999,0
1739697922766,CLX 87,A00,809115,Castro; Robert Jess,20,0,20,0
1739697923790,CMM 225,A00,872556,Esko; Jeffrey D.,7,0,7,0
1739697924818,CMM 246,A00,872560,Gordts; Philip & Lewis; Amanda Lark & Godula; Kamil & Gagneux; Pascal & Esko; Jeffrey D. & Bode; Lars,10,0,10,0
1739697925843,CMM 250,A00,884466,Willert; Karl Heinrich,60,0,60,0
1739697926870,COGR 201D,A00,808201,Serlin; David,10,0,10,0
1739697927897,COGR 219,A00,808207,Harb; Anthony Joseph,5,0,10,5
1739697928923,COGR 225B,A00,808212,Gere; Catherina M.,10,0,10,0
1739697929948,COGR 225C,A00,808214,McKenzie; Kerry V.,10,0,10,0
1739697930974,COGR 275,A00,808219,Jack; Caroline Sarah,8,0,10,2
1739697931999,COGR 296,A00,808221,Ybarra; Megan,5,0,5,0
1739697933034,COGS 1,A01,810294,Deak; Gedeon O.,58,0,60,2
1739697933034,COGS 1,A02,810296,Deak; Gedeon O.,57,0,60,3
1739697933034,COGS 1,A03,810298,Deak; Gedeon O.,56,0,60,4
1739697933034,COGS 1,A04,810299,Deak; Gedeon O.,57,0,60,3
1739697933034,COGS 1,A05,810300,Deak; Gedeon O.,60,0,60,0
1739697933034,COGS 1,A06,810301,Deak; Gedeon O.,59,0,60,1
1739697933034,COGS 1,A07,810302,Deak; Gedeon O.,57,0,57,0
1739697934063,COGS 2,A01,810304,Boyle; Mary E. T.,54,0,56,2
1739697934063,COGS 2,A02,810305,Boyle; Mary E. T.,56,0,56,0
1739697934063,COGS 2,A03,810307,Boyle; Mary E. T.,54,0,56,2
1739697934063,COGS 2,A04,810309,Boyle; Mary E. T.,57,0,60,3
1739697934063,COGS 2,A05,810310,Boyle; Mary E. T.,67,0,67,0
1739697935092,COGS 9,A01,810312,Shannon; Kyle Michael,49,0,50,1
1739697935092,COGS 9,A02,810313,Shannon; Kyle Michael,49,0,50,1
1739697935092,COGS 9,A03,810314,Shannon; Kyle Michael,49,0,50,1
1739697935092,COGS 9,A04,810316,Shannon; Kyle Michael,50,0,50,0
1739697935092,COGS 9,A05,810320,Shannon; Kyle Michael,50,0,50,0
1739697935092,COGS 9,A06,810321,Shannon; Kyle Michael,49,0,50,1
1739697936117,COGS 11,A01,810324,Boroditsky; Lera,135,0,140,5
1739697937144,COGS 13,A01,810328,Rossano; Federico,42,0,50,8
1739697937144,COGS 13,A02,810329,Rossano; Federico,48,0,49,1
1739697937144,COGS 13,A03,810330,Rossano; Federico,48,0,50,2
1739697937144,COGS 13,A04,810331,Rossano; Federico,48,0,49,1
1739697937144,COGS 13,A05,810332,Rossano; Federico,48,0,49,1
1739697937144,COGS 13,A06,810333,Rossano; Federico,49,0,49,0
1739697938174,COGS 14A,A01,810335,Barrera; Steven James,45,0,50,5
1739697938174,COGS 14A,A02,810336,Barrera; Steven James,47,0,50,3
1739697938174,COGS 14A,A03,810338,Barrera; Steven James,49,0,50,1
1739697938174,COGS 14A,A04,810339,Barrera; Steven James,56,0,60,4
1739697938174,COGS 14A,A05,810340,Barrera; Steven James,50,0,50,0
1739697938174,COGS 14A,A06,810341,Barrera; Steven James,50,0,50,0
1739697938174,COGS 14A,A07,810343,Barrera; Steven James,54,0,56,2
1739697939202,COGS 14B,A01,810346,Hoffman; Drew Ellen,54,0,57,3
1739697939202,COGS 14B,A02,810347,Hoffman; Drew Ellen,55,0,55,0
1739697939202,COGS 14B,A03,810348,Hoffman; Drew Ellen,52,0,55,3
1739697939202,COGS 14B,A04,810350,Hoffman; Drew Ellen,54,0,55,1
1739697939202,COGS 14B,A05,810351,Hoffman; Drew Ellen,53,0,55,2
1739697940229,COGS 17,A01,810353,Johnson; Christine M.,49,0,50,1
1739697940229,COGS 17,A02,810354,Johnson; Christine M.,48,0,50,2
1739697940229,COGS 17,A03,810356,Johnson; Christine M.,48,0,50,2
1739697940229,COGS 17,A04,810357,Johnson; Christine M.,47,0,50,3
1739697940229,COGS 17,A05,810359,Johnson; Christine M.,49,0,50,1
1739697940229,COGS 17,A06,810360,Johnson; Christine M.,50,0,50,0
1739697940229,COGS 17,A07,810361,Johnson; Christine M.,52,0,55,3
1739697940229,COGS 17,A08,810362,Johnson; Christine M.,54,0,55,1
1739697941259,COGS 18,A01,810366,Ellis; Shannon Elizabeth,31,0,35,4
1739697941259,COGS 18,A02,810367,Ellis; Shannon Elizabeth,31,0,35,4
1739697941259,COGS 18,A03,810371,Ellis; Shannon Elizabeth,30,0,35,5
1739697941259,COGS 18,A04,810372,Ellis; Shannon Elizabeth,34,0,35,1
1739697941259,COGS 18,A05,810373,Ellis; Shannon Elizabeth,32,0,35,3
1739697941259,COGS 18,A06,810374,Ellis; Shannon Elizabeth,35,0,35,0
1739697941259,COGS 18,A07,810375,Ellis; Shannon Elizabeth,35,0,35,0
1739697941259,COGS 18,A08,810376,Ellis; Shannon Elizabeth,34,0,35,1
1739697941259,COGS 18,A09,810377,Ellis; Shannon Elizabeth,35,0,35,0
1739697941259,COGS 18,B01,810379,Ellis; Shannon Elizabeth,33,0,35,2
1739697941259,COGS 18,B02,810384,Ellis; Shannon Elizabeth,34,0,35,1
1739697941259,COGS 18,B03,810385,Ellis; Shannon Elizabeth,34,0,35,1
1739697941259,COGS 18,B04,810388,Ellis; Shannon Elizabeth,34,0,35,1
1739697941259,COGS 18,B05,810389,Ellis; Shannon Elizabeth,31,0,35,4
1739697941259,COGS 18,B06,810390,Ellis; Shannon Elizabeth,31,0,35,4
1739697941259,COGS 18,B07,810392,Ellis; Shannon Elizabeth,34,0,35,1
1739697941259,COGS 18,B08,810393,Ellis; Shannon Elizabeth,34,0,35,1
1739697941259,COGS 18,B09,810395,Ellis; Shannon Elizabeth,32,0,35,3
1739697942283,COGS 87,A00,810426,Deak; Gedeon O.,20,0,20,0
1739697943312,COGS 100,A01,810564,Morgan; Eric,49,0,56,7
1739697943312,COGS 100,A02,810582,Morgan; Eric,54,0,56,2
1739697943312,COGS 100,A03,810589,Morgan; Eric,55,0,56,1
1739697943312,COGS 100,A04,810651,Morgan; Eric,54,0,56,2
1739697943312,COGS 100,A05,810684,Morgan; Eric,56,0,56,0
1739697943312,COGS 100,A06,810690,Morgan; Eric,54,0,56,2
1739697944337,COGS 101A,A01,810697,Morgan; Eric,49,0,50,1
1739697944337,COGS 101A,A02,810701,Morgan; Eric,49,0,50,1
1739697944337,COGS 101A,A03,810707,Morgan; Eric,49,0,50,1
1739697944337,COGS 101A,A04,810708,Morgan; Eric,50,0,50,0
1739697945366,COGS 101B,A01,810716,Barrera; Steven James,49,0,50,1
1739697945366,COGS 101B,A02,810718,Barrera; Steven James,45,0,50,5
1739697945366,COGS 101B,A03,810719,Barrera; Steven James,47,0,50,3
1739697945366,COGS 101B,A04,810730,Barrera; Steven James,38,0,50,12
1739697946392,COGS 101C,A01,810737,Cooperrider; Kensy A,50,0,50,0
1739697946392,COGS 101C,A02,810742,Cooperrider; Kensy A,43,0,50,7
1739697946392,COGS 101C,A03,810743,Cooperrider; Kensy A,48,0,50,2
1739697947423,COGS 102A,A01,810750,Allen; Michael Gordon,49,0,50,1
1739697947423,COGS 102A,A02,810751,Allen; Michael Gordon,50,0,50,0
1739697947423,COGS 102A,A03,810754,Allen; Michael Gordon,44,0,49,5
1739697948452,COGS 107A,A01,810756,Boyle; Mary E. T.,54,0,56,2
1739697948452,COGS 107A,A02,810757,Boyle; Mary E. T.,52,0,56,4
1739697948452,COGS 107A,A03,810760,Boyle; Mary E. T.,55,0,56,1
1739697948452,COGS 107A,A04,810767,Boyle; Mary E. T.,54,0,56,2
1739697948452,COGS 107A,A05,810769,Boyle; Mary E. T.,54,0,56,2
1739697948452,COGS 107A,A06,810777,Boyle; Mary E. T.,55,0,56,1
1739697949481,COGS 107B,A03,810800,Mooshagian; Eric Frederick,41,0,50,9
1739697949481,COGS 107B,A04,810810,Mooshagian; Eric Frederick,33,0,50,17
1739697949481,COGS 107B,A05,810811,Mooshagian; Eric Frederick,44,0,50,6
1739697950507,COGS 107C,A01,810815,Chiba; Andrea,41,0,47,6
1739697950507,COGS 107C,A02,810816,Chiba; Andrea,35,0,50,15
1739697950507,COGS 107C,A03,810853,Chiba; Andrea,44,0,49,5
1739697951539,COGS 108,A01,810862,Fleischer; Jason G,42,0,50,8
1739697951539,COGS 108,A02,810870,Fleischer; Jason G,42,0,50,8
1739697951539,COGS 108,A03,810871,Fleischer; Jason G,50,0,50,0
1739697951539,COGS 108,A04,810874,Fleischer; Jason G,49,0,50,1
1739697951539,COGS 108,A05,810876,Fleischer; Jason G,47,0,50,3
1739697951539,COGS 108,A06,810879,Fleischer; Jason G,48,0,50,2
1739697951539,COGS 108,A07,810896,Fleischer; Jason G,50,0,50,0
1739697951539,COGS 108,B01,810950,Fleischer; Jason G,54,0,56,2
1739697951539,COGS 108,B02,810960,Fleischer; Jason G,54,0,56,2
1739697951539,COGS 108,B03,810961,Fleischer; Jason G,52,0,56,4
1739697951539,COGS 108,B04,810962,Fleischer; Jason G,43,0,60,17
1739697951539,COGS 108,B05,810963,Fleischer; Jason G,58,0,60,2
1739697951539,COGS 108,B06,810964,Fleischer; Jason G,58,0,60,2
1739697951539,COGS 108,B07,810965,Fleischer; Jason G,62,0,62,0
1739697953599,COGS 112,A01,811001,Hoffman; Drew Ellen,34,0,50,16
1739697953599,COGS 112,A02,811020,Hoffman; Drew Ellen,42,0,50,8
1739697953599,COGS 112,A03,811045,Hoffman; Drew Ellen,44,0,50,6
1739697953599,COGS 112,A04,811047,Hoffman; Drew Ellen,49,0,50,1
1739697954633,COGS 124,A00,811065,Guo; Philip J,1,0,25,24
1739697955658,COGS 125,A00,811079,Klemmer; Scott R,43,0,50,7
1739697956684,COGS 142,A01,811081,Rossano; Federico,50,0,50,0
1739697957713,COGS 143,A01,811108,Staff,46,0,50,4
1739697958742,COGS 150,A01,811185,Trott; Sean Thomas,35,0,50,15
1739697958742,COGS 150,A02,811319,Trott; Sean Thomas,50,0,50,0
1739697958742,COGS 150,A03,811360,Trott; Sean Thomas,42,0,49,7
1739697959771,COGS 157,A00,811371,Creel; Sarah,66,0,75,9
1739697960799,COGS 160,A00,872440,Saygin; Ayse P,29,0,30,1
1739697960799,COGS 160,B00,872441,Saygin; Ayse P,30,0,30,0
1739697960799,COGS 160,C00,872442,Kirsh; David Joel,30,0,30,0
1739697961825,COGS 172,A01,811389,Greene; Deanna Jacquelyn,46,0,50,4
1739697961825,COGS 172,A02,811390,Greene; Deanna Jacquelyn,48,0,50,2
1739697961825,COGS 172,A03,811391,Greene; Deanna Jacquelyn,45,0,50,5
1739697961825,COGS 172,A04,811392,Greene; Deanna Jacquelyn,47,0,50,3
1739697963881,COGS 179,A01,811401,Staff,43,0,50,7
1739697964908,COGS 184,A01,811403,Johnson; Christine M.,46,0,50,4
1739697965935,COGS 185,A01,811514,Tu; Zhuowen,38,0,50,12
1739697965935,COGS 185,A02,811580,Tu; Zhuowen,46,0,50,4
1739697966962,COGS 187A,A01,811589,Allen; Michael Gordon,45,0,50,5
1739697966962,COGS 187A,A02,811590,Allen; Michael Gordon,46,0,50,4
1739697966962,COGS 187A,A03,811591,Allen; Michael Gordon,44,0,49,5
1739697968001,COGS 190C,001,811592,Chiba; Andrea,9999,0,9999,0
1739697968001,COGS 190C,002,811601,Fleischer; Jason G,9999,0,9999,0
1739697968001,COGS 190C,003,811602,Boyle; Mary E. T.,9999,0,9999,0
1739697968001,COGS 190C,004,811604,Nitz; Douglas A.,9999,0,9999,0
1739697968001,COGS 190C,005,811605,Rangel; Lara M,9999,0,9999,0
1739697968001,COGS 190C,006,811609,Hoffman; Drew Ellen,9999,0,9999,0
1739697968001,COGS 190C,007,811610,Deak; Gedeon O.,9999,0,9999,0
1739697968001,COGS 190C,008,811613,Kiyonaga; Anastasia,9999,0,9999,0
1739697968001,COGS 190C,009,811716,Creel; Sarah,9999,0,9999,0
1739697968001,COGS 190C,010,811733,Voytek; Bradley Thomas,9999,0,9999,0
1739697968001,COGS 190C,011,811836,Beatty-Martinez; Anne,9999,0,9999,0
1739697968001,COGS 190C,012,811838,De Sa; Virginia,9999,0,9999,0
1739697968001,COGS 190C,013,811839,Kirsh; David Joel,9999,0,9999,0
1739697968001,COGS 190C,014,811843,Jernigan; Terry Lynne,9999,0,9999,0
1739697968001,COGS 190C,015,811844,Tu; Zhuowen,9999,0,9999,0
1739697969027,COGS 190D,A00,811922,Voytek; Bradley Thomas,25,0,25,0
1739697970052,COGS 194,A00,811949,Hill; Seth J,9999,0,9999,0
1739697971084,COGS 202,A00,872444,Khosla; Meenakshi,12,0,25,13
1739697972111,COGS 205,A00,812100,Chiba; Andrea,20,0,20,0
1739697973136,COGS 209,A00,812101,Mukamel; Eran A,25,0,46,21
1739697974160,COGS 210C,A00,812186,Kirsh; David Joel,9999,0,9999,0
1739697974160,COGS 210C,B00,812192,Greene; Deanna Jacquelyn,9999,0,9999,0
1739697974160,COGS 210C,C00,812199,Xia; Haijun,9999,0,9999,0
1739697974160,COGS 210C,D00,812206,Nitz; Douglas A.,9999,0,9999,0
1739697974160,COGS 210C,E00,812207,Hollan; James D.,9999,0,9999,0
1739697974160,COGS 210C,F00,812260,De Sa; Virginia,9999,0,9999,0
1739697974160,COGS 210C,G00,812261,Rossano; Federico,9999,0,9999,0
1739697974160,COGS 210C,H00,812262,Kiyonaga; Anastasia,9999,0,9999,0
1739697974160,COGS 210C,I00,812263,Guo; Philip J,9999,0,9999,0
1739697974160,COGS 210C,J00,812264,Dow; Steven P,9999,0,9999,0
1739697974160,COGS 210C,K00,812265,Bergen; Benjamin,9998,0,9999,1
1739697974160,COGS 210C,L00,812266,Coulson; Seana M,9999,0,9999,0
1739697974160,COGS 210C,M00,812267,Rangel; Lara M,9999,0,9999,0
1739697975187,COGS 211C,A00,812268,Boroditsky; Lera,19,0,20,1
1739697976211,COGS 229,A00,812269,Irani; Lilly C & Shvartzberg Carrio; Manuel,10,0,10,0
1739697977239,COGS 231,A00,812270,Guo; Philip J,0,0,20,20
1739697978265,COGS 238,A00,812271,Bergen; Benjamin,18,0,20,2
1739697979295,COMM 10,A01,807316,Whitworth-Smith; Andrew C,22,0,23,1
1739697979295,COMM 10,A02,807320,Whitworth-Smith; Andrew C,23,0,23,0
1739697979295,COMM 10,A03,807321,Whitworth-Smith; Andrew C,23,0,23,0
1739697979295,COMM 10,A04,807324,Whitworth-Smith; Andrew C,23,0,23,0
1739697979295,COMM 10,A05,807328,Whitworth-Smith; Andrew C,17,0,23,6
1739697979295,COMM 10,A06,807329,Whitworth-Smith; Andrew C,21,0,23,2
1739697979295,COMM 10,A07,807330,Whitworth-Smith; Andrew C,21,0,23,2
1739697979295,COMM 10,A08,807333,Whitworth-Smith; Andrew C,21,0,22,1
1739697979295,COMM 10,A09,807334,Whitworth-Smith; Andrew C,23,0,23,0
1739697979295,COMM 10,A11,807363,Whitworth-Smith; Andrew C,0,0,0,0
1739697979295,COMM 10,A12,807364,Whitworth-Smith; Andrew C,0,0,0,0
1739697979295,COMM 10,A13,807366,Whitworth-Smith; Andrew C,23,0,23,0
1739697979295,COMM 10,A15,807374,Whitworth-Smith; Andrew C,0,0,0,0
1739697979295,COMM 10,A16,807427,Whitworth-Smith; Andrew C,23,0,23,0
1739697979295,COMM 10,A17,807428,Whitworth-Smith; Andrew C,23,0,23,0
1739697979295,COMM 10,A18,807429,Whitworth-Smith; Andrew C,0,0,0,0
1739697980320,COMM 20,A01,807435,Hill; Erin Truesdell,72,0,75,3
1739697981358,COMM 30,A00,807436,Metcalf; Kathryne Young,73,0,75,2
1739697982383,COMM 50,A00,807438,Armenta; John E,22,0,25,3
1739697983413,COMM 80,A01,807440,Campbell; Robert Harold,0,0,0,0
1739697984440,COMM 100B,A01,807446,Serlin; David,20,0,25,5
1739697984440,COMM 100B,A02,807447,Serlin; David,23,0,25,2
1739697984440,COMM 100B,A03,807450,Serlin; David,25,0,25,0
1739697984440,COMM 100B,A05,807453,Serlin; David,23,0,25,2
1739697984440,COMM 100B,A06,807454,Serlin; David,25,0,25,0
1739697984440,COMM 100B,A07,807455,Serlin; David,18,0,25,7
1739697984440,COMM 100B,A08,807458,Serlin; David,22,0,25,3
1739697984440,COMM 100B,A09,807459,Serlin; David,21,0,25,4
1739697984440,COMM 100B,A10,807462,Serlin; David,25,0,25,0
1739697984440,COMM 100B,A11,807464,Serlin; David,25,0,25,0
1739697985467,COMM 101,A01,807470,Davis; Zeinabu I.,15,0,15,0
1739697985467,COMM 101,A02,807513,Davis; Zeinabu I.,15,0,15,0
1739697985467,COMM 101,A03,807516,Davis; Zeinabu I.,15,0,15,0
1739697985467,COMM 101,A04,807517,Davis; Zeinabu I.,14,0,15,1
1739697986493,COMM 101D,A00,807570,Halm; Gavin Patrick,18,0,18,0
1739697987522,COMM 101K,A00,807571,Martinico; Daniel J,16,0,16,0
1739697988549,COMM 101N,A00,807572,Martinico; Daniel J,16,0,16,0
1739697989580,COMM 101T,A00,807573,Halm; Gavin Patrick,17,0,18,1
1739697989580,COMM 101T,B00,807588,Dewey; Matthew D,10,0,10,0
1739697989580,COMM 101T,C00,807592,Dewey; Matthew D,9,0,10,1
1739697990607,COMM 102C,A01,807604,Campion; Camille E,6,0,6,0
1739697990607,COMM 102C,A02,807605,Campion; Camille E,6,0,6,0
1739697990607,COMM 102C,A03,807612,Campion; Camille E,3,0,6,3
1739697991635,COMM 102M,A01,807638,Ahn; Patricia Jeehyun,9,0,9,0
1739697991635,COMM 102M,A02,807639,Ahn; Patricia Jeehyun,7,0,9,2
1739697992664,COMM 106F,A00,807672,McKenna; Denise,69,0,75,6
1739697993692,COMM 106I,A00,807926,Irani; Lilly C,71,0,75,4
1739697994719,COMM 109P,A00,807927,Jack; Caroline Sarah,39,0,40,1
1739697995746,COMM 110M,A00,807928,Abuelhiga; Soraya Jill,40,0,40,0
1739697996770,COMM 113T,A00,807929,Dominguez Rubio; Fernando,39,0,40,1
1739697997794,COMM 114A,A00,807930,Zilberg; Elana,37,0,40,3
1739697998822,COMM 114F,A00,808016,Rojo Solis; Juan Jose,38,0,40,2
1739697999850,COMM 114P,A00,808034,Abuelhiga; Soraya Jill,38,0,40,2
1739698000874,COMM 114W,A00,808035,Walkover; Lillian B,17,0,20,3
1739698001900,COMM 115,A00,808037,Alac; Morana,33,0,35,2
1739698002926,COMM 132,A00,808058,McKenna; Denise,37,0,40,3
1739698003954,COMM 139,A00,808063,Davis; Zeinabu I.,23,0,30,7
1739698004983,COMM 143,A00,808064,Rojo Solis; Juan Jose,38,0,40,2
1739698006012,COMM 146,A00,808068,Ahn; Patricia Jeehyun,34,0,35,1
1739698007037,COMM 155,A00,808072,Pavon Aramburu; Maria Laur,39,0,40,1
1739698008063,COMM 158,A00,808073,Fields; Gary,40,0,40,0
1739698009087,COMM 171,A00,808082,Zilberg; Elana,24,0,25,1
1739698010112,COMM 172,A00,808083,Staff,23,0,25,2
1739698011137,COMM 173,A00,808091,Alac; Morana,25,0,25,0
1739698012167,COMM 180,A00,808162,Leuning; Grant Maurstad,25,0,25,0
1739698013245,COMM 190,A00,808168,Dominguez Rubio; Fernando,22,0,23,1
1739698013245,COMM 190,B00,808169,Harb; Anthony Joseph,22,0,23,1
1739698013245,COMM 190,C00,808170,Rojo Solis; Juan Jose,22,0,23,1
1739698013245,COMM 190,D00,870218,Boateng; Boatema,22,0,23,1
1739698014270,COMM 194,A00,851599,Staff,0,0,0,0
1739698015296,CSE 6R,A01,842851,Moshiri; Niema,142,0,149,7
1739698015296,CSE 6R,B01,876602,Moshiri; Niema,50,0,50,0
1739698016328,CSE 8A,A50,842974,Porter; Leonard Emerson,38,0,38,0
1739698016328,CSE 8A,A51,843001,Porter; Leonard Emerson,37,0,38,1
1739698016328,CSE 8A,A52,843011,Porter; Leonard Emerson,38,0,38,0
1739698016328,CSE 8A,A53,843012,Porter; Leonard Emerson,37,0,38,1
1739698016328,CSE 8A,A54,874345,Porter; Leonard Emerson,38,0,38,0
1739698016328,CSE 8A,A55,874414,Porter; Leonard Emerson,35,0,38,3
1739698016328,CSE 8A,A56,874418,Porter; Leonard Emerson,38,0,38,0
1739698017356,CSE 11,A01,860850,Ochoa; Benjamin Lawrence,300,0,320,20
1739698018381,CSE 12,A01,860851,Cao; Yingjun,117,0,120,3
1739698018381,CSE 12,B01,865865,Cao; Yingjun,109,0,120,11
1739698019409,CSE 20,A01,865892,Jones; Miles E,97,0,100,3
1739698019409,CSE 20,A02,865908,Jones; Miles E,97,0,100,3
1739698020435,CSE 21,A01,865911,Jones; Miles E,97,0,100,3
1739698020435,CSE 21,A02,865914,Jones; Miles E,94,0,100,6
1739698021467,CSE 29,A50,843454,Solares; Edwin A,9,0,10,1
1739698021467,CSE 29,A51,843459,Solares; Edwin A,10,0,10,0
1739698021467,CSE 29,A52,843460,Solares; Edwin A,8,0,10,2
1739698021467,CSE 29,A53,843549,Solares; Edwin A,5,0,5,0
1739698021467,CSE 29,B50,843559,Soosai Raj; Adalbert Geral,5,0,10,5
1739698021467,CSE 29,B51,843750,Soosai Raj; Adalbert Geral,4,0,10,6
1739698021467,CSE 29,B52,843757,Soosai Raj; Adalbert Geral,8,0,10,2
1739698021467,CSE 29,B53,843758,Soosai Raj; Adalbert Geral,4,0,5,1
1739698022496,CSE 30,A01,864415,Chin; Bryan W.,120,0,125,5
1739698022496,CSE 30,B01,864419,Chin; Bryan W.,99,0,100,1
1739698023521,CSE 87,A00,875925,Moshiri; Niema,20,0,20,0
1739698024547,CSE 89,A00,872519,Minnes Kemp; Mor Mia,100,0,100,0
1739698024547,CSE 89,B00,872520,Minnes Kemp; Mor Mia,100,0,100,0
1739698025575,CSE 95,A00,843802,Cao; Yingjun,100,0,100,0
1739698026603,CSE 100,A01,864420,Sahoo; Debashis,100,0,120,20
1739698027632,CSE 101,A01,860868,Impagliazzo; Russell,0,0,10,10
1739698027632,CSE 101,A02,860869,Impagliazzo; Russell,0,0,10,10
1739698027632,CSE 101,A03,860870,Impagliazzo; Russell,6,0,10,4
1739698028657,CSE 105,A01,864426,Lovett; Shachar,223,0,250,27
1739698029683,CSE 107,A01,864427,Bellare; Mihir,92,0,96,4
1739698030709,CSE 110,A50,843823,Powell; Thomas Allan,111,0,116,5
1739698030709,CSE 110,A51,843827,Powell; Thomas Allan,93,0,116,23
1739698030709,CSE 110,A52,843828,Powell; Thomas Allan,106,0,116,10
1739698031735,CSE 120,A01,860871,Ousterhout; Amy,300,0,328,28
1739698032761,CSE 124,A01,864431,Porter; George M,139,0,196,57
1739698033789,CSE 125,A00,843848,Voelker; Geoffrey M.,30,0,30,0
1739698034815,CSE 127,A01,865915,Fernandes; Earlence T,173,0,192,19
1739698035840,CSE 130,A01,865928,Polikarpova; Nadezhda,176,0,192,16
1739698036864,CSE 131,A01,865936,Ding; Yufei,65,0,75,10
1739698037893,CSE 140,A01,865937,Eldon; John,184,0,196,12
1739698038921,CSE 140L,A01,843892,Eldon; John,174,0,196,22
1739698039949,CSE 141,A01,865939,Pannuto; Patrick William,165,0,192,27
1739698040976,CSE 141L,A01,843910,Eldon; John,158,0,196,38
1739698042004,CSE 145,A00,843915,Kastner; Ryan Charles,25,0,25,0
1739698043034,CSE 150A,A01,860873,Bonjour; Trevor,182,0,196,14
1739698044061,CSE 150B,A01,864429,Gao; Sicun,330,0,362,32
1739698045087,CSE 151A,A01,860874,Dasgupta; Sanjoy,297,0,325,28
1739698046114,CSE 151B,A01,864435,Yu; Qi,165,0,192,27
1739698047143,CSE 152B,A01,874283,Chandraker; Manmohan Krishna,57,0,70,13
1739698048168,CSE 153,A01,872732,McAuley; Julian John,181,0,196,15
1739698049203,CSE 153R,A01,872798,McAuley; Julian John,216,0,250,34
1739698049203,CSE 153R,B01,877492,Staff,50,0,50,0
1739698050228,CSE 165,A01,844081,Weibel; Nadir,23,0,35,12
1739698051258,CSE 168,A01,860875,Ramamoorthi; Ravi,23,0,28,5
1739698051258,CSE 168,A02,860876,Ramamoorthi; Ravi,26,0,28,2
1739698052284,CSE 175,A01,865941,Kumar; Rakesh,50,0,50,0
1739698054336,CSE 182,A01,851596,Bafna; Vineet,44,0,49,5
1739698055365,CSE 185,A01,844113,Moshiri; Niema,25,0,45,20
1739698055365,CSE 185,A02,844118,Moshiri; Niema,38,0,45,7
1739698056396,CSE 190,A00,844121,Grier; Daniel T,52,0,52,0
1739698056396,CSE 190,B00,844124,Soosai Raj; Adalbert Geral,82,0,100,18
1739698056396,CSE 190,C00,881308,Prithviraj; Ammanabrolu,45,0,50,5
1739698056396,CSE 190,D00,844127,Stefan; Deian,50,0,50,0
1739698057421,CSE 191,A00,844133,Minnes Kemp; Mor Mia,9999,0,9999,0
1739698058450,CSE 205A,A00,844166,Vianu; Victor Dan,0,0,0,0
1739698059475,CSE 209A,A00,844205,Impagliazzo; Russell,0,0,0,0
1739698060503,CSE 209B,A00,844216,Bellare; Mihir,0,0,0,0
1739698061529,CSE 217,A01,844235,Weibel; Nadir,0,0,0,0
1739698062557,CSE 219,A00,844246,Irani; Lilly C & Shvartzberg Carrio; Manuel,0,0,0,0
1739698063586,CSE 223B,A00,844249,Snoeren; Alex C.,0,0,0,0
1739698064613,CSE 224,A01,864433,Porter; George M,0,0,0,0
1739698065641,CSE 227,A00,844270,Stefan; Deian,0,0,0,0
1739698066667,CSE 229A,A00,844274,Ousterhout; Amy,0,0,0,0
1739698067691,CSE 229C,A00,844280,Fernandes; Earlence T,0,0,0,0
1739698068721,CSE 230,A00,844311,D'Antoni; Loris,0,0,0,0
1739698069747,CSE 237D,A00,844312,Kastner; Ryan Charles,0,0,0,0
1739698070770,CSE 239A,A00,844313,Vianu; Victor Dan,0,0,0,0
1739698071798,CSE 239B,A00,844314,Coblenz; Michael J,0,0,0,0
1739698072823,CSE 240A,A00,844315,Zhao; Jishen,0,0,0,0
1739698073852,CSE 241A,A00,844316,Kahng; Andrew Byun,0,0,0,0
1739698074880,CSE 250A,A00,844317,Bonjour; Trevor,0,0,0,0
1739698075906,CSE 251B,A01,864438,Yu; Qi,0,0,0,0
1739698076931,CSE 252D,A00,844320,Chandraker; Manmohan Krishna,0,0,0,0
1739698077956,CSE 253,A01,872796,McAuley; Julian John,0,0,0,0
1739698078981,CSE 253R,A01,872838,McAuley; Julian John,0,0,0,0
1739698081032,CSE 276F,A01,872476,Su; Hao,0,0,0,0
1739698082056,CSE 283,A00,844332,Bafna; Vineet & Zhong; Sheng,0,0,0,0
1739698083116,CSE 290,A00,844338,Gao; Sicun,0,0,0,0
1739698083116,CSE 290,B00,844366,Pannuto; Patrick William,0,0,0,0
1739698083116,CSE 290,C00,844379,Stefan; Deian,0,0,0,0
1739698083116,CSE 290,D00,881470,Yu; Qi,0,0,0,0
1739698083116,CSE 290,E00,844387,Chern; Albert Ren-Haur,0,0,0,0
1739698083116,CSE 290,F00,891163,Ding; Yufei,0,0,0,0
1739698084143,CSE 291,A00,844398,Bandeira; Nuno Filipe Cabrita,0,0,0,0
1739698084143,CSE 291,B00,844401,Li; Tzumao,0,0,0,0
1739698084143,CSE 291,C00,844402,Heninger; Nadia A,0,0,0,0
1739698084143,CSE 291,D00,844407,Chern; Albert Ren-Haur,0,0,0,0
1739698084143,CSE 291,E00,844409,Savage; Stefan,0,0,0,0
1739698084143,CSE 291,F00,881310,Niethammer; Marc S,0,0,0,0
1739698084143,CSE 291,H00,844419,Kahng; Andrew Byun,0,0,0,0
1739698085181,CSE 293,001,877922,Bafna; Vineet,9999,0,9999,0
1739698085181,CSE 293,002,877923,Bellare; Mihir,9999,0,9999,0
1739698085181,CSE 293,003,877942,Berg-Kirkpatrick; Taylor D,9999,0,9999,0
1739698085181,CSE 293,004,877943,Chandraker; Manmohan Krishna,9999,0,9999,0
1739698085181,CSE 293,005,877945,Cheng; Chung Kuan,9999,0,9999,0
1739698085181,CSE 293,006,877947,Christensen; Henrik I,9999,0,9999,0
1739698085181,CSE 293,007,877950,Coblenz; Michael J,9999,0,9999,0
1739698085181,CSE 293,008,877951,Cottrell; Garrison W,9999,0,9999,0
1739698085181,CSE 293,009,877952,Deutsch; Alin Bernard,9999,0,9999,0
1739698085181,CSE 293,010,877954,Esmaeilzadeh; Hadi,9999,0,9999,0
1739698085181,CSE 293,011,878049,Freund; Yoav,9999,0,9999,0
1739698085181,CSE 293,012,878145,Griswold; William G.,9999,0,9999,0
1739698085181,CSE 293,013,878152,Gymrek; Melissa Ann,9999,0,9999,0
1739698085181,CSE 293,014,878207,Heninger; Nadia A,9999,0,9999,0
1739698085181,CSE 293,015,878221,Impagliazzo; Russell,9999,0,9999,0
1739698085181,CSE 293,016,878223,Jhala; Ranjit,9999,0,9999,0
1739698085181,CSE 293,017,878262,Kahng; Andrew Byun,9999,0,9999,0
1739698085181,CSE 293,018,878267,Kane; Daniel Mertz,9999,0,9999,0
1739698085181,CSE 293,019,878270,Kriegman; David J,9999,0,9999,0
1739698085181,CSE 293,020,878273,Kumar; Arun Kumar,9999,0,9999,0
1739698085181,CSE 293,021,878275,Lerner; Sorin,9999,0,9999,0
1739698085181,CSE 293,022,878276,Lovett; Shachar,9999,0,9999,0
1739698085181,CSE 293,023,878311,McAuley; Julian John,9999,0,9999,0
1739698085181,CSE 293,024,878312,Micciancio; Daniele,9999,0,9999,0
1739698085181,CSE 293,025,878313,Orailoglu; Alex,9999,0,9999,0
1739698085181,CSE 293,026,878314,Pannuto; Patrick William,9999,0,9999,0
1739698085181,CSE 293,027,878315,Paturi; Ramamohan,9999,0,9999,0
1739698085181,CSE 293,028,878330,Polikarpova; Nadezhda,9999,0,9999,0
1739698085181,CSE 293,029,878358,Politz; Joseph Gibbs,9999,0,9999,0
1739698085181,CSE 293,030,878392,Porter; George M,9999,0,9999,0
1739698085181,CSE 293,031,878399,Porter; Leonard Emerson,9999,0,9999,0
1739698085181,CSE 293,032,878415,Ramamoorthi; Ravi,9999,0,9999,0
1739698085181,CSE 293,033,878416,Riek; Laurel D,9999,0,9999,0
1739698085181,CSE 293,034,878417,Sahoo; Debashis,9999,0,9999,0
1739698085181,CSE 293,035,878418,Saul; Lawrence,9999,0,9999,0
1739698085181,CSE 293,036,878419,Savage; Stefan,9999,0,9999,0
1739698085181,CSE 293,037,878420,Schulze; Jurgen P.,9999,0,9999,0
1739698085181,CSE 293,038,878421,Snoeren; Alex C.,9999,0,9999,0
1739698085181,CSE 293,039,878422,Shang; Jingbo,9999,0,9999,0
1739698085181,CSE 293,040,878423,Stefan; Deian,9999,0,9999,0
1739698085181,CSE 293,041,878424,Su; Hao,9999,0,9999,0
1739698085181,CSE 293,042,878425,Swanson; Steven James,9999,0,9999,0
1739698085181,CSE 293,043,878460,Tullsen; Dean Michael,9999,0,9999,0
1739698085181,CSE 293,044,878476,Vaccaro; Kristen Marie,9999,0,9999,0
1739698085181,CSE 293,045,878517,Voelker; Geoffrey M.,9999,0,9999,0
1739698085181,CSE 293,046,878541,Zhao; Jishen,9999,0,9999,0
1739698085181,CSE 293,047,878663,Zhou; Yuan-Yuan,9999,0,9999,0
1739698085181,CSE 293,048,878664,Gao; Sicun,9999,0,9999,0
1739698085181,CSE 293,049,878665,Weibel; Nadir,9999,0,9999,0
1739698085181,CSE 293,050,878666,Gupta; Rajesh K.,9999,0,9999,0
1739698085181,CSE 293,051,878667,Soosai Raj; Adalbert Geral,9999,0,9999,0
1739698085181,CSE 293,052,891170,Tu; Zhuowen,9999,0,9999,0
1739698086208,CSE 294,A00,844429,Voelker; Geoffrey M.,0,0,0,0
1739698087234,CSS 1,A01,864447,Staff,34,0,36,2
1739698087234,CSS 1,A02,864476,Staff,30,0,36,6
1739698087234,CSS 1,A03,864511,Staff,34,0,36,2
1739698087234,CSS 1,A04,864512,Staff,36,0,36,0
1739698088259,CSS 100,A01,864537,Trott; Sean Thomas,30,0,36,6
1739698088259,CSS 100,A02,864538,Trott; Sean Thomas,36,0,36,0
1739698089284,CSS 120,A01,864563,Mignozzetti; Umberto,28,0,28,0
1739698089284,CSS 120,A02,864564,Mignozzetti; Umberto,28,0,30,2
1739698090309,CSS 206,A00,812747,Mukamel; Eran A,6,0,24,18
1739698091337,CSS 209,A00,864566,Mignozzetti; Umberto,27,0,45,18
1739698092367,CSS 296,001,864568,Mignozzetti; Umberto,0,0,0,4
1739698092367,CSS 296,002,864569,Mignozzetti; Umberto,0,0,0,3
1739698092367,CSS 296,003,864571,Leas; Eric Craig,0,0,0,1
1739698092367,CSS 296,004,864577,Okonkwo; Holly,0,0,0,1
1739698092367,CSS 296,005,864605,Fleischer; Jason G,0,0,0,1
1739698092367,CSS 296,006,864634,Creel; Sarah,0,0,0,1
1739698092367,CSS 296,007,864661,Patel; Hemal,0,0,0,1
1739698092367,CSS 296,008,864688,Martin; Isaac,0,0,0,0
1739698092367,CSS 296,009,864697,Styler; William Francis,0,0,0,1
1739698092367,CSS 296,010,864751,Grigoryan; Aram,0,0,0,1
1739698092367,CSS 296,011,864752,Bonjour; Trevor,0,0,0,1
1739698092367,CSS 296,012,864753,Martin; Isaac,0,0,0,2
1739698093397,DDPM 210,A00,814899,Ma; Joseph David,29,0,32,3
1739698094422,DDPM 211,A00,814901,Ma; Joseph David,29,0,32,3
1739698095446,DDPM 214,A00,814907,Ma; Joseph David,29,0,32,3
1739698096471,DERM 296,001,866221,Eichenfield; Dawn Zhang,4,0,5,1
1739698096471,DERM 296,002,866222,Staff,5,0,5,0
1739698096471,DERM 296,003,866229,Staff,5,0,5,0
1739698097519,DOC 3,A01,813868,Staff,0,0,0,0
1739698097519,DOC 3,A02,813884,Staff,0,0,0,0
1739698097519,DOC 3,A03,813885,Staff,0,0,0,0
1739698097519,DOC 3,A04,813886,Staff,0,0,0,0
1739698097519,DOC 3,A05,813887,Staff,0,0,0,0
1739698097519,DOC 3,A06,813888,Staff,0,0,0,0
1739698097519,DOC 3,A07,813889,Staff,0,0,0,0
1739698097519,DOC 3,A08,813890,Staff,0,0,0,0
1739698097519,DOC 3,A09,813891,Staff,0,0,0,0
1739698097519,DOC 3,A10,813892,Staff,0,0,0,0
1739698097519,DOC 3,A11,813893,Staff,0,0,0,0
1739698097519,DOC 3,A12,813894,Staff,0,0,0,0
1739698097519,DOC 3,A13,813895,Staff,0,0,0,0
1739698097519,DOC 3,A14,813896,Staff,0,0,0,0
1739698097519,DOC 3,A15,813897,Staff,0,0,0,0
1739698097519,DOC 3,A16,813898,Staff,0,0,0,0
1739698097519,DOC 3,B01,813900,Staff,0,0,0,0
1739698097519,DOC 3,B02,813901,Staff,0,0,0,0
1739698097519,DOC 3,B03,813902,Staff,0,0,0,0
1739698097519,DOC 3,B04,813903,Staff,0,0,0,0
1739698097519,DOC 3,B05,813904,Staff,0,0,0,0
1739698097519,DOC 3,B06,813905,Staff,0,0,0,0
1739698097519,DOC 3,B07,813906,Staff,0,0,0,0
1739698097519,DOC 3,B08,813907,Staff,0,0,0,0
1739698097519,DOC 3,B09,813908,Staff,0,0,0,0
1739698097519,DOC 3,B10,813910,Staff,0,0,0,0
1739698097519,DOC 3,B11,813911,Staff,0,0,0,0
1739698097519,DOC 3,B12,813913,Staff,0,0,0,0
1739698097519,DOC 3,B13,813914,Staff,0,0,0,0
1739698097519,DOC 3,B14,813915,Staff,0,0,0,0
1739698097519,DOC 3,B15,813916,Staff,0,0,0,0
1739698097519,DOC 3,B16,813917,Staff,0,0,0,0
1739698097519,DOC 3,C01,813919,Staff,0,0,0,0
1739698097519,DOC 3,C02,813920,Staff,0,0,0,0
1739698097519,DOC 3,C03,813921,Staff,0,0,0,0
1739698097519,DOC 3,C04,813922,Staff,0,0,0,0
1739698097519,DOC 3,C05,813923,Staff,0,0,0,0
1739698097519,DOC 3,C06,813926,Staff,0,0,0,0
1739698097519,DOC 3,C07,813927,Staff,0,0,0,0
1739698097519,DOC 3,C08,813928,Staff,0,0,0,0
1739698097519,DOC 3,C09,813929,Staff,0,0,0,0
1739698097519,DOC 3,C10,813931,Staff,0,0,0,0
1739698097519,DOC 3,C11,813932,Staff,0,0,0,0
1739698097519,DOC 3,C12,813933,Staff,0,0,0,0
1739698097519,DOC 3,C13,813936,Staff,0,0,0,0
1739698097519,DOC 3,C14,813937,Staff,0,0,0,0
1739698097519,DOC 3,C15,813938,Staff,0,0,0,0
1739698097519,DOC 3,C16,813939,Staff,0,0,0,0
1739698097519,DOC 3,D01,813942,Staff,0,0,0,0
1739698097519,DOC 3,D02,813943,Staff,0,0,0,0
1739698097519,DOC 3,D03,813944,Staff,0,0,0,0
1739698097519,DOC 3,D04,813945,Staff,0,0,0,0
1739698097519,DOC 3,D05,813979,Staff,0,0,0,0
1739698097519,DOC 3,D06,813981,Staff,0,0,0,0
1739698097519,DOC 3,D07,813985,Staff,0,0,0,0
1739698097519,DOC 3,D08,813986,Staff,0,0,0,0
1739698097519,DOC 3,D09,813988,Staff,0,0,0,0
1739698097519,DOC 3,D10,813991,Staff,0,0,0,0
1739698097519,DOC 3,D11,813993,Staff,0,0,0,0
1739698097519,DOC 3,D12,813994,Staff,0,0,0,0
1739698097519,DOC 3,D13,814000,Staff,0,0,0,0
1739698097519,DOC 3,D14,814002,Staff,0,0,0,0
1739698097519,DOC 3,D15,814003,Staff,0,0,0,0
1739698097519,DOC 3,D16,814012,Staff,0,0,0,0
1739698097519,DOC 3,D17,814014,Staff,0,0,0,0
1739698098545,DOC 100D,A00,814015,Pass; Natalye,24,0,25,1
1739698098545,DOC 100D,B00,814017,Pass; Natalye,24,0,25,1
1739698099574,DSC 10,A01,841644,Tiefenbruck; Janine LoBue,146,0,146,0
1739698099574,DSC 10,B01,870243,Tiefenbruck; Janine LoBue,143,0,146,3
1739698100604,DSC 20,A01,841647,Langlois; Marina,60,0,60,0
1739698100604,DSC 20,B01,841649,Langlois; Marina,60,0,60,0
1739698101638,DSC 30,A01,841651,Liao; Soohyun Nam,189,0,190,1
1739698101638,DSC 30,B01,841653,Liao; Soohyun Nam,188,0,190,2
1739698102664,DSC 40A,A01,841659,Shannon; Kyle Michael,143,0,146,3
1739698103691,DSC 40B,A01,841663,Eldridge; Justin Matthew,175,0,180,5
1739698104716,DSC 80,A01,841667,Rahman; Tauhidur,116,0,120,4
1739698105741,DSC 95,A01,841669,Tiefenbruck; Janine LoBue,40,0,40,0
1739698106769,DSC 100,A01,841671,Salimi; Babak,146,0,146,0
1739698107794,DSC 102,A01,841674,Staff,293,0,300,7
1739698108823,DSC 106,B01,841679,Lau; Samuel Ethan,98,0,100,2
1739698108823,DSC 106,C01,841681,Lau; Samuel Ethan,100,0,100,0
1739698109852,DSC 140A,A01,841683,Ustun; Tevfik Berk,150,0,150,0
1739698110877,DSC 140B,A01,841687,Weng; Tsui-Wei (lily),122,0,125,3
1739698111905,DSC 161,A00,841688,Roberts; Margaret Earling,40,0,40,0
1739698112935,DSC 190,A01,841690,Silberman; Jack,30,0,30,0
1739698112935,DSC 190,B01,841692,Langlois; Marina,99,0,100,1
1739698112935,DSC 190,C01,841694,Weng; Tsui-Wei (lily),28,0,30,2
1739698112935,DSC 190,D01,841696,Ustun; Tevfik Berk,30,0,30,0
1739698113960,DSC 197,001,841699,Eldridge; Justin Matthew,9999,0,9999,0
1739698114989,DSC 204A,A00,841700,Bellur; Umesh,0,0,0,0
1739698116016,DSC 208R,A01,841703,Jin; Haojian,34,0,40,6
1739698117096,DSC 212,A00,841705,Staff,78,0,90,12
1739698118124,DSC 214,A00,841706,Wang; Yusu,0,0,60,60
1739698119147,DSC 232R,A01,841708,Solares; Edwin A,49,0,80,31
1739698120174,DSC 240,A00,841710,Belkin; Mikhail,114,0,120,6
1739698121200,DSC 241,A00,841712,Schwartzman; Armin,20,0,90,70
1739698122226,DSC 255R,A01,841714,Staff,32,0,40,8
1739698123250,DSC 258R,A01,841716,Shang; Jingbo,35,0,60,25
1739698124277,DSC 267R,A01,841718,Danks; David J,53,0,60,7
1739698125305,DSC 291,A00,841719,Ustun; Tevfik Berk,0,0,30,30
1739698125305,DSC 291,B00,841723,Huang; Biwei,4,0,60,56
1739698125305,DSC 291,C00,841724,Weng; Tsui-Wei (lily),0,0,30,30
1739698125305,DSC 291,D00,841725,Hu; Zhiting,54,0,90,36
1739698125305,DSC 291,E00,841726,Warstadt; Alexander Scott,7,0,60,53
1739698126330,DSC 293,A00,841727,Ustun; Tevfik Berk,9995,0,9999,4
1739698127354,DSC 297,001,872917,Rahman; Tauhidur,9999,0,9999,0
1739698128380,DSE 210,A00,869159,Staff,20,0,20,0
1739698129405,DSE 230,A00,813774,Staff,25,0,25,0
1739698130428,DSE 260B,A00,813775,Staff,25,0,25,0
1739698131456,DSGN 1,A01,810429,Klemmer; Scott R,49,0,50,1
1739698131456,DSGN 1,A02,810431,Klemmer; Scott R,49,0,50,1
1739698131456,DSGN 1,A03,810434,Klemmer; Scott R,50,0,50,0
1739698131456,DSGN 1,A04,810436,Klemmer; Scott R,48,0,50,2
1739698131456,DSGN 1,A05,810438,Klemmer; Scott R,39,0,40,1
1739698132481,DSGN 2,A01,810443,Hollan; James D.,49,0,50,1
1739698133508,DSGN 100,A01,811981,Rill; Bryan,18,0,18,0
1739698133508,DSGN 100,A02,811982,Rill; Bryan,10,0,18,8
1739698133508,DSGN 100,A03,811983,Rill; Bryan,15,0,18,3
1739698133508,DSGN 100,A04,812053,Rill; Bryan,6,0,16,10
1739698134533,DSGN 119,A00,812054,Irani; Lilly C & Shvartzberg Carrio; Manuel,63,0,80,17
1739698136582,DSGN 219,A00,812273,Irani; Lilly C & Shvartzberg Carrio; Manuel,12,0,15,3
1739698137608,ECE 5,A01,816583,Morris; Karcher William,0,0,0,0
1739698137608,ECE 5,A02,816584,Morris; Karcher William,0,0,0,0
1739698137608,ECE 5,A03,816586,Morris; Karcher William,22,0,22,0
1739698137608,ECE 5,A04,816589,Morris; Karcher William,22,0,22,0
1739698138640,ECE 15,A01,816591,Sahay; Rajeev,114,0,120,6
1739698139665,ECE 16,A01,816594,Wang; Edward Jay,26,0,30,4
1739698140693,ECE 17,A01,816599,Sahay; Rajeev,67,0,75,8
1739698141721,ECE 25,A50,816722,Dey; Sujit,30,0,30,0
1739698141721,ECE 25,A51,816734,Dey; Sujit,29,0,30,1
1739698142751,ECE 30,A50,816809,Mir Arabbaygi; Siavash,25,0,30,5
1739698142751,ECE 30,A51,816811,Mir Arabbaygi; Siavash,25,0,30,5
1739698142751,ECE 30,A52,816812,Mir Arabbaygi; Siavash,30,0,30,0
1739698142751,ECE 30,A53,816814,Mir Arabbaygi; Siavash,30,0,30,0
1739698142751,ECE 30,A54,816817,Mir Arabbaygi; Siavash,27,0,27,0
1739698143778,ECE 35,A50,816821,Ndao; Abdoulaye,25,0,26,1
1739698143778,ECE 35,A51,816822,Ndao; Abdoulaye,24,0,26,2
1739698143778,ECE 35,A52,816825,Ndao; Abdoulaye,26,0,26,0
1739698143778,ECE 35,A53,816826,Ndao; Abdoulaye,26,0,26,0
1739698144804,ECE 45,A01,816828,Zeger; Kenneth A.,187,0,192,5
1739698145833,ECE 65,A50,816873,Baghdadchi; Saharnaz,28,0,30,2
1739698145833,ECE 65,A51,816874,Baghdadchi; Saharnaz,28,0,30,2
1739698145833,ECE 65,A52,816877,Baghdadchi; Saharnaz,30,0,30,0
1739698145833,ECE 65,A53,816880,Baghdadchi; Saharnaz,30,0,30,0
1739698145833,ECE 65,A54,816882,Baghdadchi; Saharnaz,30,0,30,0
1739698145833,ECE 65,A55,816883,Baghdadchi; Saharnaz,29,0,30,1
1739698145833,ECE 65,A56,816884,Baghdadchi; Saharnaz,30,0,30,0
1739698146863,ECE 100,A01,816926,Hsueh; Tzu-Chien,29,0,30,1
1739698146863,ECE 100,A02,816939,Hsueh; Tzu-Chien,26,0,30,4
1739698146863,ECE 100,A03,816945,Hsueh; Tzu-Chien,29,0,30,1
1739698146863,ECE 100,A04,816950,Hsueh; Tzu-Chien,29,0,30,1
1739698146863,ECE 100,A05,816962,Hsueh; Tzu-Chien,29,0,30,1
1739698147890,ECE 101,A01,816993,Siegel; Paul H.,57,0,60,3
1739698147890,ECE 101,A02,817165,Siegel; Paul H.,57,0,60,3
1739698148927,ECE 103,A01,817352,Nomura; Kenji,43,0,50,7
1739698149954,ECE 108,A01,817373,Kang; Mingu,99,0,120,21
1739698150983,ECE 109,A01,817418,Orlitsky; Alon,72,0,73,1
1739698150983,ECE 109,A02,817420,Orlitsky; Alon,73,0,73,0
1739698152007,ECE 111,A01,817426,Eldon; John,167,0,180,13
1739698153034,ECE 115,A01,817432,Yip; Michael,20,0,26,6
1739698154062,ECE 123,A01,817448,Sievenpiper; Daniel F.,28,0,37,9
1739698155093,ECE 125B,A50,817453,Esmaili; Gholamreza,18,0,24,6
1739698155093,ECE 125B,A51,817455,Esmaili; Gholamreza,23,0,24,1
1739698156118,ECE 134,A00,817457,Ng; Tse Nga,47,0,50,3
1739698157144,ECE 136L,A01,817459,Dayeh; Shadi Ahmad,5,0,5,0
1739698157144,ECE 136L,A02,817461,Dayeh; Shadi Ahmad,2,0,5,3
1739698157144,ECE 136L,A03,817462,Dayeh; Shadi Ahmad,3,0,5,2
1739698157144,ECE 136L,A04,817463,Dayeh; Shadi Ahmad,4,0,5,1
1739698158169,ECE 139,A00,817537,Nomura; Kenji,29,0,30,1
1739698159199,ECE 140B,A50,817654,Khoshabeh; Ramsin & Gessner; Richard K.,23,0,24,1
1739698159199,ECE 140B,A51,817662,Khoshabeh; Ramsin & Gessner; Richard K.,22,0,24,2
1739698159199,ECE 140B,A52,817663,Khoshabeh; Ramsin & Gessner; Richard K.,22,0,22,0
1739698160224,ECE 141B,A01,872372,Gessner; Richard K.,26,0,30,4
1739698161249,ECE 148,A01,817698,Silberman; Jack,22,0,26,4
1739698162276,ECE 153,A01,817703,Naghizadeh Ardabili; Parinaz,74,0,90,16
1739698163301,ECE 157A,A01,817708,Bharadia; Dinesh,21,0,25,4
1739698164330,ECE 161C,A00,817865,Harris; Frederick Joel,48,0,50,2
1739698165358,ECE 165,A51,817880,Mercier; Patrick Philip,26,0,30,4
1739698165358,ECE 165,A52,817882,Mercier; Patrick Philip,23,0,30,7
1739698165358,ECE 165,A53,817885,Mercier; Patrick Philip,27,0,30,3
1739698165358,ECE 165,A54,817888,Mercier; Patrick Philip,29,0,30,1
1739698166387,ECE 171A,A01,817892,Zheng; Yang,93,0,100,7
1739698167412,ECE 175B,A01,817899,Xie; Pengtao,47,0,50,3
1739698168437,ECE 183,A01,817903,Mookherjea; Shayan,26,0,30,4
1739698169461,ECE 185,A01,817907,Liu; Zhaowei,20,0,20,0
1739698170485,ECE 196,A00,817908,Morris; Karcher William,15,0,24,9
1739698170485,ECE 196,B00,817913,Morris; Karcher William,26,0,28,2
1739698171512,ECE 197,001,816579,Mercier; Patrick Philip,9999,0,9999,0
1739698172538,ECE 198,001,816580,Nguyen; Truong Quang,9999,0,9999,0
1739698173564,ECE 204,A00,817918,Alexandrov; Ludmil B,0,0,0,0
1739698174591,ECE 208,A00,817920,Mir Arabbaygi; Siavash,0,0,0,0
1739698175617,ECE 212CN,A00,817921,Liu; Zhaowei,0,0,0,0
1739698176645,ECE 222D,A00,817922,Sievenpiper; Daniel F.,0,0,0,0
1739698177671,ECE 227,A00,817926,Franceschetti; Massimo,0,0,0,0
1739698178698,ECE 228,A00,817928,Shi; Yuanyuan,0,0,0,0
1739698179726,ECE 236B,A00,817929,Lo; Yu-Hwa,0,0,0,0
1739698180753,ECE 238B,A00,817934,Garay; Javier,0,0,0,0
1739698181782,ECE 240C,A00,818013,Mookherjea; Shayan,0,0,0,0
1739698182806,ECE 241A,A00,818014,Rubin; Noah,0,0,0,0
1739698183832,ECE 251B,A00,818015,Vasconcelos; Manuela,0,0,0,0
1739698184857,ECE 258B,A00,818016,Milstein; Laurence B.,0,0,0,0
1739698185885,ECE 260C,A00,818017,Kahng; Andrew Byun,0,0,0,0
1739698186911,ECE 264B,A00,818018,Galton; Ian A,0,0,0,0
1739698187935,ECE 265B,A00,818019,Gudem; Prasad S.S.,0,0,0,0
1739698188962,ECE 266,A01,818021,Hall; Drew A.,0,0,0,0
1739698189985,ECE 268,A00,818022,Koushanfar; Farinaz,0,0,0,0
1739698191012,ECE 272A,A01,818064,Poveda Fonseca; Jorge,0,0,0,0
1739698192038,ECE 273,A00,818065,Wang; Jun-Kun,0,0,0,0
1739698193063,ECE 275A,A00,818066,Meyer; Florian,0,0,0,0
1739698194089,ECE 276B,A00,818067,Atanasov; Nikolay A.,0,0,0,0
1739698195119,ECE 284,A00,818068,Wang; Edward,0,0,0,0
1739698196145,ECE 285,A00,818069,Wang; Xiaolong,0,0,0,0
1739698196145,ECE 285,B00,818070,Antipa; Nicholas A,0,0,0,0
1739698196145,ECE 285,C00,818071,Xie; Pengtao,0,0,0,0
1739698197169,ECE 287,A00,872497,Gonzalez Prelcic; Nuria,0,0,0,0
1739698198201,ECON 1,A01,814026,Famulari; Melissa,118,0,120,2
1739698198201,ECON 1,A02,814028,Famulari; Melissa,114,0,115,1
1739698198201,ECON 1,A03,814029,Famulari; Melissa,115,0,115,0
1739698198201,ECON 1,B01,814039,Famulari; Melissa,46,0,50,4
1739698199228,ECON 2,A01,814045,Crane; Meredith Helen,95,0,96,1
1739698200257,ECON 3,A01,814154,Crane; Meredith Helen,91,0,95,4
1739698200257,ECON 3,A02,814155,Crane; Meredith Helen,93,0,95,2
1739698200257,ECON 3,B01,814188,Crane; Meredith Helen,95,0,95,0
1739698200257,ECON 3,B02,814195,Crane; Meredith Helen,91,0,95,4
1739698201286,ECON 4,A01,814197,Levkoff; Steven B.,50,0,54,4
1739698201286,ECON 4,A02,814210,Levkoff; Steven B.,54,0,54,0
1739698201286,ECON 4,A03,814224,Levkoff; Steven B.,54,0,54,0
1739698201286,ECON 4,B01,814273,Brooks; Marcus Raymond,3,0,3,0
1739698202320,ECON 5,A01,814495,Arnold; David Hall,66,0,72,6
1739698202320,ECON 5,A02,814507,Arnold; David Hall,72,0,72,0
1739698202320,ECON 5,A03,814508,Arnold; David Hall,71,0,72,1
1739698202320,ECON 5,A04,814509,Arnold; David Hall,71,0,72,1
1739698202320,ECON 5,A05,814510,Arnold; David Hall,72,0,72,0
1739698202320,ECON 5,B01,814513,Dai; Yinlin,44,0,45,1
1739698202320,ECON 5,B02,814514,Dai; Yinlin,39,0,45,6
1739698203346,ECON 100A,A01,814516,Newhouse; Herbert S,76,0,79,3
1739698203346,ECON 100A,A02,814517,Newhouse; Herbert S,79,0,79,0
1739698203346,ECON 100A,B01,814519,Newhouse; Herbert S,82,0,83,1
1739698203346,ECON 100A,B02,814520,Newhouse; Herbert S,73,0,75,2
1739698204372,ECON 100AH,A00,814521,Famulari; Melissa,20,0,20,0
1739698205404,ECON 100B,A01,814523,Boomhower; Judson P,74,0,85,11
1739698205404,ECON 100B,A02,814524,Boomhower; Judson P,82,0,85,3
1739698205404,ECON 100B,A03,814525,Boomhower; Judson P,78,0,80,2
1739698205404,ECON 100B,B01,814527,Boomhower; Judson P,0,0,0,0
1739698206434,ECON 100BH,A00,814528,Boomhower; Judson P,20,0,20,0
1739698207461,ECON 100C,A01,814530,Newhouse; Herbert S,95,0,98,3
1739698207461,ECON 100C,A02,814531,Newhouse; Herbert S,98,0,98,0
1739698208488,ECON 101,A00,814532,Esfahani; Sara,112,0,120,8
1739698209515,ECON 109T,A00,814533,Trevino; Isabel,20,0,20,0
1739698210544,ECON 110A,A01,814535,Candido; Maria Teresa,97,0,100,3
1739698211571,ECON 110B,A01,814537,Herreno Lopera; Juan,91,0,100,9
1739698211571,ECON 110B,A02,814538,Herreno Lopera; Juan,100,0,100,0
1739698211571,ECON 110B,A03,814539,Herreno Lopera; Juan,99,0,100,1
1739698211571,ECON 110B,A04,814540,Herreno Lopera; Juan,98,0,100,2
1739698212600,ECON 120A,A01,814542,Dai; Yinlin,90,0,95,5
1739698212600,ECON 120A,A02,814543,Dai; Yinlin,95,0,95,0
1739698212600,ECON 120A,B01,814545,Dai; Yinlin,93,0,95,2
1739698212600,ECON 120A,B02,814546,Dai; Yinlin,94,0,95,1
1739698213630,ECON 120B,A01,814548,Candido; Maria Teresa,91,0,95,4
1739698213630,ECON 120B,A02,814549,Candido; Maria Teresa,89,0,95,6
1739698213630,ECON 120B,B01,814551,Candido; Maria Teresa,91,0,95,4
1739698213630,ECON 120B,B02,814552,Candido; Maria Teresa,95,0,95,0
1739698214657,ECON 120C,A01,814554,Sun; Yixiao,38,0,40,2
1739698214657,ECON 120C,B01,814556,Sun; Yixiao,33,0,40,7
1739698214657,ECON 120C,C01,814585,Sun; Yixiao,39,0,40,1
1739698215684,ECON 125,A00,814588,Vogl; Tom Saul,96,0,100,4
1739698216710,ECON 129,A00,814589,Eckert; Fabian Paul,99,0,100,1
1739698217737,ECON 132,A00,814595,Carson; Richard T,72,0,75,3
1739698217737,ECON 132,B00,814599,Carson; Richard T,73,0,75,2
1739698218765,ECON 132T,A00,814600,Carson; Richard T,20,0,20,0
1739698219790,ECON 134,A00,814601,Gelber; Alexander Michael,47,0,50,3
1739698220871,ECON 137,A00,814602,Niehaus; Paul,20,0,20,0
1739698221895,ECON 140,A00,814630,Clemens; Jeffrey,44,0,49,5
1739698222921,ECON 142,A00,814647,Trevino; Isabel,50,0,50,0
1739698222921,ECON 142,B00,814656,Trevino; Isabel,46,0,50,4
1739698223946,ECON 147,A00,814683,Betts; Julian,100,0,100,0
1739698224973,ECON 164,A00,814684,Muralidharan; Karthik,219,0,220,1
1739698225998,ECON 168,A00,814691,Maron; Asa,74,0,80,6
1739698227027,ECON 173B,A01,814700,Levkoff; Steven B.,39,0,40,1
1739698227027,ECON 173B,B01,814734,Levkoff; Steven B.,40,0,40,0
1739698228052,ECON 191A,A00,814768,Cullen; Julie,20,0,20,0
1739698229079,ECON 200C,A00,814811,Grigoryan; Aram & Trevino; Isabel & Sobel; Joel,24,0,25,1
1739698230109,ECON 210C,A00,814815,Herreno Lopera; Juan,25,0,25,0
1739698231134,ECON 220C,A00,814816,Sun; Yixiao,23,0,25,2
1739698232158,ECON 220F,A00,814817,Carson; Richard T,28,0,30,2
1739698233186,ECON 221,A00,814818,Zhu; Ying,15,0,15,0
1739698234211,ECON 241,A00,814819,Muralidharan; Karthik,14,0,15,1
1739698235238,ECON 243,A00,814820,Niehaus; Paul & Adhvaryu; Achyuta Rasendra,15,0,15,0
1739698236263,ECON 248,A00,814821,Eckert; Fabian Paul & Trottner; Fabian Gunter We,13,0,15,2
1739698237286,ECON 250C,A00,814840,Arnold; David Hall & Betts; Julian,24,0,25,1
1739698238315,ECON 281,A00,814850,Wu; Pak Yeung & Herreno Lopera; Juan,14,0,15,1
1739698239341,ECON 285,A00,814851,Eckert; Fabian Paul,25,0,25,0
1739698240369,ECON 286,A00,814852,Hamilton; James D.,20,0,20,0
1739698240369,ECON 286,B00,814853,Shishkin; Denis,19,0,20,1
1739698241395,ECON 296,A00,814854,Eckert; Fabian Paul,24,0,25,1
1739698242420,EDS 31,A00,815023,Brydges; Stacey,17,0,20,3
1739698243446,EDS 39,A01,815025,Heinzman; Erica M.,25,0,25,0
1739698244470,EDS 102,A01,815042,Hopkins; Megan Beth,40,0,45,5
1739698246524,EDS 115,A00,815058,Jones; Gabrielle Anastasia,48,0,50,2
1739698247551,EDS 117,A01,851605,Jones; Makeba,33,0,37,4
1739698247551,EDS 117,A02,851607,Jones; Makeba,35,0,37,2
1739698247551,EDS 117,A03,851608,Jones; Makeba,38,0,38,0
1739698247551,EDS 117,A04,851610,Jones; Makeba,37,0,38,1
1739698247551,EDS 117,B01,870849,Staff,24,0,25,1
1739698247551,EDS 117,B02,870920,Staff,25,0,25,0
1739698247551,EDS 117,B03,870978,Staff,25,0,25,0
1739698247551,EDS 117,B04,870979,Staff,25,0,25,0
1739698248579,EDS 118,A00,815184,Staff,57,0,60,3
1739698249602,EDS 123,A00,815186,Brydges; Stacey,20,0,20,0
1739698250631,EDS 124AR,A00,815196,Simon; Elizabeth A,189,0,200,11
1739698250631,EDS 124AR,B00,815197,Simon; Elizabeth A,99,0,100,1
1739698250631,EDS 124AR,C00,872649,Simon; Elizabeth A,40,0,40,0
1739698251660,EDS 124BR,A00,815259,Eguchi; Emi,57,0,75,18
1739698251660,EDS 124BR,B00,872641,Eguchi; Emi,25,0,25,0
1739698252685,EDS 125,A00,815260,Aragon; Maria Jose,55,0,60,5
1739698253711,EDS 126,A01,851619,Jones; Makeba,25,0,33,8
1739698253711,EDS 126,A02,815283,Jones; Makeba,31,0,33,2
1739698253711,EDS 126,A03,815284,Jones; Makeba,33,0,34,1
1739698254738,EDS 128B,A01,815311,Pappas; Elizabeth,24,0,25,1
1739698254738,EDS 128B,A02,815312,Pappas; Elizabeth,25,0,25,0
1739698254738,EDS 128B,A03,870748,Pappas; Elizabeth,20,0,20,0
1739698255765,EDS 129C,A01,815314,Millstone; Rachel Diana,60,0,60,0
1739698256791,EDS 130,A01,815383,Mendez; Kathrina Mendoza,18,0,20,2
1739698256791,EDS 130,A02,815384,Mendez; Kathrina Mendoza,20,0,20,0
1739698256791,EDS 130,A03,815390,Mendez; Kathrina Mendoza,20,0,20,0
1739698257817,EDS 133,A01,815456,Bintliff; Amy S.V.,12,0,15,3
1739698257817,EDS 133,A02,815457,Bintliff; Amy S.V.,15,0,15,0
1739698257817,EDS 133,A03,815458,Bintliff; Amy S.V.,14,0,15,1
1739698257817,EDS 133,A04,815459,Bintliff; Amy S.V.,10,0,10,0
1739698258844,EDS 136,A01,815462,Hemans; Patricia Ann Benitez,17,0,20,3
1739698258844,EDS 136,A02,815463,Hemans; Patricia Ann Benitez,20,0,20,0
1739698258844,EDS 136,A03,815467,Hemans; Patricia Ann Benitez,20,0,20,0
1739698259872,EDS 139,A00,815469,Pappas; Elizabeth,47,0,50,3
1739698259872,EDS 139,B00,815470,Millstone; Rachel Diana,60,0,60,0
1739698259872,EDS 139,C00,815471,Mendez; Kathrina Mendoza,58,0,60,2
1739698259872,EDS 139,D00,815472,Bintliff; Amy S.V.,57,0,60,3
1739698259872,EDS 139,E00,815473,Hemans; Patricia Ann Benitez,57,0,60,3
1739698259872,EDS 139,F00,815474,Mamas; Christoforos,32,0,35,3
1739698259872,EDS 139,G00,815583,Choi; Bailey Miyeon,30,0,30,0
1739698259872,EDS 139,H00,815588,Bintliff; Amy S.V.,20,0,20,0
1739698260898,EDS 141,A00,815592,Mamas; Christoforos,34,0,35,1
1739698261930,EDS 145,A01,815629,Choi; Bailey Miyeon,13,0,15,2
1739698261930,EDS 145,A02,815630,Choi; Bailey Miyeon,15,0,15,0
1739698262957,EDS 164R,A01,815632,Staff,37,0,40,3
1739698262957,EDS 164R,B01,872639,Staff,20,0,20,0
1739698263983,EDS 165,A00,815635,Jones; Gabrielle Anastasia,29,0,30,1
1739698265009,EDS 180,A00,815642,Chapman; Thandeka K,24,0,25,1
1739698265009,EDS 180,B00,886111,Eguchi; Emi,30,0,30,0
1739698266036,EDS 190,A00,889678,Bintliff; Amy S.V.,4,0,5,1
1739698267062,EDS 205B,A00,815645,Halter; Christopher P.,48,0,50,2
1739698268089,EDS 253,A00,815646,Staff,14,0,15,1
1739698269116,EDS 266,A00,815647,Phuong; Andrew,11,0,12,1
1739698270146,EDS 282,A00,815649,Daly; Alan J.,15,0,15,0
1739698271172,EDS 287B,A00,815650,Daly; Alan J.,15,0,15,0
1739698272201,EDS 288A,A00,815651,Bjorklund; Peter,15,0,15,0
1739698273229,EDS 288B,A00,815694,Chapman; Thandeka K,19,0,20,1
1739698274257,EDS 288C,A00,815695,Staff,15,0,15,0
1739698275283,EDS 289B,A01,815710,Daly; Alan J.,15,0,15,0
1739698276313,EDS 290,A00,815711,Millstone; Rachel Diana,20,0,20,0
1739698276313,EDS 290,B00,815712,Heinzman; Erica M.,20,0,20,0
1739698276313,EDS 290,C00,815717,Choi; Bailey Miyeon,21,0,21,0
1739698276313,EDS 290,D00,815727,Black; Alison Michelle,20,0,20,0
1739698277339,EDS 293B,A01,815735,Burrell; Sade Renee,15,0,15,0
1739698278365,EDS 294B,A00,815745,Meyerott; Theresa Ann,15,0,15,0
1739698279397,EDS 296,001,814911,Ambo; Theresa Jean,10,0,10,0
1739698279397,EDS 296,002,814917,Aragon; Maria Jose,9,0,10,1
1739698279397,EDS 296,003,814918,Bintliff; Amy S.V.,10,0,10,0
1739698279397,EDS 296,004,814922,Chapman; Thandeka K,10,0,10,0
1739698279397,EDS 296,005,814927,Cohen; Shana R,10,0,10,0
1739698279397,EDS 296,006,814929,Daly; Alan J.,10,0,10,0
1739698279397,EDS 296,007,814930,Eguchi; Emi,10,0,10,0
1739698279397,EDS 296,008,814947,Datnow; Amanda Lee,10,0,10,0
1739698279397,EDS 296,009,814948,Halter; Christopher P.,10,0,10,0
1739698279397,EDS 296,010,814953,Hofstetter; Carolyn,10,0,10,0
1739698279397,EDS 296,011,814954,Hopkins; Megan Beth,10,0,10,0
1739698279397,EDS 296,012,814955,Jones; Gabrielle Anastasia,10,0,10,0
1739698279397,EDS 296,013,814958,Jones; Makeba,10,0,10,0
1739698279397,EDS 296,014,814961,Mamas; Christoforos,10,0,10,0
1739698279397,EDS 296,015,814962,Museus; Samuel David,10,0,10,0
1739698279397,EDS 296,016,814966,Pollock; Mica,10,0,10,0
1739698279397,EDS 296,017,814967,Wishard Guerra; Alison G.,10,0,10,0
1739698279397,EDS 296,018,886234,Clarke; Sherice Nicole,10,0,10,0
1739698279397,EDS 296,019,886235,Cohen; Shana R,10,0,10,0
1739698279397,EDS 296,020,886236,Fine; Sarah,10,0,10,0
1739698280427,EMED 296,001,866359,Daniel; Michelle Marie,4,0,5,1
1739698280427,EMED 296,002,866361,Staff,5,0,5,0
1739698280427,EMED 296,003,866363,Staff,5,0,5,0
1739698281452,ENG 10,A00,813776,Evdokimenko; Ekaterina,60,0,60,0
1739698282479,ENG 30,A01,869879,Schurgers; Curt,30,0,30,0
1739698283506,ENG 100D,A00,813777,Ngo; Anh-Thu T.,43,0,50,7
1739698283506,ENG 100D,B00,887051,Ngo; Anh-Thu T.,48,0,50,2
1739698284533,ENG 100L,A00,813778,Kleissl; Jan,6,0,6,0
1739698284533,ENG 100L,B00,813780,Bratton; Maryann,8,0,8,0
1739698284533,ENG 100L,C00,813781,Yu; Paul K L,8,0,8,0
1739698284533,ENG 100L,D00,813782,Goldberg; Charles G.,6,0,6,0
1739698284533,ENG 100L,E00,813783,de Oliveira; Mauricio,8,0,8,0
1739698284533,ENG 100L,F00,813852,Bratton; Maryann,6,0,6,0
1739698284533,ENG 100L,G00,813856,Boyle; Mary E. T.,15,0,15,0
1739698284533,ENG 100L,H00,813860,Boyle; Mary E. T.,15,0,15,0
1739698285575,ENVR 102,A00,818253,Lin; Cindy Jih-Shing,23,0,25,2
1739698285575,ENVR 102,B00,818254,Montejo; Carolina,25,0,25,0
1739698285575,ENVR 102,C00,818255,Staff,24,0,25,1
1739698285575,ENVR 102,E00,818257,Daly; Heather Marie,18,0,20,2
1739698286605,ENVR 140,A01,818259,Siapno; Jacqueline A,13,0,15,2
1739698286605,ENVR 140,A02,818260,Siapno; Jacqueline A,13,0,15,2
1739698286605,ENVR 140,A03,818261,Siapno; Jacqueline A,13,0,15,2
1739698286605,ENVR 140,A04,818290,Siapno; Jacqueline A,14,0,15,1
1739698287635,ESYS 103,A01,818299,Lerner; Amy M,30,0,34,4
1739698287635,ESYS 103,A02,818300,Lerner; Amy M,33,0,34,1
1739698287635,ESYS 103,A03,818301,Lerner; Amy M,24,0,34,10
1739698287635,ESYS 103,A04,818302,Lerner; Amy M,32,0,34,2
1739698287635,ESYS 103,A05,818322,Lerner; Amy M,31,0,34,3
1739698287635,ESYS 103,A06,818385,Lerner; Amy M,30,0,30,0
1739698288670,ESYS 187C,A01,818387,Hetherington; Elizabeth Dorsey,32,0,40,8
1739698288670,ESYS 187C,A02,818388,Hetherington; Elizabeth Dorsey,39,0,40,1
1739698289700,ETHN 3R,A01,818390,Okonkwo; Holly,20,0,25,5
1739698289700,ETHN 3R,A02,818391,Okonkwo; Holly,24,0,25,1
1739698289700,ETHN 3R,A03,818392,Okonkwo; Holly,23,0,25,2
1739698289700,ETHN 3R,A04,818393,Okonkwo; Holly,23,0,25,2
1739698289700,ETHN 3R,A05,818394,Okonkwo; Holly,22,0,25,3
1739698289700,ETHN 3R,A06,818395,Okonkwo; Holly,22,0,25,3
1739698289700,ETHN 3R,A07,818396,Okonkwo; Holly,23,0,25,2
1739698289700,ETHN 3R,A08,818397,Okonkwo; Holly,25,0,25,0
1739698289700,ETHN 3R,A09,818398,Okonkwo; Holly,25,0,25,0
1739698289700,ETHN 3R,A10,818399,Okonkwo; Holly,23,0,25,2
1739698289700,ETHN 3R,A11,818400,Okonkwo; Holly,24,0,25,1
1739698289700,ETHN 3R,A12,818401,Okonkwo; Holly,24,0,25,1
1739698289700,ETHN 3R,A13,818402,Okonkwo; Holly,24,0,25,1
1739698289700,ETHN 3R,A14,818403,Okonkwo; Holly,23,0,25,2
1739698290729,ETHN 30,A01,818405,Fuste; Jose Ignacio,24,0,25,1
1739698290729,ETHN 30,A02,818406,Fuste; Jose Ignacio,22,0,25,3
1739698290729,ETHN 30,A03,818407,Fuste; Jose Ignacio,25,0,25,0
1739698290729,ETHN 30,A04,818408,Fuste; Jose Ignacio,25,0,25,0
1739698290729,ETHN 30,A05,818409,Fuste; Jose Ignacio,25,0,25,0
1739698290729,ETHN 30,A06,818410,Fuste; Jose Ignacio,25,0,25,0
1739698291755,ETHN 100C,A00,818411,Fuste; Jose Ignacio,32,0,36,4
1739698292781,ETHN 101,A01,818413,Marez; Curtis F.,23,0,25,2
1739698292781,ETHN 101,A02,818414,Marez; Curtis F.,24,0,25,1
1739698292781,ETHN 101,A03,818415,Marez; Curtis F.,25,0,25,0
1739698292781,ETHN 101,A04,818416,Marez; Curtis F.,23,0,25,2
1739698293806,ETHN 108,A00,818418,Hankins; Sarah E.,15,0,20,5
1739698294836,ETHN 110,A00,818419,Klann; Mary Cameron,23,0,30,7
1739698295862,ETHN 112C,A00,818420,Frank; Ross H.,28,0,30,2
1739698296886,ETHN 121R,A00,818422,Choi; Esther Min,35,0,45,10
1739698297914,ETHN 122B,A00,891172,Museus; Samuel David,50,0,50,0
1739698299970,ETHN 127,A00,818424,Cuong; Marisol,27,0,30,3
1739698300999,ETHN 140,A00,818426,Tran; Ly Thi Hai,30,0,30,0
1739698302024,ETHN 142,A00,818429,Wilson; Brenda K,27,0,30,3
1739698303050,ETHN 147,A00,872912,Staff,20,0,20,0
1739698304081,ETHN 171,A00,869845,Gallagher-Geurtsen; Tricia Meghan,29,0,30,1
1739698305106,ETHN 172,A00,818477,Childs; Dennis R.,20,0,20,0
1739698306133,ETHN 174,A00,818481,Childs; Dennis R.,20,0,20,0
1739698307163,ETHN 182,A00,818487,Streeby; Shelley,58,0,60,2
1739698308190,ETHN 183,A00,818489,Cuong; Marisol,21,0,22,1
1739698309216,ETHN 189,A00,818496,Museus; Samuel David,20,0,20,0
1739698310243,ETHN 196H,A00,885505,Fuste; Jose Ignacio,0,0,0,0
1739698310243,ETHN 196H,B00,885506,Klann; Mary Cameron,0,0,0,0
1739698310243,ETHN 196H,C00,885507,Museus; Samuel David,0,0,0,0
1739698310243,ETHN 196H,D00,885524,Taylor-Garcia; Daphne,0,0,0,0
1739698310243,ETHN 196H,E00,885706,Wilson; Brenda K,0,0,0,1
1739698311270,ETHN 200C,A00,818498,Frank; Ross H.,11,0,15,4
1739698312310,ETHN 230,A00,818501,Perreira; Christopher Michael,11,0,15,4
1739698313337,ETHN 291,A00,818504,Streeby; Shelley,15,0,15,0
1739698314362,ETIM 289,A00,818674,Marez; Curtis F.,11,0,15,4
1739698315391,EXPR 100,A00,871385,Staff,9999,0,9999,0
1739698316416,EXPR 105,A00,871455,Staff,9999,0,9999,0
1739698317445,EXPR 201,A00,871548,Staff,9999,0,9999,0
1739698318472,EXPR 205,A00,871602,Staff,9999,0,9999,0
1739698319501,FILM 71,A01,809813,Staff,9,0,10,1
1739698320528,FILM 72,A01,871143,Staff,9,0,10,1
1739698321555,FILM 73,A01,871145,Staff,8,0,10,2
1739698322583,FILM 87,A00,809816,Rahimi; Babak,20,0,20,0
1739698322583,FILM 87,B00,809859,Rahimi; Babak,20,0,20,0
1739698322583,FILM 87,C00,869076,Havis; Allan,19,0,20,1
1739698323616,FMPH 291,A00,818678,Boutelle; Kerri & Eichen; Dawn,13,0,15,2
1739698323616,FMPH 291,B00,818689,Lacroix; Andrea Zauderer,12,0,15,3
1739698323616,FMPH 291,C00,818694,Shadyab; Aladdin Hassan,15,0,15,0
1739698323616,FMPH 291,D00,818695,Salem; Rany Mansour,12,0,15,3
1739698323616,FMPH 291,E00,818704,Shadyab; Aladdin Hassan,14,0,15,1
1739698323616,FMPH 291,F00,872513,Araneta; Maria Rosario Gorrez,12,0,15,3
1739698323616,FMPH 291,G00,876306,Ross; Camille,13,0,15,2
1739698324696,FPM 276,A00,886086,Zhu; Shu-Hong,14,0,15,1
1739698325725,FPM 286,A00,866428,Johnson; Michelle Lee,0,0,0,0
1739698326751,FPM 296,001,866429,Johnson; Michelle Lee,4,0,5,1
1739698326751,FPM 296,002,866430,Araneta; Maria Rosario Gorrez,5,0,5,0
1739698326751,FPM 296,003,866433,Staff,5,0,5,0
1739698327783,FPM 297,001,881032,Strong; David R,9998,0,9999,1
1739698328813,GLBH 20,A00,818752,Elwardani; Nile Regina,143,0,146,3
1739698329840,GLBH 101,A00,818757,Sloane; Julia Kathryn,39,0,40,1
1739698330869,GLBH 107,A00,818758,Wilson; Brenda K,65,0,70,5
1739698331896,GLBH 108,A00,818759,Olivas Hernandez; Olga Lid,68,0,70,2
1739698332923,GLBH 111,A01,818761,Burgos; Jose L.,0,0,0,0
1739698332923,GLBH 111,B01,818763,Burgos; Jose L.,0,0,0,0
1739698333948,GLBH 114W,A00,818764,Walkover; Lillian B,16,0,17,1
1739698335998,GLBH 121,A00,870699,Villarino; Margarita,42,0,44,2
1739698337023,GLBH 130,A00,870701,Schonberg; Jeffrey,38,0,40,2
1739698338052,GLBH 131,A00,870812,Staff,43,0,44,1
1739698339078,GLBH 147,A00,818766,Stewart; Alexander B,38,0,40,2
1739698340103,GLBH 148,A00,818828,Schonberg; Jeffrey,95,0,100,5
1739698341127,GLBH 150B,A00,818838,Kaiser; Bronwyn Nicole,14,0,15,1
1739698342155,GLBH 181,A00,818842,Burgos; Jose L.,207,0,216,9
1739698343182,GLBH 190,A00,870700,Bhavsar; Radhika,44,0,44,0
1739698344207,GLBH 215,A00,818849,Walkover; Lillian B,8,0,16,8
1739698345233,GLBH 260,A00,818858,Elwardani; Nile Regina,16,0,16,0
1739698346258,GSS 20,A00,818859,Siapno; Jacqueline A,27,0,30,3
1739698347283,GSS 21,A00,818860,Gyamfi; Bright,29,0,30,1
1739698348310,HDS 1,A01,819050,Staff,29,0,30,1
1739698348310,HDS 1,A02,819053,Staff,28,0,30,2
1739698348310,HDS 1,A03,819074,Staff,29,0,30,1
1739698348310,HDS 1,A04,819075,Staff,30,0,30,0
1739698348310,HDS 1,A05,819076,Staff,29,0,30,1
1739698348310,HDS 1,A06,819077,Staff,30,0,30,0
1739698348310,HDS 1,A07,819078,Staff,29,0,30,1
1739698349338,HDS 60,A01,819095,Staff,32,0,35,3
1739698349338,HDS 60,A02,819096,Staff,35,0,35,0
1739698350365,HDS 95,A00,819097,Staff,36,0,40,4
1739698351394,HDS 120,A00,819098,Staff,91,0,100,9
1739698352422,HDS 122,A00,819099,Staff,96,0,100,4
1739698353450,HDS 150,A00,819100,Staff,12,0,12,0
1739698353450,HDS 150,B00,819122,Staff,12,0,12,0
1739698353450,HDS 150,C00,819123,Staff,12,0,12,0
1739698354474,HDS 175,A00,819142,Staff,32,0,35,3
1739698355500,HDS 181,A01,819144,Staff,35,0,35,0
1739698356527,HDS 191,A01,819146,Staff,20,0,20,0
1739698356527,HDS 191,B01,819223,Staff,20,0,20,0
1739698357556,HIAF 112,A00,841742,Gyamfi; Bright,45,0,46,1
1739698358583,HIEA 114,A00,841743,Matsumura; Wendy Y,36,0,50,14
1739698359609,HIEA 131,A00,841744,Muscolino; Micah S,41,0,44,3
1739698360635,HIEA 138,A00,841747,Lu; Weijing,30,0,30,0
1739698361659,HIEA 144,A00,870811,Henry; Todd A.,24,0,25,1
1739698362688,HIEU 128,A00,841749,Hansen; Jan Eric,66,0,70,4
1739698363713,HIEU 138,A00,841750,Devereux; Andrew W,53,0,56,3
1739698364739,HIEU 146,A00,841751,Radcliff; Pamela B.,44,0,50,6
1739698365767,HIEU 148,A00,841753,Biess; Frank Peter,116,0,120,4
1739698366793,HIEU 160,A00,841754,Demetriou; Denise,11,0,15,4
1739698367819,HIEU 183,A00,870697,Gallant; Thomas W.,10,0,10,0
1739698368843,HIEU 184,A00,841757,Patterson; Patrick H.,15,0,15,0
1739698369870,HIEU 283,A00,870698,Gallant; Thomas W.,10,0,10,0
1739698370899,HIGL 126,A00,841758,Gerth; Karl G.,34,0,34,0
1739698371926,HIGR 209,A00,841771,Hanna; Mark G.,10,0,10,0
1739698372952,HIGR 210,A00,841772,Gerth; Karl G.,9,0,10,1
1739698373976,HIGR 220,A00,872411,Strasser; Ulrike,9,0,10,1
1739698375004,HIGR 239,A00,841774,Gere; Catherina M.,9,0,10,1
1739698376029,HIGR 240,A00,841777,McKenzie; Kerry V.,9,0,10,1
1739698377053,HIGR 248B,A00,841778,Vitz; Matthew,10,0,10,0
1739698378081,HIGR 280,A00,841779,Devereux; Andrew W,10,0,10,0
1739698379105,HIGR 282,A00,871856,Henry; Todd A.,10,0,10,0
1739698380136,HILA 132,A00,841759,Vitz; Matthew,141,0,146,5
1739698381160,HILA 144P,A00,869962,Murillo; Dana V.,49,0,50,1
1739698382193,HILD 2C,A01,862763,Hendrickson; Gerald M.,30,0,32,2
1739698382193,HILD 2C,A02,862769,Hendrickson; Gerald M.,30,0,32,2
1739698382193,HILD 2C,A03,862772,Hendrickson; Gerald M.,32,0,32,0
1739698382193,HILD 2C,A04,862774,Hendrickson; Gerald M.,32,0,32,0
1739698382193,HILD 2C,A05,862777,Hendrickson; Gerald M.,31,0,32,1
1739698382193,HILD 2C,A06,862778,Hendrickson; Gerald M.,32,0,32,0
1739698383220,HILD 7B,A01,862780,Martinez-Matsuda; Veronica,32,0,32,0
1739698383220,HILD 7B,A02,862781,Martinez-Matsuda; Veronica,32,0,32,0
1739698383220,HILD 7B,A03,862782,Martinez-Matsuda; Veronica,29,0,32,3
1739698383220,HILD 7B,A04,862783,Martinez-Matsuda; Veronica,31,0,32,1
1739698383220,HILD 7B,A05,862784,Martinez-Matsuda; Veronica,28,0,32,4
1739698383220,HILD 7B,A06,862788,Martinez-Matsuda; Veronica,31,0,32,1
1739698383220,HILD 7B,A07,862789,Martinez-Matsuda; Veronica,32,0,32,0
1739698383220,HILD 7B,A08,862797,Martinez-Matsuda; Veronica,32,0,32,0
1739698383220,HILD 7B,A09,862798,Martinez-Matsuda; Veronica,32,0,32,0
1739698383220,HILD 7B,A10,862799,Martinez-Matsuda; Veronica,30,0,32,2
1739698383220,HILD 7B,A11,862801,Martinez-Matsuda; Veronica,32,0,32,0
1739698383220,HILD 7B,A12,862802,Martinez-Matsuda; Veronica,32,0,32,0
1739698384248,HILD 12,A01,862804,Matsumura; Wendy Y,31,0,32,1
1739698384248,HILD 12,A02,862987,Matsumura; Wendy Y,31,0,32,1
1739698384248,HILD 12,A03,862989,Matsumura; Wendy Y,0,0,0,0
1739698384248,HILD 12,A04,862991,Matsumura; Wendy Y,0,0,0,0
1739698384248,HILD 12,A05,863014,Matsumura; Wendy Y,31,0,32,1
1739698384248,HILD 12,A06,863015,Matsumura; Wendy Y,32,0,32,0
1739698385273,HILD 42,A01,863016,Gere; Catherina M.,31,0,32,1
1739698385273,HILD 42,A02,863017,Gere; Catherina M.,32,0,32,0
1739698386298,HINE 115,A00,841762,Balberg; Mira,44,0,56,12
1739698387324,HINE 116,A00,869964,Gokatalay; Semih,35,0,35,0
1739698388349,HINE 120,A00,869963,Gokatalay; Semih,35,0,35,0
1739698389374,HISA 101,A00,871799,De; Aniket,35,0,35,0
1739698390399,HISA 120,A00,871840,De; Aniket,34,0,35,1
1739698391424,HITO 87,A00,841738,Patterson; Patrick H.,15,0,15,0
1739698391424,HITO 87,B00,841740,Patterson; Patrick H.,14,0,15,1
1739698392448,HITO 100,B00,841764,Kwak; Nancy,23,0,25,2
1739698393472,HITO 170,A00,841765,Watts; Edward J.,9,0,10,1
1739698394496,HITO 193,A00,851603,Staff,0,0,0,0
1739698395525,HIUS 104,A00,841766,Hanna; Mark G.,142,0,146,4
1739698396552,HIUS 114A,A00,841767,Lewandoski; Julia Mavis,48,0,50,2
1739698397576,HIUS 144,B00,841769,Daly; Heather Marie,39,0,40,1
1739698398613,HUM 2,A01,832551,Crum; Matthew Stephen,15,0,15,0
1739698398613,HUM 2,A02,832552,Crum; Matthew Stephen,14,0,15,1
1739698398613,HUM 2,A03,832553,Crum; Matthew Stephen,15,0,15,0
1739698398613,HUM 2,A04,832554,Crum; Matthew Stephen,14,0,15,1
1739698398613,HUM 2,A05,832555,Crum; Matthew Stephen,15,0,15,0
1739698398613,HUM 2,A06,832557,Crum; Matthew Stephen,14,0,15,1
1739698398613,HUM 2,A07,832600,Crum; Matthew Stephen,14,0,15,1
1739698398613,HUM 2,A08,832662,Crum; Matthew Stephen,15,0,15,0
1739698398613,HUM 2,A09,832667,Crum; Matthew Stephen,13,0,15,2
1739698398613,HUM 2,A10,832671,Crum; Matthew Stephen,15,0,15,0
1739698398613,HUM 2,A11,832673,Crum; Matthew Stephen,15,0,15,0
1739698398613,HUM 2,A12,832675,Crum; Matthew Stephen,15,0,15,0
1739698398613,HUM 2,A13,832680,Crum; Matthew Stephen,15,0,15,0
1739698398613,HUM 2,A14,832682,Crum; Matthew Stephen,15,0,15,0
1739698398613,HUM 2,B01,832686,Watts; Edward J.,7,0,15,8
1739698398613,HUM 2,B02,832688,Watts; Edward J.,14,0,15,1
1739698398613,HUM 2,B03,832693,Watts; Edward J.,15,0,15,0
1739698398613,HUM 2,B04,832694,Watts; Edward J.,15,0,15,0
1739698398613,HUM 2,B05,832739,Watts; Edward J.,15,0,15,0
1739698398613,HUM 2,B06,832742,Watts; Edward J.,14,0,15,1
1739698398613,HUM 2,B07,832756,Watts; Edward J.,15,0,15,0
1739698398613,HUM 2,B08,832760,Watts; Edward J.,13,0,15,2
1739698398613,HUM 2,B09,832762,Watts; Edward J.,15,0,15,0
1739698398613,HUM 2,B10,832764,Watts; Edward J.,13,0,15,2
1739698398613,HUM 2,B11,832767,Watts; Edward J.,15,0,15,0
1739698398613,HUM 2,B12,832770,Watts; Edward J.,14,0,15,1
1739698398613,HUM 2,B13,832775,Watts; Edward J.,13,0,15,2
1739698398613,HUM 2,B14,832776,Watts; Edward J.,12,0,15,3
1739698398613,HUM 2,C01,832784,Markman; Kristina,15,0,15,0
1739698398613,HUM 2,C02,832785,Markman; Kristina,15,0,15,0
1739698398613,HUM 2,C03,832787,Markman; Kristina,14,0,15,1
1739698398613,HUM 2,C04,832789,Markman; Kristina,6,0,15,9
1739698398613,HUM 2,C05,832790,Markman; Kristina,15,0,15,0
1739698398613,HUM 2,C06,832793,Markman; Kristina,15,0,15,0
1739698398613,HUM 2,C07,832794,Markman; Kristina,15,0,15,0
1739698398613,HUM 2,C08,832804,Markman; Kristina,15,0,15,0
1739698398613,HUM 2,C09,832805,Markman; Kristina,15,0,15,0
1739698398613,HUM 2,C10,832946,Markman; Kristina,14,0,15,1
1739698398613,HUM 2,C11,833014,Markman; Kristina,15,0,15,0
1739698398613,HUM 2,C12,833037,Markman; Kristina,15,0,15,0
1739698398613,HUM 2,C13,833075,Markman; Kristina,15,0,15,0
1739698398613,HUM 2,C14,833078,Markman; Kristina,13,0,15,2
1739698399642,HUM 5,A01,833083,Lyon; Antony J.,21,0,28,7
1739698399642,HUM 5,A02,833086,Lyon; Antony J.,28,0,28,0
1739698399642,HUM 5,A03,833090,Lyon; Antony J.,27,0,28,1
1739698399642,HUM 5,A04,833095,Lyon; Antony J.,26,0,28,2
1739698399642,HUM 5,A05,833096,Lyon; Antony J.,27,0,28,1
1739698399642,HUM 5,A06,833099,Lyon; Antony J.,26,0,28,2
1739698399642,HUM 5,A07,833110,Lyon; Antony J.,26,0,28,2
1739698399642,HUM 5,A08,833112,Lyon; Antony J.,27,0,28,1
1739698399642,HUM 5,B01,833118,Rodriguez; Bretton Sigfred,24,0,28,4
1739698399642,HUM 5,B02,833122,Rodriguez; Bretton Sigfred,25,0,28,3
1739698399642,HUM 5,B03,833128,Rodriguez; Bretton Sigfred,19,0,28,9
1739698399642,HUM 5,B04,833129,Rodriguez; Bretton Sigfred,24,0,28,4
1739698399642,HUM 5,B05,833133,Rodriguez; Bretton Sigfred,27,0,28,1
1739698399642,HUM 5,B06,833138,Rodriguez; Bretton Sigfred,27,0,28,1
1739698399642,HUM 5,B07,833140,Rodriguez; Bretton Sigfred,27,0,28,1
1739698399642,HUM 5,B08,833141,Rodriguez; Bretton Sigfred,28,0,28,0
1739698399642,HUM 5,C01,833158,West; Geoffrey Scott,20,0,28,8
1739698399642,HUM 5,C02,833159,West; Geoffrey Scott,23,0,28,5
1739698399642,HUM 5,C03,833163,West; Geoffrey Scott,28,0,28,0
1739698399642,HUM 5,C04,833165,West; Geoffrey Scott,27,0,28,1
1739698399642,HUM 5,C05,833168,West; Geoffrey Scott,26,0,28,2
1739698399642,HUM 5,C06,833171,West; Geoffrey Scott,23,0,28,5
1739698399642,HUM 5,C07,833172,West; Geoffrey Scott,26,0,28,2
1739698399642,HUM 5,C08,833176,West; Geoffrey Scott,24,0,28,4
1739698400677,HUM 100,A00,833179,Shenoy; Niyati,16,0,16,0
1739698400677,HUM 100,B00,833180,Shenoy; Niyati,16,0,16,0
1739698400677,HUM 100,C00,833187,Zavodny; Tatiana Sophia,15,0,16,1
1739698400677,HUM 100,D00,833190,Zavodny; Tatiana Sophia,15,0,16,1
1739698400677,HUM 100,E00,833196,West; Geoffrey Scott,15,0,16,1
1739698400677,HUM 100,F00,833199,West; Geoffrey Scott,15,0,16,1
1739698401705,INTL 100,A01,819235,Feuer; Anna Stagg,24,0,25,1
1739698401705,INTL 100,A02,819246,Feuer; Anna Stagg,24,0,25,1
1739698401705,INTL 100,A03,819251,Feuer; Anna Stagg,25,0,25,0
1739698401705,INTL 100,A04,819252,Feuer; Anna Stagg,21,0,25,4
1739698401705,INTL 100,A05,819256,Feuer; Anna Stagg,25,0,25,0
1739698401705,INTL 100,A06,819260,Feuer; Anna Stagg,25,0,25,0
1739698402733,INTL 101,A01,819264,McCord; Gordon Carlos,27,0,35,8
1739698402733,INTL 101,A02,819266,McCord; Gordon Carlos,32,0,35,3
1739698403763,INTL 102,A01,819271,Fisk; David Lee,29,0,35,6
1739698403763,INTL 102,A02,819279,Fisk; David Lee,27,0,35,8
1739698404793,INTL 190,A00,819281,Lettieri; Michael Joseph,0,0,0,2
1739698404793,INTL 190,B00,819301,Vos; Stacie N.,0,0,0,0
1739698404793,INTL 190,C00,819303,McIntosh; Justin,0,0,0,2
1739698404793,INTL 190,D00,819389,Segui; Alan S,0,0,0,2
1739698404793,INTL 190,E00,819393,Segui; Alan S,0,0,0,1
1739698404793,INTL 190,F00,819394,Auerbach; Bradford C,0,0,0,0
1739698404793,INTL 190,G00,819395,Samphantharak; Krislert,0,0,0,2
1739698405830,JAPN 10C,A01,819403,Maruyama; Rie,14,0,15,1
1739698405830,JAPN 10C,B01,819406,McKee; Mayumi Mochizuki,13,0,15,2
1739698405830,JAPN 10C,C01,819448,Ross; Kayoko F,14,0,15,1
1739698405830,JAPN 10C,D01,819450,Sato; Kyoko,15,0,15,0
1739698405830,JAPN 10C,E01,819454,Kamioka; Sachiko,13,0,15,2
1739698405830,JAPN 10C,F01,819457,McKee; Mayumi Mochizuki,10,0,15,5
1739698405830,JAPN 10C,G01,819459,Tipton; Yuko,12,0,15,3
1739698405830,JAPN 10C,H01,819466,Sato; Kyoko,15,0,15,0
1739698405830,JAPN 10C,I01,819486,Homma; Kunihiko,14,0,15,1
1739698405830,JAPN 10C,J01,819536,Tipton; Yuko,15,0,15,0
1739698405830,JAPN 10C,K01,819584,Kamioka; Sachiko,14,0,15,1
1739698406858,JAPN 10CR,A01,819684,Inada; Minori,12,0,12,0
1739698406858,JAPN 10CR,B01,819741,McKee; Mayumi Mochizuki,12,0,12,0
1739698407887,JAPN 20C,A01,819791,Iwamoto; Naoki,13,0,13,0
1739698407887,JAPN 20C,B01,819874,Homma; Kunihiko,12,0,13,1
1739698407887,JAPN 20C,C01,819904,Iwamoto; Naoki,12,0,13,1
1739698407887,JAPN 20C,D01,819934,Takeda; Izumi,12,0,13,1
1739698407887,JAPN 20C,E01,819936,Simpson; Junko Tokuda,13,0,13,0
1739698408913,JAPN 130C,A01,819938,Maruyama; Rie,12,0,12,0
1739698408913,JAPN 130C,B01,820148,Kamioka; Sachiko,9,0,12,3
1739698409945,JAPN 135C,A00,820169,Ross; Kayoko F,11,0,12,1
1739698409945,JAPN 135C,B00,820192,Iwamoto; Naoki,10,0,12,2
1739698410971,JAPN 137C,A00,820201,Simpson; Junko Tokuda,17,0,20,3
1739698411996,JAPN 140C,A00,820210,Takeda; Izumi,19,0,20,1
1739698413024,JWSP 3,A01,820218,Shuster; Alana,15,0,15,0
1739698414052,LATI 10,A01,820230,Kennemore; Amy Michelle,28,0,30,2
1739698414052,LATI 10,A02,820286,Kennemore; Amy Michelle,29,0,30,1
1739698414052,LATI 10,A03,820289,Kennemore; Amy Michelle,29,0,30,1
1739698414052,LATI 10,A04,820293,Kennemore; Amy Michelle,29,0,30,1
1739698414052,LATI 10,A05,820380,Kennemore; Amy Michelle,30,0,30,0
1739698414052,LATI 10,A06,820381,Kennemore; Amy Michelle,29,0,30,1
1739698415080,LATI 50,A01,820465,Kokinis; Troy Andreas,29,0,30,1
1739698415080,LATI 50,A02,820466,Kokinis; Troy Andreas,30,0,30,0
1739698415080,LATI 50,A03,820470,Kokinis; Troy Andreas,0,0,0,0
1739698415080,LATI 50,A04,820490,Kokinis; Troy Andreas,0,0,0,0
1739698415080,LATI 50,A05,872455,Kokinis; Troy Andreas,0,0,0,0
1739698416107,LATI 130,A00,820527,Alvarez; Camila Huerta,46,0,46,0
1739698417149,LATI 131,A00,869142,Villafuerte Vazquez; Nadia,30,0,30,0
1739698419198,LATI 166,A00,886084,Kokinis; Troy Andreas,42,0,42,0
1739698420227,LATI 180,A00,820555,Kennemore; Amy Michelle,40,0,44,4
1739698421257,LIAB 1C,B00,820742,Saab; Dima,12,0,14,2
1739698421257,LIAB 1C,C00,820744,Saab; Dima,12,0,14,2
1739698422283,LIAB 1CX,A00,820745,El Cheddadi; Youniss,25,0,28,3
1739698423313,LIAB 1F,A00,872423,El Cheddadi; Youniss,15,0,15,0
1739698424341,LIDS 19,001,886201,Goodall; Grant Todd,9999,0,9999,0
1739698424341,LIDS 19,002,886202,Goodall; Grant Todd,9999,0,9999,0
1739698424341,LIDS 19,003,886204,Goodall; Grant Todd,9999,0,9999,0
1739698424341,LIDS 19,004,886207,Goodall; Grant Todd,9999,0,9999,0
1739698424341,LIDS 19,005,886208,Goodall; Grant Todd,9999,0,9999,0
1739698424341,LIDS 19,006,886209,Goodall; Grant Todd,9999,0,9999,0
1739698424341,LIDS 19,007,886210,Goodall; Grant Todd,9999,0,9999,0
1739698424341,LIDS 19,008,886211,Goodall; Grant Todd,9999,0,9999,0
1739698424341,LIDS 19,009,886213,Goodall; Grant Todd,9999,0,9999,0
1739698424341,LIDS 19,010,886214,Goodall; Grant Todd,9999,0,9999,0
1739698424341,LIDS 19,011,886215,Goodall; Grant Todd,9999,0,9999,0
1739698424341,LIDS 19,012,886216,Goodall; Grant Todd,9999,0,9999,0
1739698425370,LIFR 1A,C00,820857,Van Moer; Vinciane G,12,0,14,2
1739698425370,LIFR 1A,D00,820858,Van Moer; Vinciane G,14,0,14,0
1739698426398,LIFR 1AX,B00,820861,Van Moer; Vinciane G,27,0,28,1
1739698427429,LIFR 1C,A00,820862,Van Moer; Vinciane G,12,0,14,2
1739698427429,LIFR 1C,B00,820916,Van Moer; Vinciane G,12,0,14,2
1739698427429,LIFR 1C,C00,820970,Van Moer; Vinciane G,14,0,14,0
1739698427429,LIFR 1C,D00,820971,Van Moer; Vinciane G,13,0,14,1
1739698428510,LIFR 1CX,A00,820972,Van Moer; Vinciane G,26,0,28,2
1739698428510,LIFR 1CX,B00,820973,Van Moer; Vinciane G,26,0,28,2
1739698429540,LIFR 1D,A00,820974,Van Moer; Vinciane G,13,0,14,1
1739698429540,LIFR 1D,B00,820975,Van Moer; Vinciane G,11,0,14,3
1739698429540,LIFR 1D,C00,820976,Van Moer; Vinciane G,14,0,14,0
1739698429540,LIFR 1D,D00,820977,Van Moer; Vinciane G,14,0,14,0
1739698430566,LIFR 1DX,A00,820978,Van Moer; Vinciane G,25,0,28,3
1739698430566,LIFR 1DX,B00,820979,Van Moer; Vinciane G,28,0,28,0
1739698431594,LIFR 11,001,820980,Goodall; Grant Todd,9999,0,9999,0
1739698432621,LIGM 1C,A00,820981,Fischer-Grunski; Eva K,14,0,14,0
1739698432621,LIGM 1C,B00,820982,Fischer-Grunski; Eva K,11,0,14,3
1739698433652,LIGM 1CX,A00,820985,Fischer-Grunski; Eva K,13,0,14,1
1739698433652,LIGM 1CX,B00,820986,Fischer-Grunski; Eva K,13,0,14,1
1739698434678,LIGM 11,001,820987,Goodall; Grant Todd,9999,0,9999,0
1739698435704,LIGN 8,A00,821976,McIntosh; Justin,238,0,250,12
1739698436733,LIGN 17,A00,821977,Kehler; Andrew Scott,247,0,250,3
1739698437758,LIGN 101,A01,821980,Staff,35,0,35,0
1739698437758,LIGN 101,A02,821982,Staff,35,0,35,0
1739698437758,LIGN 101,A03,821983,Staff,35,0,35,0
1739698437758,LIGN 101,A04,821984,Staff,35,0,35,0
1739698438785,LIGN 113,A00,821985,Styler; William Francis,88,0,90,2
1739698439813,LIGN 117,A00,869927,Kehler; Andrew Scott,42,0,50,8
1739698440843,LIGN 120,A01,821987,Caballero; Gabriela Hernandez,23,0,25,2
1739698440843,LIGN 120,A02,821988,Caballero; Gabriela Hernandez,22,0,25,3
1739698440843,LIGN 120,A03,821990,Caballero; Gabriela Hernandez,20,0,25,5
1739698441871,LIGN 146,A00,821992,Lott; Margaret S.,27,0,30,3
1739698442899,LIGN 165,A00,821993,Bergen; Leon,51,0,70,19
1739698443926,LIGN 180,A00,821994,Kluender; Robert,63,0,70,7
1739698444954,LIGN 188R,A00,821996,Clem; Emily,40,0,40,0
1739698445983,LIGN 200,A00,821997,Warstadt; Alexander Scott,35,0,35,0
1739698447008,LIGN 211,A00,821999,Bakovic; Eric John,20,0,20,0
1739698448034,LIGN 220,A00,822003,Caballero; Gabriela Hernandez,18,0,20,2
1739698449058,LIGN 225,A00,822004,Goodall; Grant Todd,20,0,20,0
1739698450086,LIGN 238,A00,822005,Bergen; Benjamin,20,0,20,0
1739698451114,LIGN 252,A00,822006,Bergen; Leon,14,0,15,1
1739698452141,LIGN 279,A00,822007,Dudley; Rachel,17,0,20,3
1739698453175,LIGN 296,001,821907,Ackerman; Farrell,5,0,5,0
1739698453175,LIGN 296,002,821908,Bakovic; Eric John,5,0,5,0
1739698453175,LIGN 296,003,821909,Bergen; Leon,5,0,5,0
1739698453175,LIGN 296,004,821910,Caballero; Gabriela Hernandez,5,0,5,0
1739698453175,LIGN 296,005,821912,Caponigro; Ivano,5,0,5,0
1739698453175,LIGN 296,006,821913,Clem; Emily,5,0,5,0
1739698453175,LIGN 296,007,821914,Dudley; Rachel,5,0,5,0
1739698453175,LIGN 296,008,821916,Garellek; Marc,5,0,5,0
1739698453175,LIGN 296,009,821917,Goodall; Grant Todd,5,0,5,0
1739698453175,LIGN 296,010,821918,Kehler; Andrew Scott,5,0,5,0
1739698453175,LIGN 296,011,821919,Kluender; Robert,5,0,5,0
1739698453175,LIGN 296,012,821920,Mayberry; Rachel,5,0,5,0
1739698453175,LIGN 296,013,821921,Rose; Sharon,5,0,5,0
1739698453175,LIGN 296,014,821924,Styler; William Francis,5,0,5,0
1739698453175,LIGN 296,015,821925,Warstadt; Alexander Scott,5,0,5,0
1739698454203,LIHL 112P,A00,820733,Pagkalinawan; Leticia Cant,29,0,30,1
1739698455230,LIHL 114P,A00,820734,Nguyen; Hoan Thi,29,0,30,1
1739698456258,LIHL 117P,A00,820735,Sadegholvad; Elham,28,0,28,0
1739698457282,LIHL 118,A00,820736,Chen; Areana Yen,30,0,30,0
1739698458307,LIHL 124P,A00,820737,Nguyen; Hoan Thi,26,0,28,2
1739698459332,LIHL 132P,A00,820738,Pagkalinawan; Leticia Cant,28,0,28,0
1739698460358,LIHL 134P,A00,820739,Nguyen; Hoan Thi,28,0,28,0
1739698461387,LIHL 138,A00,820740,Chen; Areana Yen,15,0,16,1
1739698462418,LIIT 1C,A00,820988,Carnelos; Chiara,13,0,14,1
1739698462418,LIIT 1C,B00,820989,Carnelos; Chiara,9,0,14,5
1739698463445,LIIT 1CX,A00,820990,Carnelos; Chiara,23,0,28,5
1739698464474,LIPO 1C,A00,820991,Paladini; Denise,14,0,14,0
1739698464474,LIPO 1C,B00,820992,Paladini; Denise,14,0,14,0
1739698465501,LIPO 1CX,A00,820993,De Abreu; Cassia,28,0,28,0
1739698466531,LISL 1A,A00,820994,Lott; Margaret S.,13,0,14,1
1739698466531,LISL 1A,B00,820995,Lott; Margaret S.,14,0,14,0
1739698466531,LISL 1A,C00,820996,Lott; Margaret S.,13,0,14,1
1739698466531,LISL 1A,D00,820997,Lott; Margaret S.,14,0,14,0
1739698466531,LISL 1A,E00,820998,Lott; Margaret S.,14,0,14,0
1739698466531,LISL 1A,F00,820999,Lott; Margaret S.,14,0,14,0
1739698467559,LISL 1AR,A00,821000,Lott; Margaret S.,12,0,15,3
1739698467559,LISL 1AR,B00,821001,Lott; Margaret S.,12,0,15,3
1739698467559,LISL 1AR,C00,885716,Lott; Margaret S.,3,0,3,0
1739698467559,LISL 1AR,D00,885778,Lott; Margaret S.,3,0,3,0
1739698468589,LISL 1AX,A00,821002,Lott; Margaret S.,27,0,28,1
1739698468589,LISL 1AX,B00,821003,Lott; Margaret S.,28,0,28,0
1739698468589,LISL 1AX,C00,821004,Lott; Margaret S.,27,0,28,1
1739698469617,LISL 1C,A00,821009,Lott; Margaret S.,12,0,14,2
1739698469617,LISL 1C,B00,821010,Lott; Margaret S.,14,0,14,0
1739698469617,LISL 1C,C00,821011,Lott; Margaret S.,13,0,14,1
1739698469617,LISL 1C,D00,821012,Lott; Margaret S.,14,0,14,0
1739698469617,LISL 1C,E00,821022,Lott; Margaret S.,12,0,14,2
1739698469617,LISL 1C,F00,821023,Lott; Margaret S.,14,0,14,0
1739698470645,LISL 1CX,A00,821024,Lott; Margaret S.,26,0,28,2
1739698470645,LISL 1CX,B00,821027,Lott; Margaret S.,23,0,28,5
1739698470645,LISL 1CX,C00,821029,Lott; Margaret S.,28,0,28,0
1739698471676,LISL 1D,A00,821030,Lott; Margaret S.,13,0,14,1
1739698471676,LISL 1D,B00,821083,Lott; Margaret S.,14,0,14,0
1739698471676,LISL 1D,C00,821084,Lott; Margaret S.,14,0,14,0
1739698471676,LISL 1D,D00,821148,Lott; Margaret S.,8,0,14,6
1739698472703,LISL 1DX,A00,821160,Lott; Margaret S.,23,0,28,5
1739698472703,LISL 1DX,B00,821165,Lott; Margaret S.,27,0,28,1
1739698473730,LISP 1A,001,821174,Munoz Sanchez; Alicia,12,0,14,2
1739698473730,LISP 1A,002,821175,Munoz Sanchez; Alicia,12,0,14,2
1739698473730,LISP 1A,003,821179,Munoz Sanchez; Alicia,12,0,14,2
1739698473730,LISP 1A,004,821180,Munoz Sanchez; Alicia,13,0,14,1
1739698474757,LISP 1AX,001,821196,Munoz Sanchez; Alicia,26,0,28,2
1739698474757,LISP 1AX,002,821204,Munoz Sanchez; Alicia,26,0,28,2
1739698475784,LISP 1C,001,821226,Munoz Sanchez; Alicia,14,0,14,0
1739698475784,LISP 1C,002,821250,Munoz Sanchez; Alicia,13,0,14,1
1739698475784,LISP 1C,003,821251,Munoz Sanchez; Alicia,12,0,14,2
1739698475784,LISP 1C,004,821259,Munoz Sanchez; Alicia,14,0,14,0
1739698475784,LISP 1C,005,821274,Munoz Sanchez; Alicia,12,0,14,2
1739698475784,LISP 1C,006,821280,Munoz Sanchez; Alicia,13,0,14,1
1739698475784,LISP 1C,007,821281,Munoz Sanchez; Alicia,13,0,14,1
1739698475784,LISP 1C,009,821299,Munoz Sanchez; Alicia,13,0,14,1
1739698475784,LISP 1C,010,821300,Munoz Sanchez; Alicia,14,0,14,0
1739698476815,LISP 1CX,001,821305,Munoz Sanchez; Alicia,30,0,32,2
1739698476815,LISP 1CX,002,821312,Munoz Sanchez; Alicia,31,0,32,1
1739698476815,LISP 1CX,004,821314,Munoz Sanchez; Alicia,28,0,32,4
1739698476815,LISP 1CX,005,821343,Munoz Sanchez; Alicia,28,0,32,4
1739698477850,LISP 1D,002,821390,Munoz Sanchez; Alicia,13,0,14,1
1739698477850,LISP 1D,003,821391,Munoz Sanchez; Alicia,14,0,14,0
1739698477850,LISP 1D,004,821392,Munoz Sanchez; Alicia,14,0,14,0
1739698477850,LISP 1D,005,821393,Munoz Sanchez; Alicia,13,0,14,1
1739698477850,LISP 1D,006,821395,Munoz Sanchez; Alicia,13,0,14,1
1739698477850,LISP 1D,007,821396,Munoz Sanchez; Alicia,14,0,14,0
1739698477850,LISP 1D,008,821397,Munoz Sanchez; Alicia,14,0,14,0
1739698477850,LISP 1D,009,821398,Munoz Sanchez; Alicia,14,0,14,0
1739698477850,LISP 1D,011,821400,Munoz Sanchez; Alicia,13,0,14,1
1739698477850,LISP 1D,012,821401,Munoz Sanchez; Alicia,12,0,14,2
1739698477850,LISP 1D,013,821402,Munoz Sanchez; Alicia,14,0,14,0
1739698477850,LISP 1D,014,821403,Munoz Sanchez; Alicia,14,0,14,0
1739698477850,LISP 1D,015,821404,Munoz Sanchez; Alicia,12,0,14,2
1739698477850,LISP 1D,016,821405,Munoz Sanchez; Alicia,11,0,14,3
1739698477850,LISP 1D,017,821406,Munoz Sanchez; Alicia,14,0,14,0
1739698477850,LISP 1D,018,821407,Munoz Sanchez; Alicia,14,0,14,0
1739698477850,LISP 1D,019,821408,Munoz Sanchez; Alicia,14,0,14,0
1739698477850,LISP 1D,020,821409,Munoz Sanchez; Alicia,14,0,14,0
1739698477850,LISP 1D,021,821410,Munoz Sanchez; Alicia,13,0,14,1
1739698477850,LISP 1D,022,821411,Munoz Sanchez; Alicia,14,0,14,0
1739698477850,LISP 1D,023,821412,Munoz Sanchez; Alicia,14,0,14,0
1739698477850,LISP 1D,024,821413,Munoz Sanchez; Alicia,14,0,14,0
1739698478883,LISP 1DX,001,821414,Munoz Sanchez; Alicia,27,0,28,1
1739698478883,LISP 1DX,002,821415,Munoz Sanchez; Alicia,28,0,28,0
1739698478883,LISP 1DX,003,821416,Munoz Sanchez; Alicia,27,0,28,1
1739698478883,LISP 1DX,004,821417,Munoz Sanchez; Alicia,24,0,28,4
1739698478883,LISP 1DX,005,821418,Munoz Sanchez; Alicia,28,0,28,0
1739698478883,LISP 1DX,006,821419,Munoz Sanchez; Alicia,24,0,28,4
1739698478883,LISP 1DX,007,821420,Munoz Sanchez; Alicia,28,0,28,0
1739698478883,LISP 1DX,008,821430,Munoz Sanchez; Alicia,26,0,28,2
1739698478883,LISP 1DX,009,821434,Munoz Sanchez; Alicia,28,0,28,0
1739698478883,LISP 1DX,010,821478,Munoz Sanchez; Alicia,27,0,28,1
1739698478883,LISP 1DX,011,821489,Munoz Sanchez; Alicia,28,0,28,0
1739698479914,LISP 17,001,821599,Munoz Sanchez; Alicia,17,0,20,3
1739698480941,LISP 18,001,821606,Munoz Sanchez; Alicia,18,0,20,2
1739698481970,LTAM 111,A00,822939,Johnson; Sara E.,39,0,40,1
1739698482996,LTCH 101,A00,822940,Liao; Ping H,119,0,120,1
1739698484023,LTCO 287,A00,823141,Vitkus; Daniel J.,14,0,15,1
1739698485048,LTCS 12,A00,822033,Staff,40,0,40,0
1739698486074,LTCS 87,A00,822034,Nguyen; Hoang Tan,19,0,20,1
1739698486074,LTCS 87,B00,822035,Nguyen; Hoang Tan,20,0,20,0
1739698487102,LTCS 111,A00,822941,Bessett; Ryan Matthew,39,0,40,1
1739698488132,LTCS 222,A00,823145,Nguyen; Hoang Tan,12,0,15,3
1739698489161,LTCS 250,A00,823151,Myerston Santana; Jacobo,13,0,15,2
1739698490187,LTEA 100B,A00,822944,Fiss; Geraldine Anna,37,0,40,3
1739698491215,LTEA 110C,A00,822945,Zhu; Ping,39,0,40,1
1739698492245,LTEA 120A,A00,822946,Zhu; Ping,297,0,300,3
1739698493272,LTEN 22,A01,822037,Lu; Lillian,28,0,28,0
1739698493272,LTEN 22,A02,822039,Lu; Lillian,28,0,28,0
1739698493272,LTEN 22,A03,822040,Lu; Lillian,26,0,28,2
1739698493272,LTEN 22,A04,822042,Lu; Lillian,27,0,28,1
1739698494301,LTEN 28,A01,822044,Suzuki; Erin M.,27,0,28,1
1739698494301,LTEN 28,A02,822045,Suzuki; Erin M.,28,0,28,0
1739698494301,LTEN 28,A03,822046,Suzuki; Erin M.,27,0,28,1
1739698494301,LTEN 28,A04,822047,Suzuki; Erin M.,28,0,28,0
1739698494301,LTEN 28,A05,822049,Suzuki; Erin M.,28,0,28,0
1739698494301,LTEN 28,A06,822054,Suzuki; Erin M.,27,0,28,1
1739698494301,LTEN 28,A07,822056,Suzuki; Erin M.,26,0,28,2
1739698494301,LTEN 28,A08,822057,Suzuki; Erin M.,28,0,28,0
1739698495327,LTEN 110,A00,822947,Dhar; Amrita,36,0,40,4
1739698496353,LTEN 127,A00,822948,Garofalo; Devin,36,0,40,4
1739698497377,LTEN 148,A00,822949,Suzuki; Erin M.,35,0,40,5
1739698498402,LTEN 149,A00,872375,Wesling; Megan E.,34,0,40,6
1739698499428,LTEN 181,A00,822950,Mukherjee; Silpa,56,0,60,4
1739698500453,LTEN 183,A00,822951,Childs; Dennis R.,18,0,20,2
1739698501479,LTEN 185,A00,822952,Childs; Dennis R.,19,0,20,1
1739698502509,LTEN 231,A00,823152,Lu; Lillian,13,0,15,2
1739698503536,LTEN 254,A00,823160,Ruiz; Ariana,15,0,15,0
1739698504562,LTEU 110,A00,822953,Kontje; Todd Curtis,38,0,40,2
1739698505592,LTEU 140,A00,872377,De Marchi Gherini; Adriana,38,0,40,2
1739698506617,LTEU 154,A00,872369,Morse; Ainsley,34,0,35,1
1739698507643,LTFR 2A,A01,822059,Ploye; Catherine,28,0,28,0
1739698508669,LTFR 2C,A00,822060,Ploye; Catherine,25,0,25,0
1739698509695,LTFR 141,A00,822955,Zhiri; Oumelbanine,25,0,25,0
1739698510721,LTGK 3,A00,822062,Murray; Kourtney Kristine,31,0,31,0
1739698511746,LTGM 2C,A00,822067,Fischer-Grunski; Eva K,23,0,25,2
1739698512770,LTIT 50,A00,822068,De Marchi Gherini; Adriana,25,0,25,0
1739698513805,LTKO 1C,A01,822071,Jung; Ji Yun,26,0,28,2
1739698513805,LTKO 1C,B01,822075,Jung; Ji Yun,27,0,28,1
1739698513805,LTKO 1C,C01,822078,Lim; Meeyoung,28,0,28,0
1739698513805,LTKO 1C,D01,822098,Yim; Nancy,27,0,28,1
1739698513805,LTKO 1C,E01,822104,Yim; Nancy,28,0,28,0
1739698514835,LTKO 2C,A01,822289,Yim; Nancy,26,0,28,2
1739698515864,LTKO 130P,A00,822956,Lee; Jeyseon,25,0,25,0
1739698516893,LTKO 135,A00,822992,Lee; Jeyseon,25,0,25,0
1739698517921,LTLA 3,A00,822472,Murray; Kourtney Kristine,45,0,45,0
1739698518949,LTRU 1C,A01,822476,Wells; Patricia Rebecca,27,0,28,1
1739698519974,LTRU 104A,A01,823009,Wells; Patricia Rebecca,27,0,28,1
1739698521000,LTRU 150,A00,872370,Morse; Ainsley,5,0,5,0
1739698522029,LTSP 2A,A01,822483,Lampell; Toni,27,0,28,1
1739698523054,LTSP 2B,A01,822508,Mastromartino; Alexandra L,27,0,28,1
1739698524080,LTSP 2C,A01,822534,Lampell; Toni,27,0,28,1
1739698524080,LTSP 2C,B01,822616,Lampell; Toni,28,0,28,0
1739698525106,LTSP 2F,A00,822619,Mastromartino; Alexandra L,25,0,25,0
1739698526137,LTSP 3F,A00,822629,Dominguez; Noelia,25,0,25,0
1739698526137,LTSP 3F,B00,822669,Dominguez; Noelia,25,0,25,0
1739698527163,LTSP 100A,A00,823023,Dominguez; Noelia,24,0,25,1
1739698528192,LTSP 100F,A00,823027,Bessett; Ryan Matthew,25,0,25,0
1739698528192,LTSP 100F,B00,823028,Martin-Cabrera; Luis,24,0,25,1
1739698529218,LTSP 134,A00,823035,Arcos Herrera; Carol,40,0,40,0
1739698530242,LTSP 155,A00,823036,Mendoza; Andrea,39,0,40,1
1739698531268,LTSP 169,A00,823037,Martin-Cabrera; Luis,38,0,40,2
1739698532348,LTSP 175,A00,823038,Arcos Herrera; Carol,39,0,40,1
1739698533377,LTSP 272,A00,823162,Chacon; Gloria Elizabeth,15,0,15,0
1739698534403,LTTH 210C,A00,823163,Glaser; Amelia,15,0,15,0
1739698535433,LTTH 250,A00,823180,Carroll; Amy Sara,12,0,15,3
1739698536458,LTTH 260,A00,823181,Mendoza; Andrea,29,0,30,1
1739698537484,LTWL 12,A00,822679,Villafuerte Vazquez; Nadia,40,0,40,0
1739698538510,LTWL 19C,A00,822710,Kelting; Edward William,37,0,40,3
1739698539535,LTWL 101,A00,823039,Kelting; Edward William,35,0,40,5
1739698540562,LTWL 114,A00,823040,Morse; Ainsley,40,0,40,0
1739698541585,LTWL 128,A00,823041,Cohen; Alain J. J.,39,0,40,1
1739698542610,LTWL 138,A00,823042,Fiss; Geraldine Anna,40,0,40,0
1739698543635,LTWL 180,A00,823045,Mukherjee; Silpa,39,0,40,1
1739698544664,LTWL 184,A00,823046,Cohen; Alain J. J.,40,0,40,0
1739698545690,LTWL 192,A00,823047,Blanco; John D,20,0,20,0
1739698546716,LTWL 194A,A00,823048,Suzuki; Erin M.,27,0,30,3
1739698547741,LTWR 8A,A01,822713,Jemc; Jaclyn,28,0,28,0
1739698547741,LTWR 8A,A02,822863,Jemc; Jaclyn,27,0,28,1
1739698547741,LTWR 8A,A03,822923,Jemc; Jaclyn,28,0,28,0
1739698547741,LTWR 8A,A04,822932,Jemc; Jaclyn,26,0,28,2
1739698548772,LTWR 8C,A01,822935,Wilkinson; Marco,26,0,28,2
1739698548772,LTWR 8C,A02,822936,Wilkinson; Marco,27,0,28,1
1739698548772,LTWR 8C,A03,822937,Wilkinson; Marco,27,0,28,1
1739698548772,LTWR 8C,A04,822938,Wilkinson; Marco,25,0,28,3
1739698549801,LTWR 100W,A00,854460,Terry; Christopher,7,0,15,8
1739698550830,LTWR 102W,A00,823049,Doller; Ben,12,0,15,3
1739698551858,LTWR 106C,A00,823050,Terry; Christopher,27,0,30,3
1739698552887,LTWR 109C,A00,823080,Doller; Ben,28,0,30,2
1739698553918,LTWR 113C,A00,823093,Som; Brandon D,29,0,30,1
1739698554944,LTWR 115W,A00,823096,Springer; Anna Joy,13,0,15,2
1739698555969,LTWR 119C,A00,823099,Copp; Corina,28,0,30,2
1739698556998,LTWR 124W,A00,823102,Copp; Corina,15,0,15,0
1739698558023,LTWR 126C,A00,823108,Terry; Christopher,29,0,30,1
1739698559048,LTWR 140,A00,823133,Carroll; Amy Sara,30,0,30,0
1739698560077,LTWR 148,A00,823136,Wilkinson; Marco,39,0,40,1
1739698561106,LTWR 215,A00,823218,Jemc; Jaclyn,18,0,20,2
1739698562135,MAE 3,A01,825269,Delson; Nathan Joseph,13,0,16,3
1739698562135,MAE 3,A02,825273,Delson; Nathan Joseph,13,0,16,3
1739698562135,MAE 3,A03,825278,Delson; Nathan Joseph,11,0,16,5
1739698562135,MAE 3,A04,825280,Delson; Nathan Joseph,14,0,16,2
1739698562135,MAE 3,B01,825301,Morimoto; Tania,12,0,16,4
1739698562135,MAE 3,B02,825303,Morimoto; Tania,6,0,16,10
1739698562135,MAE 3,B03,825312,Morimoto; Tania,16,0,16,0
1739698562135,MAE 3,B04,825343,Morimoto; Tania,16,0,16,0
1739698563161,MAE 8,A01,825350,Qian; Kai,93,0,100,7
1739698564191,MAE 30B,A00,825352,Lubarda; Marko,96,0,100,4
1739698564191,MAE 30B,B00,825362,Ghazinejad; Maziar,85,0,100,15
1739698565218,MAE 87,A00,872412,Mullin; Jennifer S & Twomey; Robert Daniel,10,0,10,0
1739698566244,MAE 101B,A00,825363,Nomura; Keiko K.,143,0,146,3
1739698567271,MAE 101C,A00,825364,Staff,0,0,0,0
1739698568298,MAE 101D,A00,825378,Coimbra; Carlos F.,16,0,25,9
1739698569323,MAE 104,A00,825379,Pham; Hieu Tan,91,0,100,9
1739698570348,MAE 105,A00,825380,Bandaru; Prabhakar,95,0,100,5
1739698571375,MAE 107,A00,825381,Lindsey; Stephanie,94,0,100,6
1739698572402,MAE 119,A00,825382,Hidalgo-Gonzalez; Patricia,123,0,146,23
1739698573430,MAE 131A,A00,825385,Qi; Huihui,84,0,100,16
1739698573430,MAE 131A,B00,825435,Luan; Haiwen,99,0,100,1
1739698574456,MAE 143B,A00,825498,Diagne; Mamadou Lamine,62,0,80,18
1739698574456,MAE 143B,B00,825499,Kramer; Boris,92,0,96,4
1739698575485,MAE 148,A01,825502,Silberman; Jack,17,0,26,9
1739698576513,MAE 150,A00,825505,Friend; James Robert,115,0,120,5
1739698577538,MAE 152,A00,886080,Llewellyn Smith; Stefan G.,16,0,16,0
1739698577538,MAE 152,B00,886081,Llewellyn Smith; Stefan G.,16,0,16,0
1739698577538,MAE 152,C00,886082,Llewellyn Smith; Stefan G.,14,0,16,2
1739698577538,MAE 152,D00,886083,Llewellyn Smith; Stefan G.,16,0,16,0
1739698578566,MAE 155B,A01,825508,Anderson; Mark Ronald,17,0,50,33
1739698578566,MAE 155B,B01,825515,Hwang; John T,36,0,50,14
1739698579594,MAE 156B,D01,825618,Tustaniwskyj; Jerry I,30,0,35,5
1739698579594,MAE 156B,A01,825549,Delson; Nathan Joseph,34,0,35,1
1739698579594,MAE 156B,B01,825595,Ghazinejad; Maziar,30,0,35,5
1739698579594,MAE 156B,C01,825604,Pawlak; Geno Ronald,32,0,35,3
1739698579594,MAE 156B,F01,825626,Saha; Abhishek,34,0,35,1
1739698579594,MAE 156B,G01,825631,Qi; Huihui,32,0,35,3
1739698580621,MAE 170,A01,825636,Lubarda; Marko,27,0,32,5
1739698580621,MAE 170,A02,825638,Lubarda; Marko,31,0,32,1
1739698580621,MAE 170,A03,825639,Lubarda; Marko,31,0,32,1
1739698580621,MAE 170,B04,825643,Evdokimenko; Ekaterina,28,0,32,4
1739698580621,MAE 170,B05,825645,Evdokimenko; Ekaterina,21,0,32,11
1739698580621,MAE 170,B06,825648,Evdokimenko; Ekaterina,26,0,32,6
1739698581647,MAE 171A,A01,825655,Tynan; George Robert,22,0,30,8
1739698581647,MAE 171A,A02,825657,Tynan; George Robert,29,0,30,1
1739698582674,MAE 175A,A01,825661,de Callafon; Raymond A,20,0,20,0
1739698582674,MAE 175A,A02,825662,de Callafon; Raymond A,14,0,20,6
1739698583699,MAE 184,A00,825714,Anderson; Mark Ronald,23,0,60,37
1739698584725,MAE 185,A00,825715,Schmidt; Oliver,28,0,60,32
1739698585753,MAE 190,A00,825719,Beg; Farhat N.,34,0,40,6
1739698585753,MAE 190,B00,825720,Tynan; George Robert & Mullin; Jennifer S,57,0,60,3
1739698585753,MAE 190,C00,869044,Gerardo; Hortense Flotilde,13,0,14,1
1739698586778,MAE 205,A00,825721,Herbert; Sylvia Lee & Pawlak; Geno Ronald & Mullin; Jennifer S & Lindsey; Stephanie & Cai; Shengqiang & Beg; Farhat N.,9995,0,9999,4
1739698587808,MAE 207,A00,825722,Beg; Farhat N.,7,0,10,3
1739698587808,MAE 207,B00,869156,Gerardo; Hortense Flotilde,24,0,30,6
1739698588837,MAE 209,A00,825723,Scholtes Acevedo; Claire,18,0,30,12
1739698589864,MAE 210C,A00,869158,Sanchez; Antonio Luis,9,0,15,6
1739698590892,MAE 214A,A00,825724,Sarkar; Sutanu,0,0,20,20
1739698591918,MAE 217C,A00,825725,Marinoni; Alessandro,12,0,15,3
1739698592944,MAE 221D,A00,825726,Poulikakos; Lisa Voula,0,0,15,15
1739698593972,MAE 223,A01,825729,Lucas; Andrew J.,0,0,32,32
1739698594996,MAE 224A,A00,825731,Pawlak; Geno Ronald,0,0,10,10
1739698596022,MAE 227,A00,825732,Hidalgo-Gonzalez; Patricia,0,0,15,15
1739698597050,MAE 231B,A00,825733,Boechler; Nicholas Sebastia,28,0,30,2
1739698598074,MAE 240,A00,825734,Rosengren; Aaron,22,0,40,18
1739698599099,MAE 242,A00,825735,Martinez; Sonia,0,0,40,40
1739698600142,MAE 243,A00,869161,Davidson; Michael R,11,0,20,9
1739698601169,MAE 254,A00,825736,Chen; Renkun,0,0,15,15
1739698602194,MAE 256,A00,825740,Coimbra; Carlos F.,7,0,15,8
1739698603221,MAE 266,A00,825741,Evdokimenko; Ekaterina,0,0,20,20
1739698604246,MAE 269,A00,825837,Gravish; Nicholas G,0,0,35,35
1739698605274,MAE 271B,A00,825838,Garay; Javier,5,0,5,0
1739698606301,MAE 272,A00,825839,Meyers; Marc,4,0,15,11
1739698607329,MAE 280B,A00,825840,de Callafon; Raymond A,11,0,40,29
1739698608359,MAE 281B,A00,825842,Cortes; Jorge,7,0,20,13
1739698609384,MAE 289C,A00,825843,McEneaney; William Michael,8,0,10,2
1739698610414,MAE 290C,A00,825846,Schmidt; Oliver,27,0,30,3
1739698611444,MAE 294C,A01,825850,Young; William Roy,10,0,10,0
1739698612471,MATH 2,A01,848213,Cheng; Hsiao-Bing,187,0,190,3
1739698613500,MATH 3B,A01,848358,Ohm; Ko Woon,28,0,30,2
1739698613500,MATH 3B,A02,848359,Ohm; Ko Woon,30,0,30,0
1739698613500,MATH 3B,A03,848368,Ohm; Ko Woon,18,0,30,12
1739698613500,MATH 3B,A04,848369,Ohm; Ko Woon,30,0,30,0
1739698614529,MATH 3C,A01,848397,Anzaldo; Leesa B,20,0,28,8
1739698614529,MATH 3C,A02,848398,Anzaldo; Leesa B,28,0,28,0
1739698614529,MATH 3C,A03,848399,Anzaldo; Leesa B,28,0,28,0
1739698614529,MATH 3C,A04,848400,Anzaldo; Leesa B,28,0,28,0
1739698614529,MATH 3C,B01,848423,Nandi; Achinta Kumar,24,0,30,6
1739698614529,MATH 3C,B02,848439,Nandi; Achinta Kumar,30,0,30,0
1739698614529,MATH 3C,B03,848458,Nandi; Achinta Kumar,29,0,30,1
1739698614529,MATH 3C,B04,848459,Nandi; Achinta Kumar,30,0,30,0
1739698615555,MATH 4C,A01,848474,Briones; Jor-el Thomas Caparas,31,0,35,4
1739698615555,MATH 4C,A02,848476,Briones; Jor-el Thomas Caparas,35,0,36,1
1739698615555,MATH 4C,A03,848479,Briones; Jor-el Thomas Caparas,36,0,36,0
1739698615555,MATH 4C,A04,848481,Briones; Jor-el Thomas Caparas,36,0,36,0
1739698616588,MATH 10A,A01,848484,Briones; Jor-el Thomas Caparas,31,0,33,2
1739698616588,MATH 10A,A02,848490,Briones; Jor-el Thomas Caparas,32,0,33,1
1739698616588,MATH 10A,A03,848495,Briones; Jor-el Thomas Caparas,21,0,33,12
1739698616588,MATH 10A,A04,848508,Briones; Jor-el Thomas Caparas,19,0,33,14
1739698616588,MATH 10A,A05,848517,Briones; Jor-el Thomas Caparas,30,0,33,3
1739698616588,MATH 10A,A06,848518,Briones; Jor-el Thomas Caparas,33,0,33,0
1739698616588,MATH 10A,B01,848521,Bach; Quang Tran,30,0,31,1
1739698616588,MATH 10A,B02,848523,Bach; Quang Tran,31,0,32,1
1739698616588,MATH 10A,B03,848542,Bach; Quang Tran,33,0,33,0
1739698616588,MATH 10A,B04,848543,Bach; Quang Tran,33,0,33,0
1739698616588,MATH 10A,B05,848544,Bach; Quang Tran,28,0,33,5
1739698616588,MATH 10A,B06,848545,Bach; Quang Tran,33,0,33,0
1739698617626,MATH 10B,A01,848547,Zhao; Yizhen,33,0,33,0
1739698617626,MATH 10B,A02,848548,Zhao; Yizhen,33,0,33,0
1739698617626,MATH 10B,A03,848557,Zhao; Yizhen,32,0,33,1
1739698617626,MATH 10B,A04,848558,Zhao; Yizhen,32,0,33,1
1739698617626,MATH 10B,B01,848583,Zhao; Yizhen,55,0,60,5
1739698617626,MATH 10B,B02,848585,Zhao; Yizhen,59,0,60,1
1739698617626,MATH 10B,B03,848586,Zhao; Yizhen,31,0,33,2
1739698617626,MATH 10B,B04,848588,Zhao; Yizhen,32,0,33,1
1739698617626,MATH 10B,C01,848591,Ophir; Amit,30,0,30,0
1739698617626,MATH 10B,C02,848592,Ophir; Amit,29,0,30,1
1739698617626,MATH 10B,C03,848593,Ophir; Amit,30,0,30,0
1739698617626,MATH 10B,C04,848595,Ophir; Amit,30,0,30,0
1739698617626,MATH 10B,D01,848651,Buzaglo; Lucas,8,0,30,22
1739698617626,MATH 10B,D02,848653,Buzaglo; Lucas,26,0,32,6
1739698617626,MATH 10B,D03,848672,Buzaglo; Lucas,31,0,33,2
1739698617626,MATH 10B,D04,848691,Buzaglo; Lucas,33,0,33,0
1739698617626,MATH 10B,D05,848700,Buzaglo; Lucas,28,0,33,5
1739698617626,MATH 10B,D06,848702,Buzaglo; Lucas,27,0,33,6
1739698618657,MATH 10C,A01,848704,Ho; Ching Wei,12,0,27,15
1739698618657,MATH 10C,A02,848706,Ho; Ching Wei,28,0,33,5
1739698618657,MATH 10C,A03,848708,Ho; Ching Wei,29,0,33,4
1739698618657,MATH 10C,A04,848709,Ho; Ching Wei,33,0,33,0
1739698618657,MATH 10C,A05,848711,Ho; Ching Wei,32,0,33,1
1739698618657,MATH 10C,A06,848712,Ho; Ching Wei,32,0,33,1
1739698618657,MATH 10C,B01,848716,Staff,28,0,35,7
1739698618657,MATH 10C,B02,848766,Staff,33,0,35,2
1739698618657,MATH 10C,B03,848767,Staff,33,0,35,2
1739698618657,MATH 10C,B04,848772,Staff,35,0,35,0
1739698618657,MATH 10C,C01,848775,Cheng; Hsiao-Bing,28,0,35,7
1739698618657,MATH 10C,C02,848779,Cheng; Hsiao-Bing,35,0,35,0
1739698618657,MATH 10C,C03,848780,Cheng; Hsiao-Bing,35,0,35,0
1739698618657,MATH 10C,C04,848781,Cheng; Hsiao-Bing,35,0,35,0
1739698619689,MATH 11,A01,848784,Peca-Medlin; John Michael,18,0,28,10
1739698619689,MATH 11,A02,848786,Peca-Medlin; John Michael,28,0,33,5
1739698619689,MATH 11,A03,848788,Peca-Medlin; John Michael,33,0,33,0
1739698619689,MATH 11,A04,848791,Peca-Medlin; John Michael,33,0,33,0
1739698619689,MATH 11,A05,848793,Peca-Medlin; John Michael,55,0,55,0
1739698619689,MATH 11,A06,848794,Peca-Medlin; John Michael,55,0,55,0
1739698619689,MATH 11,B01,848798,Peca-Medlin; John Michael,54,0,55,1
1739698619689,MATH 11,B02,848799,Peca-Medlin; John Michael,55,0,55,0
1739698619689,MATH 11,B03,848800,Peca-Medlin; John Michael,26,0,33,7
1739698619689,MATH 11,B04,848801,Peca-Medlin; John Michael,31,0,33,2
1739698619689,MATH 11,B05,848843,Peca-Medlin; John Michael,33,0,33,0
1739698619689,MATH 11,B06,848844,Peca-Medlin; John Michael,33,0,33,0
1739698620721,MATH 18,A01,848854,Hiatt; Patrick John,32,0,35,3
1739698620721,MATH 18,A02,848859,Hiatt; Patrick John,35,0,35,0
1739698620721,MATH 18,A03,848860,Hiatt; Patrick John,34,0,35,1
1739698620721,MATH 18,A04,848861,Hiatt; Patrick John,35,0,35,0
1739698620721,MATH 18,A05,872522,Hiatt; Patrick John,33,0,35,2
1739698620721,MATH 18,A06,872523,Hiatt; Patrick John,35,0,35,0
1739698620721,MATH 18,B01,848869,Anzaldo; Leesa B,35,0,40,5
1739698620721,MATH 18,B02,848873,Anzaldo; Leesa B,20,0,35,15
1739698620721,MATH 18,B03,848877,Anzaldo; Leesa B,37,0,40,3
1739698620721,MATH 18,B04,848880,Anzaldo; Leesa B,38,0,40,2
1739698620721,MATH 18,B05,848882,Anzaldo; Leesa B,40,0,40,0
1739698620721,MATH 18,B06,848883,Anzaldo; Leesa B,35,0,40,5
1739698620721,MATH 18,B07,848884,Anzaldo; Leesa B,38,0,40,2
1739698620721,MATH 18,B08,848924,Anzaldo; Leesa B,38,0,40,2
1739698620721,MATH 18,C01,849043,Hiatt; Patrick John,34,0,35,1
1739698620721,MATH 18,C02,849044,Hiatt; Patrick John,35,0,35,0
1739698620721,MATH 18,C03,849045,Hiatt; Patrick John,35,0,35,0
1739698620721,MATH 18,C04,849047,Hiatt; Patrick John,33,0,35,2
1739698620721,MATH 18,C05,872524,Hiatt; Patrick John,34,0,35,1
1739698620721,MATH 18,C06,872525,Hiatt; Patrick John,35,0,35,0
1739698620721,MATH 18,D01,849050,Staff,35,0,35,0
1739698620721,MATH 18,D02,849053,Staff,35,0,35,0
1739698620721,MATH 18,D03,849054,Staff,35,0,35,0
1739698620721,MATH 18,D04,849055,Staff,35,0,35,0
1739698620721,MATH 18,D05,872526,Staff,34,0,35,1
1739698620721,MATH 18,D06,872528,Staff,35,0,35,0
1739698621752,MATH 20A,A01,849061,Ho; Ching Wei,28,0,32,4
1739698621752,MATH 20A,A02,849062,Ho; Ching Wei,34,0,35,1
1739698621752,MATH 20A,A03,849064,Ho; Ching Wei,35,0,35,0
1739698621752,MATH 20A,A04,849065,Ho; Ching Wei,35,0,35,0
1739698621752,MATH 20A,B01,849087,Bowers; Adam R.,28,0,35,7
1739698621752,MATH 20A,B02,849100,Bowers; Adam R.,35,0,35,0
1739698621752,MATH 20A,B03,849110,Bowers; Adam R.,34,0,35,1
1739698621752,MATH 20A,B04,849111,Bowers; Adam R.,34,0,35,1
1739698622780,MATH 20B,A01,849131,Staff,58,0,60,2
1739698622780,MATH 20B,A02,849242,Staff,60,0,60,0
1739698622780,MATH 20B,A03,849315,Staff,58,0,60,2
1739698622780,MATH 20B,A04,849319,Staff,60,0,60,0
1739698622780,MATH 20B,B01,849438,Xu; Fengmin,60,0,60,0
1739698622780,MATH 20B,B02,849447,Xu; Fengmin,57,0,60,3
1739698622780,MATH 20B,B03,849463,Xu; Fengmin,15,0,34,19
1739698622780,MATH 20B,B04,849465,Xu; Fengmin,36,0,37,1
1739698623811,MATH 20C,A01,849482,Shakeel; Asif,27,0,32,5
1739698623811,MATH 20C,A02,849484,Shakeel; Asif,31,0,32,1
1739698623811,MATH 20C,A03,849485,Shakeel; Asif,32,0,32,0
1739698623811,MATH 20C,A04,849511,Shakeel; Asif,32,0,32,0
1739698623811,MATH 20C,A05,849512,Shakeel; Asif,32,0,32,0
1739698623811,MATH 20C,A06,849513,Shakeel; Asif,32,0,32,0
1739698623811,MATH 20C,B01,849515,Yin; Wei,28,0,40,12
1739698623811,MATH 20C,B02,849516,Yin; Wei,41,0,45,4
1739698623811,MATH 20C,B03,849628,Yin; Wei,45,0,45,0
1739698623811,MATH 20C,B04,849636,Yin; Wei,43,0,45,2
1739698623811,MATH 20C,C01,849642,Ohm; Ko Woon,51,0,60,9
1739698623811,MATH 20C,C02,849654,Ohm; Ko Woon,60,0,60,0
1739698623811,MATH 20C,C03,849655,Ohm; Ko Woon,59,0,60,1
1739698623811,MATH 20C,C04,849663,Ohm; Ko Woon,60,0,60,0
1739698623811,MATH 20C,D01,849673,Yin; Wei,43,0,45,2
1739698623811,MATH 20C,D02,849677,Yin; Wei,43,0,45,2
1739698623811,MATH 20C,D03,849683,Yin; Wei,45,0,45,0
1739698623811,MATH 20C,D04,849686,Yin; Wei,45,0,45,0
1739698624838,MATH 20D,A01,849688,Hammock; Frances H,22,0,27,5
1739698624838,MATH 20D,A02,849695,Hammock; Frances H,32,0,32,0
1739698624838,MATH 20D,A03,849697,Hammock; Frances H,32,0,32,0
1739698624838,MATH 20D,A04,849734,Hammock; Frances H,31,0,32,1
1739698624838,MATH 20D,A05,849735,Hammock; Frances H,30,0,32,2
1739698624838,MATH 20D,A06,849736,Hammock; Frances H,32,0,32,0
1739698624838,MATH 20D,B01,849829,Hammock; Frances H,34,0,45,11
1739698624838,MATH 20D,B02,849852,Hammock; Frances H,45,0,45,0
1739698624838,MATH 20D,B03,849853,Hammock; Frances H,44,0,45,1
1739698624838,MATH 20D,B04,849857,Hammock; Frances H,45,0,45,0
1739698624838,MATH 20D,C01,849867,Staff,57,0,60,3
1739698624838,MATH 20D,C02,849888,Staff,59,0,60,1
1739698625875,MATH 20E,A01,850038,Sanchez; Anthony,20,0,31,11
1739698625875,MATH 20E,A02,850039,Sanchez; Anthony,33,0,35,2
1739698625875,MATH 20E,A03,850040,Sanchez; Anthony,34,0,35,1
1739698625875,MATH 20E,A04,850041,Sanchez; Anthony,35,0,35,0
1739698625875,MATH 20E,B01,850054,Sheng; Hongyi,27,0,35,8
1739698625875,MATH 20E,B02,850058,Sheng; Hongyi,34,0,35,1
1739698625875,MATH 20E,B03,850060,Sheng; Hongyi,35,0,35,0
1739698625875,MATH 20E,B04,850063,Sheng; Hongyi,35,0,35,0
1739698625875,MATH 20E,B05,872529,Sheng; Hongyi,35,0,35,0
1739698625875,MATH 20E,B06,872530,Sheng; Hongyi,35,0,35,0
1739698625875,MATH 20E,C01,850068,Sheng; Hongyi,29,0,30,1
1739698625875,MATH 20E,C02,850069,Sheng; Hongyi,30,0,30,0
1739698625875,MATH 20E,C03,850072,Sheng; Hongyi,29,0,30,1
1739698625875,MATH 20E,C04,850075,Sheng; Hongyi,29,0,30,1
1739698625875,MATH 20E,C05,850080,Sheng; Hongyi,30,0,30,0
1739698625875,MATH 20E,C06,850083,Sheng; Hongyi,30,0,30,0
1739698626904,MATH 31CH,A01,850090,De Vleming; Kristin Elizab,40,0,40,0
1739698627928,MATH 87,A00,872926,Bowers; Adam R.,20,0,20,0
1739698627928,MATH 87,B00,872927,Bowers; Adam R.,20,0,20,0
1739698628957,MATH 95,A00,850094,Stevens; Laura Jeanne,34,0,35,1
1739698629990,MATH 100B,A01,847038,Aycock; Jon Merrill,33,0,34,1
1739698629990,MATH 100B,A02,847048,Aycock; Jon Merrill,33,0,34,1
1739698631017,MATH 100C,A01,847050,Sorensen; Claus M,30,0,34,4
1739698631017,MATH 100C,A02,847051,Sorensen; Claus M,32,0,34,2
1739698632049,MATH 102,A01,847053,Aliabadi Sr.; Mohsen,25,0,30,5
1739698632049,MATH 102,A02,847101,Aliabadi Sr.; Mohsen,30,0,30,0
1739698632049,MATH 102,A03,847103,Aliabadi Sr.; Mohsen,28,0,30,2
1739698632049,MATH 102,A04,847106,Aliabadi Sr.; Mohsen,30,0,30,0
1739698632049,MATH 102,B01,847119,Aliabadi Sr.; Mohsen,27,0,30,3
1739698632049,MATH 102,B02,847120,Aliabadi Sr.; Mohsen,29,0,30,1
1739698632049,MATH 102,B03,847121,Aliabadi Sr.; Mohsen,29,0,30,1
1739698632049,MATH 102,B04,847123,Aliabadi Sr.; Mohsen,30,0,30,0
1739698633079,MATH 103B,A01,847125,Mohammadi; Amir,34,0,35,1
1739698633079,MATH 103B,A02,847126,Mohammadi; Amir,35,0,35,0
1739698633079,MATH 103B,B01,847128,Wenzl; Hans G,33,0,35,2
1739698633079,MATH 103B,B02,847129,Wenzl; Hans G,35,0,35,0
1739698633079,MATH 103B,C01,847131,Wenzl; Hans G,31,0,35,4
1739698633079,MATH 103B,C02,847132,Wenzl; Hans G,33,0,35,2
1739698634107,MATH 109,A01,847134,Ganesan; Priyanga,10,0,10,0
1739698634107,MATH 109,A02,847135,Ganesan; Priyanga,9,0,10,1
1739698634107,MATH 109,B01,847137,Ganesan; Priyanga,7,0,10,3
1739698634107,MATH 109,B02,847138,Ganesan; Priyanga,9,0,10,1
1739698634107,MATH 109,C01,847140,Upadrashta; Pranav Kumar,7,0,10,3
1739698634107,MATH 109,C02,847141,Upadrashta; Pranav Kumar,10,0,10,0
1739698634107,MATH 109,D01,847143,Sarkar; Pratyush,9,0,10,1
1739698634107,MATH 109,D02,847144,Sarkar; Pratyush,10,0,10,0
1739698634107,MATH 109,E01,847146,Sarkar; Pratyush,10,0,10,0
1739698634107,MATH 109,E02,847148,Sarkar; Pratyush,10,0,10,0
1739698635137,MATH 110,A01,847150,Pillai; Mohandas K,30,0,35,5
1739698635137,MATH 110,A02,847151,Pillai; Mohandas K,34,0,35,1
1739698635137,MATH 110,A03,847152,Pillai; Mohandas K,34,0,35,1
1739698636219,MATH 111A,A01,847154,Shakeel; Asif,23,0,30,7
1739698637244,MATH 112B,A01,847156,Komarova; Natalia,25,0,25,0
1739698638269,MATH 114,A01,847158,Li; Bo,21,0,30,9
1739698638269,MATH 114,A02,847159,Li; Bo,29,0,30,1
1739698639298,MATH 120B,A01,847161,Treuer; John N,32,0,35,3
1739698639298,MATH 120B,A02,847162,Treuer; John N,34,0,35,1
1739698640323,MATH 121B,A01,847164,Stevens; Laura Jeanne,33,0,35,2
1739698641350,MATH 140B,A01,847166,Lu; Yunze,35,0,35,0
1739698641350,MATH 140B,A02,847167,Lu; Yunze,34,0,35,1
1739698642375,MATH 140C,A01,847203,Zlatos; Andrej,33,0,35,2
1739698642375,MATH 140C,A02,847204,Zlatos; Andrej,34,0,35,1
1739698643407,MATH 142B,A01,847207,Parise; Davide,25,0,35,10
1739698643407,MATH 142B,A02,847208,Parise; Davide,31,0,35,4
1739698643407,MATH 142B,B01,847219,Mohammadi; Amir,33,0,35,2
1739698643407,MATH 142B,B02,847222,Mohammadi; Amir,35,0,35,0
1739698643407,MATH 142B,C01,847224,Kunnawalkam Elayavalli; Sr,34,0,35,1
1739698643407,MATH 142B,C02,847331,Kunnawalkam Elayavalli; Sr,34,0,35,1
1739698644432,MATH 146,A01,847333,Pillai; Mohandas K,35,0,35,0
1739698645464,MATH 150B,A01,847335,Chow; Bennett,33,0,35,2
1739698646497,MATH 152,A01,847337,Grier; Daniel T,32,0,50,18
1739698647530,MATH 154,A01,847340,Manners; Frederick,33,0,35,2
1739698647530,MATH 154,A02,847341,Manners; Frederick,35,0,35,0
1739698647530,MATH 154,A03,847342,Manners; Frederick,35,0,35,0
1739698647530,MATH 154,A04,847343,Manners; Frederick,35,0,35,0
1739698647530,MATH 154,B01,847345,Verstraete; Jacques Allan,30,0,35,5
1739698647530,MATH 154,B02,847346,Verstraete; Jacques Allan,35,0,35,0
1739698647530,MATH 154,B03,847347,Verstraete; Jacques Allan,34,0,35,1
1739698647530,MATH 154,B04,847348,Verstraete; Jacques Allan,33,0,35,2
1739698648556,MATH 160B,A01,847460,Manners; Frederick,34,0,35,1
1739698649584,MATH 163,A01,847462,Kunnawalkam Elayavalli; Sr,1,0,25,24
1739698650610,MATH 170A,A01,847464,Nag; Panchali,33,0,35,2
1739698650610,MATH 170A,A02,847465,Nag; Panchali,34,0,35,1
1739698650610,MATH 170A,A03,847466,Nag; Panchali,33,0,35,2
1739698650610,MATH 170A,A04,847467,Nag; Panchali,31,0,35,4
1739698651642,MATH 170B,A01,847530,Dixit; Rishabh,33,0,35,2
1739698651642,MATH 170B,A02,847531,Dixit; Rishabh,35,0,35,0
1739698651642,MATH 170B,A03,847532,Dixit; Rishabh,34,0,35,1
1739698651642,MATH 170B,A04,847533,Dixit; Rishabh,29,0,35,6
1739698652667,MATH 170C,A01,847535,Dixit; Rishabh,35,0,35,0
1739698652667,MATH 170C,A02,847536,Dixit; Rishabh,35,0,35,0
1739698652667,MATH 170C,A03,847537,Dixit; Rishabh,34,0,35,1
1739698652667,MATH 170C,A04,847538,Dixit; Rishabh,35,0,35,0
1739698653694,MATH 171B,A01,847557,Huang; Lei,32,0,35,3
1739698653694,MATH 171B,A02,847560,Huang; Lei,34,0,35,1
1739698653694,MATH 171B,A03,847596,Huang; Lei,33,0,35,2
1739698653694,MATH 171B,A04,847597,Huang; Lei,32,0,35,3
1739698654726,MATH 179,A01,847599,Cheng; Li-Tien,25,0,25,0
1739698655754,MATH 180A,A01,847601,Webber; Robert Jacobs,31,0,35,4
1739698655754,MATH 180A,A02,847602,Webber; Robert Jacobs,35,0,35,0
1739698655754,MATH 180A,A03,847603,Webber; Robert Jacobs,34,0,35,1
1739698655754,MATH 180A,A04,847604,Webber; Robert Jacobs,32,0,35,3
1739698655754,MATH 180A,B01,847606,Hardiman; Liam,35,0,35,0
1739698655754,MATH 180A,B02,847680,Hardiman; Liam,31,0,35,4
1739698655754,MATH 180A,B03,847682,Hardiman; Liam,35,0,35,0
1739698655754,MATH 180A,B04,847683,Hardiman; Liam,35,0,35,0
1739698656781,MATH 180B,A01,847686,Warnke; Lutz Peter,32,0,32,0
1739698656781,MATH 180B,A02,847688,Warnke; Lutz Peter,31,0,32,1
1739698656781,MATH 180B,A03,847689,Warnke; Lutz Peter,31,0,32,1
1739698656781,MATH 180B,A04,847691,Warnke; Lutz Peter,31,0,32,1
1739698656781,MATH 180B,A05,847693,Warnke; Lutz Peter,32,0,32,0
1739698656781,MATH 180B,A06,847694,Warnke; Lutz Peter,30,0,32,2
1739698657808,MATH 180C,A01,847701,Ang; Jie Jun,34,0,35,1
1739698657808,MATH 180C,A02,847707,Ang; Jie Jun,35,0,35,0
1739698657808,MATH 180C,A03,847708,Ang; Jie Jun,32,0,35,3
1739698657808,MATH 180C,A04,847711,Ang; Jie Jun,31,0,35,4
1739698658834,MATH 181A,A01,847753,Zhang; Danna,16,0,35,19
1739698658834,MATH 181A,A02,847756,Zhang; Danna,32,0,35,3
1739698658834,MATH 181A,A03,847757,Zhang; Danna,32,0,35,3
1739698658834,MATH 181A,A04,847758,Zhang; Danna,33,0,35,2
1739698659861,MATH 181B,A01,847760,Rava; Denise,30,0,35,5
1739698659861,MATH 181B,A02,847761,Rava; Denise,34,0,35,1
1739698659861,MATH 181B,A03,847764,Rava; Denise,35,0,35,0
1739698659861,MATH 181B,A04,847765,Rava; Denise,35,0,35,0
1739698660892,MATH 183,A01,847768,Vishwanath; Siddharth,21,0,32,11
1739698660892,MATH 183,A02,847769,Vishwanath; Siddharth,30,0,32,2
1739698660892,MATH 183,A03,847770,Vishwanath; Siddharth,31,0,32,1
1739698660892,MATH 183,A04,847772,Vishwanath; Siddharth,29,0,32,3
1739698660892,MATH 183,A05,847774,Vishwanath; Siddharth,32,0,32,0
1739698660892,MATH 183,A06,847864,Vishwanath; Siddharth,31,0,32,1
1739698661923,MATH 184,A01,847866,Wesley; William J,35,0,35,0
1739698661923,MATH 184,A02,847874,Wesley; William J,33,0,35,2
1739698661923,MATH 184,A03,847875,Wesley; William J,35,0,35,0
1739698661923,MATH 184,A04,847876,Wesley; William J,33,0,35,2
1739698662951,MATH 185,A01,847880,Rava; Denise,32,0,35,3
1739698662951,MATH 185,A02,847881,Rava; Denise,35,0,35,0
1739698663980,MATH 187A,A01,847883,Klevdal; Christian Sleek,14,0,32,18
1739698663980,MATH 187A,A02,847886,Klevdal; Christian Sleek,30,0,32,2
1739698663980,MATH 187A,A03,847892,Klevdal; Christian Sleek,27,0,32,5
1739698663980,MATH 187A,A04,847893,Klevdal; Christian Sleek,32,0,32,0
1739698663980,MATH 187A,A05,847894,Klevdal; Christian Sleek,31,0,32,1
1739698663980,MATH 187A,A06,847903,Klevdal; Christian Sleek,31,0,32,1
1739698665010,MATH 187B,A01,847905,Bucur; Alina Ioana,28,0,35,7
1739698665010,MATH 187B,A02,847906,Bucur; Alina Ioana,34,0,35,1
1739698666035,MATH 189,A01,847908,Lou; Zhipeng,0,0,10,10
1739698666035,MATH 189,A02,847909,Lou; Zhipeng,0,0,10,10
1739698666035,MATH 189,A03,847910,Lou; Zhipeng,0,0,10,10
1739698666035,MATH 189,A04,847911,Lou; Zhipeng,0,0,10,10
1739698666035,MATH 189,A05,847912,Lou; Zhipeng,0,0,10,10
1739698666035,MATH 189,A06,847917,Lou; Zhipeng,0,0,10,10
1739698667064,MATH 190B,A01,848005,McKernan; James,31,0,35,4
1739698668090,MATH 194,A01,848012,Fitzsimmons; Patrick J,12,0,32,20
1739698668090,MATH 194,A02,848080,Fitzsimmons; Patrick J,31,0,32,1
1739698668090,MATH 194,A03,848081,Fitzsimmons; Patrick J,26,0,32,6
1739698668090,MATH 194,A04,848107,Fitzsimmons; Patrick J,32,0,32,0
1739698668090,MATH 194,A05,848108,Fitzsimmons; Patrick J,31,0,32,1
1739698668090,MATH 194,A06,848147,Fitzsimmons; Patrick J,30,0,32,2
1739698669115,MATH 197,001,872928,Kedlaya; Kiran S.,9999,0,9999,0
1739698670142,MATH 200C,A00,846124,Salehi Golsefidy; Alireza,18,0,20,2
1739698671168,MATH 202C,A00,846125,Rhoades; Brendon Patrick,18,0,20,2
1739698672194,MATH 203C,A00,846128,Izadi; Elham,20,0,20,0
1739698673219,MATH 204C,A00,846131,Pollack; Aaron,20,0,20,0
1739698674245,MATH 205,A00,846132,Popescu; Cristian D.,18,0,20,2
1739698675272,MATH 208,A00,846133,Oprea; Dragos N.,10,0,10,0
1739698676299,MATH 209,A00,846173,Bucur; Alina Ioana,10,0,10,0
1739698677323,MATH 211A,A00,846174,Salehi Golsefidy; Alireza,10,0,10,0
1739698678347,MATH 211B,A00,846175,Sanchez; Anthony,9,0,10,1
1739698679373,MATH 212B,A01,846177,Komarova; Natalia,10,0,10,0
1739698680402,MATH 214,A01,846179,Li; Bo,2,0,5,3
1739698680402,MATH 214,A02,846181,Li; Bo,5,0,5,0
1739698681428,MATH 216C,A00,846182,Cloninger; Alexander,17,0,20,3
1739698682456,MATH 218,A00,846183,Komarova; Natalia,9,0,10,1
1739698683484,MATH 220C,A00,846184,Oprea; Dragos N.,20,0,20,0
1739698684512,MATH 231C,A00,846185,Li; Bo,20,0,20,0
1739698685539,MATH 240C,A00,846187,Ioana; Adrian,18,0,20,2
1739698686566,MATH 243,A00,846188,Kunnawalkam Elayavalli; Sr,9,0,10,1
1739698687591,MATH 248,A00,846189,Bejenaru; Ioan,9,0,10,1
1739698688619,MATH 250C,A00,846190,Chow; Bennett,18,0,20,2
1739698689645,MATH 258,A00,846191,Ni; Lei,10,0,10,0
1739698690670,MATH 262A,A00,846192,Suk; Andrew Hoon,17,0,20,3
1739698691698,MATH 264C,A00,846193,Rhoades; Brendon Patrick,18,0,20,2
1739698692725,MATH 269,A00,846194,Warnke; Lutz Peter,9,0,10,1
1739698693752,MATH 270C,A00,846195,Leok; Melvin,14,0,20,6
1739698694779,MATH 271C,A00,846197,Nie; Jiawang,16,0,20,4
1739698695806,MATH 272C,A00,846198,Miller; Pearson,20,0,20,0
1739698696832,MATH 276,A00,846199,Mc Culloch; Andrew Douglas,0,0,0,0
1739698697860,MATH 278A,A00,846283,Cheng; Li-Tien,10,0,10,0
1739698698885,MATH 278B,A00,846322,Cloninger; Alexander,10,0,10,0
1739698699911,MATH 278C,A00,846333,Nie; Jiawang,10,0,10,0
1739698700939,MATH 279,A01,846359,Cheng; Li-Tien,10,0,10,0
1739698701966,MATH 280C,A00,846360,Kemp; Todd Aahron,18,0,20,2
1739698702994,MATH 281C,A00,846363,Zhang; Danna,8,0,20,12
1739698704024,MATH 285,A00,846378,Schweinsberg; Jason,7,0,20,13
1739698705052,MATH 288,A00,846382,Ang; Jie Jun,9,0,10,1
1739698706080,MATH 289A,A00,846386,Novak; Jonathan I,15,0,20,5
1739698706080,MATH 289A,B00,846413,Lou; Zhipeng,13,0,20,7
1739698706080,MATH 289A,C00,876133,Xu; Ronghui,2,0,10,8
1739698707109,MATH 290C,A00,846451,Roberts; Justin Deritter,18,0,20,2
1739698708134,MATH 292,A00,846481,Lu; Yunze,9,0,10,1
1739698709163,MATH 295,A00,846486,Bejenaru; Ioan,50,0,50,0
1739698710190,MATH 296,A00,846492,Warnke; Lutz Peter,20,0,20,0
1739698711217,MATH 297,001,889670,Gamst; Anthony Collins,0,0,0,0
1739698712247,MATS 200,A00,825196,Graeve; Olivia A,9988,0,9999,11
1739698713272,MATS 201B,A00,825197,Garay; Javier,44,0,55,11
1739698714297,MATS 205A,A00,825200,Meyers; Marc,15,0,20,5
1739698715326,MATS 252,A00,825203,Evdokimenko; Ekaterina,16,0,30,14
1739698716352,MATS 256,A00,825204,Chen; Renkun,24,0,30,6
1739698717379,MATS 261B,A00,825205,Qiao; Yu,20,0,25,5
1739698718405,MBC 296,001,887235,Staff,9999,0,9999,0
1739698719431,MCWP 40,001,858225,Wastal; Carrie King,14,0,15,1
1739698719431,MCWP 40,003,858230,Wastal; Carrie King,12,0,15,3
1739698719431,MCWP 40,004,858231,Wastal; Carrie King,13,0,15,2
1739698719431,MCWP 40,006,858235,Montejo; Carolina,20,0,20,0
1739698719431,MCWP 40,007,858240,Wastal; Carrie King,15,0,15,0
1739698719431,MCWP 40,008,858241,Wastal; Carrie King,11,0,15,4
1739698720464,MCWP 50,001,826425,Bartulis; Jason Michael,19,0,20,1
1739698720464,MCWP 50,002,826426,Bartulis; Jason Michael,19,0,20,1
1739698720464,MCWP 50,003,826427,Bartulis; Jason Michael,20,0,20,0
1739698720464,MCWP 50,004,826429,Compas; Sean Matthew,17,0,20,3
1739698720464,MCWP 50,005,826431,Compas; Sean Matthew,20,0,20,0
1739698720464,MCWP 50,006,826432,Krone; Jarret,19,0,20,1
1739698720464,MCWP 50,007,826433,Krone; Jarret,19,0,20,1
1739698720464,MCWP 50,008,826434,Redela; Pamela Morgan,20,0,20,0
1739698720464,MCWP 50,009,826435,Redela; Pamela Morgan,20,0,20,0
1739698720464,MCWP 50,010,826436,Carter; Andrea L,17,0,20,3
1739698720464,MCWP 50,011,826437,Carter; Andrea L,20,0,20,0
1739698720464,MCWP 50,012,826439,Nies; Laurie Elizabeth,20,0,20,0
1739698720464,MCWP 50,013,826474,Nies; Laurie Elizabeth,19,0,20,1
1739698720464,MCWP 50,014,826483,Duru; Nur,17,0,20,3
1739698720464,MCWP 50,015,826484,Duru; Nur,20,0,20,0
1739698720464,MCWP 50,016,826486,Silva; Kelly B,20,0,20,0
1739698720464,MCWP 50,017,826488,Silva; Kelly B,20,0,20,0
1739698720464,MCWP 50,018,826489,Silva; Kelly B,20,0,20,0
1739698720464,MCWP 50,019,826490,Carter; Jennifer A,20,0,20,0
1739698720464,MCWP 50,020,826491,Carter; Jennifer A,20,0,20,0
1739698720464,MCWP 50,021,826492,Smith; Haydee Marie,20,0,20,0
1739698720464,MCWP 50,022,826493,Smith; Haydee Marie,19,0,20,1
1739698720464,MCWP 50,023,826543,Morshed; Michael James,16,0,20,4
1739698720464,MCWP 50,024,826579,Morshed; Michael James,16,0,20,4
1739698720464,MCWP 50,025,826582,Pham; Vincent Minhduc,20,0,20,0
1739698720464,MCWP 50,026,826609,Pham; Vincent Minhduc,20,0,20,0
1739698721492,MCWP 50R,A00,826669,Miller; Elizabeth Deen,17,0,20,3
1739698721492,MCWP 50R,B00,826714,Miller; Elizabeth Deen,19,0,20,1
1739698722519,MCWP 125,A00,826719,Guillen; Melinda,20,0,20,0
1739698722519,MCWP 125,B00,826720,Guillen; Melinda,18,0,20,2
1739698722519,MCWP 125,C00,826721,Guillen; Melinda,15,0,20,5
1739698723545,MED 225,A00,872558,Esko; Jeffrey D.,6,0,6,0
1739698724582,MED 246,A00,872562,Gordts; Philip & Lewis; Amanda Lark & Godula; Kamil & Gagneux; Pascal & Esko; Jeffrey D. & Bode; Lars,10,0,10,0
1739698725606,MED 262,A00,883267,Singh; Karandeep,31,0,35,4
1739698726635,MED 265,A00,884437,El-Kareh; Robert E & Sitapati; Amy,27,0,30,3
1739698727662,MED 267,A01,883697,Hogarth; Michael Andrew,23,0,30,7
1739698728693,MED 275,A00,872551,Liu; George Yenhsi,7,0,10,3
1739698729720,MED 278,A00,884420,Carter; Hannah Kathryn & Mesirov; Jill P. & Curtius; Kathleen Mary,14,0,16,2
1739698730745,MED 296,001,866575,Chi; Neil C.,4,0,5,1
1739698730745,MED 296,002,866576,Castellanos; Luis R.,4,0,5,1
1739698730745,MED 296,003,866585,Jeong; Ah-Reum,4,0,5,1
1739698730745,MED 296,004,866590,Staff,5,0,5,0
1739698730745,MED 296,005,866627,Staff,5,0,5,0
1739698731773,MGT 3,A00,839898,Wagner; Timothy Ryan,96,0,98,2
1739698732798,MGT 4,A01,839906,Levkoff; Steven B.,5,0,6,1
1739698732798,MGT 4,A02,839911,Levkoff; Steven B.,5,0,6,1
1739698732798,MGT 4,A03,839913,Levkoff; Steven B.,5,0,6,1
1739698732798,MGT 4,B01,839919,Brooks; Marcus Raymond,30,0,32,2
1739698733823,MGT 5,A00,839921,Molloie Jr.; William H,184,0,186,2
1739698734850,MGT 12,A00,839922,Lindenberger; Wade Douglas,88,0,98,10
1739698734850,MGT 12,B00,839926,Lindenberger; Wade Douglas,75,0,100,25
1739698734850,MGT 12,C00,840027,Pecore; Joseph P.,87,0,100,13
1739698735884,MGT 16,A00,840029,Buchanan; Harold G,95,0,100,5
1739698735884,MGT 16,B00,840031,Buchanan; Harold G,95,0,100,5
1739698735884,MGT 16,C00,840033,Campbell; Robert Harold,119,0,120,1
1739698735884,MGT 16,D00,840034,Campbell; Robert Harold,118,0,120,2
1739698735884,MGT 16,E00,840049,Demill; Burritt,98,0,98,0
1739698735884,MGT 16,F00,840056,Demill; Burritt,97,0,98,1
1739698736912,MGT 18,A00,840060,McKay; Michael J,97,0,98,1
1739698736912,MGT 18,B00,840063,McKay; Michael J,96,0,98,2
1739698736912,MGT 18,C00,840074,McKay; Michael J,94,0,98,4
1739698736912,MGT 18,D00,840076,Chamberlain; Travis Dean,98,0,98,0
1739698737938,MGT 45,A00,840097,Pecore; Joseph P.,128,0,150,22
1739698737938,MGT 45,B00,840098,Pecore; Joseph P.,141,0,150,9
1739698738963,MGT 71,A00,840099,Park; Kun Soo,94,0,98,4
1739698740048,MGT 71R,A00,840101,Phiroz; Zal Navroze,117,0,150,33
1739698741078,MGT 100,A00,840102,Wilbur; Kenneth C,79,0,98,19
1739698741078,MGT 100,B00,840103,Wilbur; Kenneth C,87,0,98,11
1739698741078,MGT 100,C00,840104,Wilbur; Kenneth C,95,0,98,3
1739698742110,MGT 103,A00,840105,Bates; Kenneth Walter,93,0,98,5
1739698742110,MGT 103,B00,840106,Demill; Burritt,97,0,98,1
1739698742110,MGT 103,C00,840107,Eberhard; Craig A,98,0,98,0
1739698742110,MGT 103,D00,840225,Eberhard; Craig A,97,0,98,1
1739698742110,MGT 103,E00,840226,Ehrich; Kristine R,93,0,98,5
1739698742110,MGT 103,F00,840227,Ehrich; Kristine R,95,0,98,3
1739698742110,MGT 103,G00,840228,Ehrich; Kristine R,96,0,98,2
1739698743138,MGT 105,A00,840229,Bates; Kenneth Walter,87,0,98,11
1739698744165,MGT 106,A00,840230,Eberhard; Craig A,96,0,98,2
1739698745196,MGT 107,A00,881472,Yorkston; Eric A,94,0,98,4
1739698746222,MGT 109,A00,840231,Jasko; Katarzyna Beata,85,0,98,13
1739698746222,MGT 109,B00,840232,Liu; Wei,87,0,98,11
1739698747249,MGT 112,A00,840233,Somasundaram; Tyagarajan,91,0,98,7
1739698747249,MGT 112,B00,840234,Somasundaram; Tyagarajan,76,0,98,22
1739698748297,MGT 119,A00,840235,Anderson; Jon Marcus,140,0,140,0
1739698748297,MGT 119,B00,840236,Davis; Kathleen Ann,98,0,98,0
1739698748297,MGT 119,C00,840237,Mc Kenzie; Craig R.M.,97,0,98,1
1739698748297,MGT 119,D00,840238,Etingue Kum; Menes,40,0,40,0
1739698749324,MGT 121B,A00,840239,Klaas; Jeffrey David,91,0,98,7
1739698750353,MGT 128R,A00,840240,Krishnan; Viswanathan,83,0,98,15
1739698751382,MGT 131A,A00,840242,Houskeeper; Robert,147,0,150,3
1739698752411,MGT 131B,A00,840243,Houskeeper; Robert,98,0,98,0
1739698753435,MGT 132,A00,840244,Blakley; Bruce,95,0,98,3
1739698754460,MGT 137,A00,840245,Lindenberger; Wade Douglas,84,0,98,14
1739698755487,MGT 146,A00,881478,Brooks; Marcus Raymond,97,0,98,1
1739698756513,MGT 147,A00,840246,Anderson; John Charles,74,0,75,1
1739698757543,MGT 151R,A00,840253,Phiroz; Zal Navroze,84,0,98,14
1739698758568,MGT 153,A00,840254,Perols; Johan Lars,67,0,90,23
1739698759596,MGT 155,A00,881481,Shin; Hyo Duk,95,0,98,3
1739698760624,MGT 160,A00,840265,Johnson; Erik Barry,90,0,90,0
1739698760624,MGT 160,B00,840266,Staff,87,0,90,3
1739698760624,MGT 160,C00,840267,Staff,82,0,90,8
1739698761649,MGT 162,A00,840269,Levin; Joel,93,0,98,5
1739698761649,MGT 162,B00,840270,Levin; Joel,98,0,98,0
1739698762675,MGT 162R,A00,840271,Gneezy; Uri,173,0,199,26
1739698763703,MGT 164,A00,840272,McKay; Mary A,98,0,98,0
1739698763703,MGT 164,B00,840273,McKay; Mary A,97,0,98,1
1739698763703,MGT 164,C00,840274,McKay; Mary A,97,0,98,1
1739698763703,MGT 164,D00,840275,Meyer; Alison Bloomfield,92,0,98,6
1739698764734,MGT 166,A00,840365,Moran; Cathleen L.,98,0,98,0
1739698764734,MGT 166,B00,840429,Moran; Cathleen L.,96,0,98,2
1739698764734,MGT 166,C00,840430,Moran; Cathleen L.,97,0,98,1
1739698765761,MGT 167,A00,840431,Klaas; Jeffrey David,96,0,98,2
1739698766786,MGT 171R,A00,840478,Phiroz; Zal Navroze,74,0,98,24
1739698767812,MGT 172,A00,840536,Hedges; Kathleen & Royal; Rebecca,114,0,120,6
1739698767812,MGT 172,B00,840580,Hedges; Kathleen,92,0,98,6
1739698767812,MGT 172,C00,840581,Zimmermann; Carsten,96,0,98,2
1739698767812,MGT 172,D00,881483,Zimmermann; Carsten,97,0,98,1
1739698768838,MGT 173,A00,840604,Hayes; Sherry Lorine,91,0,98,7
1739698769866,MGT 175,A00,840636,Gopal; Christopher S.,94,0,98,4
1739698770893,MGT 180,A00,840641,Bliss; Barbara Ann,145,0,150,5
1739698770893,MGT 180,B00,840642,Bliss; Barbara Ann,143,0,150,7
1739698771922,MGT 181,A00,840643,Buchanan; Harold G,117,0,120,3
1739698772951,MGT 184,A00,886143,Parashar; Sat P,89,0,98,9
1739698773974,MGT 185,A00,840648,Dunn; Louis Jean,88,0,98,10
1739698775004,MGT 187,A00,840649,Dunn; Louis Jean,68,0,75,7
1739698776032,MGT 189,A00,840650,Avenancio-Leon; Carlos,89,0,98,9
1739698777057,MGT 255,A00,840651,Rottenstreich; Yuval S,15,0,20,5
1739698778083,MGT 259,A00,872537,Staff,16,0,20,4
1739698779108,MGT 285,A00,840652,Liu; Jun,20,0,20,0
1739698780137,MGT 296,001,870424,Gneezy; Ayelet,3,0,3,0
1739698780137,MGT 296,002,870453,Amir; On,3,0,3,0
1739698780137,MGT 296,003,870454,Amir; On & Karmarkar; Uma R,3,0,3,0
1739698780137,MGT 296,004,870455,Liu; Jun,2,0,3,1
1739698780137,MGT 296,005,870456,Hansen; Karsten T.,3,0,3,0
1739698780137,MGT 296,006,870471,Erat; Sanjiv,3,0,3,0
1739698780137,MGT 296,007,870472,Timmermann; Allan,3,0,3,0
1739698780137,MGT 296,008,870501,Smith; Pamela Karen,3,0,3,0
1739698780137,MGT 296,009,870502,Zhang; Zhe,3,0,3,0
1739698780137,MGT 296,010,870508,Oveis; Christopher S,3,0,3,0
1739698780137,MGT 296,011,870523,Amir; On & Gneezy; Ayelet,2,0,3,1
1739698780137,MGT 296,012,870537,Luo; Danqi,3,0,3,0
1739698781195,MMW 13,A01,823232,Chang; Edmond Yi-Teh,16,0,16,0
1739698781195,MMW 13,A02,823239,Chang; Edmond Yi-Teh,16,0,16,0
1739698781195,MMW 13,A03,823242,Chang; Edmond Yi-Teh,16,0,16,0
1739698781195,MMW 13,A04,823251,Chang; Edmond Yi-Teh,16,0,16,0
1739698781195,MMW 13,A05,823252,Chang; Edmond Yi-Teh,16,0,16,0
1739698781195,MMW 13,A06,823253,Chang; Edmond Yi-Teh,15,0,16,1
1739698781195,MMW 13,A07,823255,Chang; Edmond Yi-Teh,16,0,16,0
1739698781195,MMW 13,A08,823257,Chang; Edmond Yi-Teh,16,0,16,0
1739698781195,MMW 13,A09,823263,Chang; Edmond Yi-Teh,16,0,16,0
1739698781195,MMW 13,A10,823291,Chang; Edmond Yi-Teh,16,0,16,0
1739698781195,MMW 13,A11,823292,Chang; Edmond Yi-Teh,16,0,16,0
1739698781195,MMW 13,A12,823293,Chang; Edmond Yi-Teh,16,0,16,0
1739698781195,MMW 13,A13,823370,Chang; Edmond Yi-Teh,0,0,0,0
1739698781195,MMW 13,A14,823480,Chang; Edmond Yi-Teh,0,0,0,0
1739698781195,MMW 13,A15,823481,Chang; Edmond Yi-Teh,16,0,16,0
1739698781195,MMW 13,A16,823482,Chang; Edmond Yi-Teh,15,0,16,1
1739698781195,MMW 13,A17,823483,Chang; Edmond Yi-Teh,16,0,16,0
1739698781195,MMW 13,A18,823484,Chang; Edmond Yi-Teh,16,0,16,0
1739698781195,MMW 13,A19,823485,Chang; Edmond Yi-Teh,0,0,0,0
1739698781195,MMW 13,A20,823486,Chang; Edmond Yi-Teh,0,0,0,0
1739698781195,MMW 13,B01,823488,Zhiri; Oumelbanine,15,0,16,1
1739698781195,MMW 13,B02,823490,Zhiri; Oumelbanine,15,0,16,1
1739698781195,MMW 13,B03,823491,Zhiri; Oumelbanine,14,0,16,2
1739698781195,MMW 13,B04,823492,Zhiri; Oumelbanine,15,0,16,1
1739698781195,MMW 13,B05,823493,Zhiri; Oumelbanine,16,0,16,0
1739698781195,MMW 13,B06,823494,Zhiri; Oumelbanine,13,0,16,3
1739698781195,MMW 13,B07,823495,Zhiri; Oumelbanine,15,0,16,1
1739698781195,MMW 13,B08,823496,Zhiri; Oumelbanine,15,0,16,1
1739698781195,MMW 13,B09,823522,Zhiri; Oumelbanine,16,0,16,0
1739698781195,MMW 13,B10,823528,Zhiri; Oumelbanine,16,0,16,0
1739698781195,MMW 13,B11,823604,Zhiri; Oumelbanine,16,0,16,0
1739698781195,MMW 13,B12,823613,Zhiri; Oumelbanine,16,0,16,0
1739698781195,MMW 13,B13,823624,Zhiri; Oumelbanine,16,0,16,0
1739698781195,MMW 13,B14,823627,Zhiri; Oumelbanine,15,0,16,1
1739698781195,MMW 13,B15,823631,Zhiri; Oumelbanine,16,0,16,0
1739698781195,MMW 13,B16,823642,Zhiri; Oumelbanine,15,0,16,1
1739698781195,MMW 13,C01,823773,Murillo; Dana V.,16,0,16,0
1739698781195,MMW 13,C02,823774,Murillo; Dana V.,16,0,16,0
1739698781195,MMW 13,C03,823793,Murillo; Dana V.,16,0,16,0
1739698781195,MMW 13,C04,823794,Murillo; Dana V.,16,0,16,0
1739698781195,MMW 13,C05,823801,Murillo; Dana V.,16,0,16,0
1739698781195,MMW 13,C06,823856,Murillo; Dana V.,16,0,16,0
1739698781195,MMW 13,C07,823876,Murillo; Dana V.,16,0,16,0
1739698781195,MMW 13,C08,823878,Murillo; Dana V.,16,0,16,0
1739698781195,MMW 13,C09,823956,Murillo; Dana V.,0,0,0,0
1739698781195,MMW 13,C10,823978,Murillo; Dana V.,0,0,0,0
1739698781195,MMW 13,C11,824009,Murillo; Dana V.,0,0,0,0
1739698781195,MMW 13,C12,824022,Murillo; Dana V.,0,0,0,0
1739698781195,MMW 13,C13,824023,Murillo; Dana V.,16,0,16,0
1739698781195,MMW 13,C14,824027,Murillo; Dana V.,15,0,16,1
1739698781195,MMW 13,C15,824029,Murillo; Dana V.,0,0,0,0
1739698781195,MMW 13,C16,824036,Murillo; Dana V.,0,0,0,0
1739698781195,MMW 13,D01,824044,Vitkus; Daniel J.,16,0,16,0
1739698781195,MMW 13,D02,824045,Vitkus; Daniel J.,16,0,16,0
1739698781195,MMW 13,D03,824050,Vitkus; Daniel J.,16,0,16,0
1739698781195,MMW 13,D04,824066,Vitkus; Daniel J.,16,0,16,0
1739698781195,MMW 13,D05,824070,Vitkus; Daniel J.,16,0,16,0
1739698781195,MMW 13,D06,824080,Vitkus; Daniel J.,16,0,16,0
1739698781195,MMW 13,D07,824081,Vitkus; Daniel J.,16,0,16,0
1739698781195,MMW 13,D08,824092,Vitkus; Daniel J.,16,0,16,0
1739698781195,MMW 13,D09,824112,Vitkus; Daniel J.,0,0,0,0
1739698781195,MMW 13,D10,824248,Vitkus; Daniel J.,0,0,0,0
1739698781195,MMW 13,D11,824303,Vitkus; Daniel J.,0,0,0,0
1739698781195,MMW 13,D12,824311,Vitkus; Daniel J.,0,0,0,0
1739698781195,MMW 13,D13,824312,Vitkus; Daniel J.,16,0,16,0
1739698781195,MMW 13,D14,824317,Vitkus; Daniel J.,16,0,16,0
1739698781195,MMW 13,D15,824377,Vitkus; Daniel J.,0,0,0,0
1739698781195,MMW 13,D16,824378,Vitkus; Daniel J.,0,0,0,0
1739698782231,MMW 15,A01,824426,Chang; Edmond Yi-Teh,27,0,28,1
1739698782231,MMW 15,A02,824586,Chang; Edmond Yi-Teh,26,0,28,2
1739698782231,MMW 15,A03,824617,Chang; Edmond Yi-Teh,24,0,28,4
1739698782231,MMW 15,A04,824641,Chang; Edmond Yi-Teh,26,0,28,2
1739698782231,MMW 15,A05,824653,Chang; Edmond Yi-Teh,25,0,28,3
1739698782231,MMW 15,A06,824689,Chang; Edmond Yi-Teh,28,0,28,0
1739698782231,MMW 15,A07,824735,Chang; Edmond Yi-Teh,28,0,28,0
1739698782231,MMW 15,A08,824804,Chang; Edmond Yi-Teh,27,0,28,1
1739698782231,MMW 15,A09,824805,Chang; Edmond Yi-Teh,0,0,0,0
1739698782231,MMW 15,A10,824963,Chang; Edmond Yi-Teh,0,0,0,0
1739698782231,MMW 15,B01,824999,Peterson; Johanna L,0,0,0,0
1739698782231,MMW 15,B02,825015,Peterson; Johanna L,0,0,0,0
1739698782231,MMW 15,B03,825050,Peterson; Johanna L,18,0,28,10
1739698782231,MMW 15,B04,825079,Peterson; Johanna L,24,0,28,4
1739698782231,MMW 15,B05,825109,Peterson; Johanna L,27,0,28,1
1739698782231,MMW 15,B06,825114,Peterson; Johanna L,24,0,28,4
1739698782231,MMW 15,B07,825151,Peterson; Johanna L,23,0,28,5
1739698782231,MMW 15,B08,825183,Peterson; Johanna L,19,0,28,9
1739698782231,MMW 15,B09,825190,Peterson; Johanna L,28,0,28,0
1739698782231,MMW 15,B10,825191,Peterson; Johanna L,26,0,28,2
1739698782231,MMW 15,B11,825192,Peterson; Johanna L,0,0,0,0
1739698782231,MMW 15,B12,825193,Peterson; Johanna L,0,0,0,0
1739698783258,MSED 295,A00,825207,Staff,5,0,5,0
1739698784285,MUS 1C,A01,826943,Staff,24,0,25,1
1739698784285,MUS 1C,A02,826944,Staff,23,0,25,2
1739698784285,MUS 1C,A03,826945,Staff,25,0,25,0
1739698785310,MUS 2C,A01,826955,Obermueller; Karola,29,0,30,1
1739698786338,MUS 2CK,A00,826957,Ohnishi; Takae,14,0,15,1
1739698786338,MUS 2CK,B00,826960,Ohnishi; Takae,15,0,15,0
1739698787363,MUS 2JK,A00,826963,Kenyatta; Kamau,13,0,15,2
1739698788390,MUS 4,A01,826968,Day; Kevin Alexander,24,0,25,1
1739698788390,MUS 4,A02,826969,Day; Kevin Alexander,24,0,25,1
1739698788390,MUS 4,A03,826970,Day; Kevin Alexander,25,0,25,0
1739698788390,MUS 4,A04,826972,Day; Kevin Alexander,25,0,25,0
1739698788390,MUS 4,A05,826973,Day; Kevin Alexander,25,0,25,0
1739698788390,MUS 4,A06,826986,Day; Kevin Alexander,25,0,25,0
1739698788390,MUS 4,A07,826987,Day; Kevin Alexander,25,0,25,0
1739698788390,MUS 4,A08,826988,Day; Kevin Alexander,25,0,25,0
1739698788390,MUS 4,A09,826989,Day; Kevin Alexander,25,0,25,0
1739698788390,MUS 4,A10,826990,Day; Kevin Alexander,24,0,25,1
1739698789418,MUS 6,A01,826992,Hankins; Sarah E.,24,0,25,1
1739698789418,MUS 6,A02,826993,Hankins; Sarah E.,23,0,25,2
1739698789418,MUS 6,A03,826994,Hankins; Sarah E.,25,0,25,0
1739698789418,MUS 6,A04,826995,Hankins; Sarah E.,22,0,25,3
1739698790448,MUS 8,A01,826997,Smythe; Cory Benjamin,23,0,25,2
1739698790448,MUS 8,A02,826998,Smythe; Cory Benjamin,25,0,25,0
1739698790448,MUS 8,A03,827002,Smythe; Cory Benjamin,25,0,25,0
1739698790448,MUS 8,A04,827003,Smythe; Cory Benjamin,22,0,25,3
1739698790448,MUS 8,A05,827004,Smythe; Cory Benjamin,25,0,25,0
1739698790448,MUS 8,A06,827005,Smythe; Cory Benjamin,25,0,25,0
1739698790448,MUS 8,A07,827006,Smythe; Cory Benjamin,24,0,25,1
1739698790448,MUS 8,A08,827007,Smythe; Cory Benjamin,23,0,25,2
1739698791473,MUS 11,A01,827011,Terrazas Perez; Wilfrido D,23,0,25,2
1739698791473,MUS 11,A02,827012,Terrazas Perez; Wilfrido D,23,0,25,2
1739698791473,MUS 11,A03,827013,Terrazas Perez; Wilfrido D,25,0,25,0
1739698791473,MUS 11,A04,827014,Terrazas Perez; Wilfrido D,24,0,25,1
1739698791473,MUS 11,A05,827015,Terrazas Perez; Wilfrido D,25,0,25,0
1739698791473,MUS 11,A06,827016,Terrazas Perez; Wilfrido D,25,0,25,0
1739698791473,MUS 11,A07,827017,Terrazas Perez; Wilfrido D,25,0,25,0
1739698791473,MUS 11,A08,827018,Terrazas Perez; Wilfrido D,22,0,25,3
1739698792501,MUS 12,A01,827020,Guy; Nancy,24,0,25,1
1739698792501,MUS 12,A02,827021,Guy; Nancy,25,0,25,0
1739698792501,MUS 12,A03,827022,Guy; Nancy,25,0,25,0
1739698792501,MUS 12,A04,827023,Guy; Nancy,24,0,25,1
1739698793526,MUS 14,A01,827025,McCormack; Timothy Matthew,25,0,25,0
1739698793526,MUS 14,A02,827026,McCormack; Timothy Matthew,25,0,25,0
1739698793526,MUS 14,A03,827027,McCormack; Timothy Matthew,24,0,25,1
1739698793526,MUS 14,A04,827028,McCormack; Timothy Matthew,25,0,25,0
1739698794556,MUS 15,A01,827031,Staff,22,0,25,3
1739698794556,MUS 15,A02,827032,Staff,23,0,25,2
1739698794556,MUS 15,A03,827033,Staff,24,0,25,1
1739698794556,MUS 15,A04,827034,Staff,25,0,25,0
1739698794556,MUS 15,A05,827035,Staff,25,0,25,0
1739698794556,MUS 15,A06,827036,Staff,23,0,25,2
1739698794556,MUS 15,A07,827037,Staff,25,0,25,0
1739698794556,MUS 15,A08,827038,Staff,24,0,25,1
1739698794556,MUS 15,A09,827039,Staff,25,0,25,0
1739698794556,MUS 15,A10,827049,Staff,23,0,25,2
1739698795596,MUS 17,A01,827051,Staff,24,0,25,1
1739698795596,MUS 17,A02,827052,Staff,25,0,25,0
1739698795596,MUS 17,A03,827053,Staff,25,0,25,0
1739698795596,MUS 17,A04,827054,Staff,24,0,25,1
1739698795596,MUS 17,A05,827055,Staff,25,0,25,0
1739698795596,MUS 17,A06,827056,Staff,24,0,25,1
1739698795596,MUS 17,A07,827057,Staff,24,0,25,1
1739698795596,MUS 17,A08,827060,Staff,23,0,25,2
1739698795596,MUS 17,A09,827061,Staff,25,0,25,0
1739698795596,MUS 17,A10,827062,Staff,25,0,25,0
1739698795596,MUS 17,A11,827063,Staff,25,0,25,0
1739698795596,MUS 17,A12,827064,Staff,25,0,25,0
1739698796624,MUS 19R,A01,827066,Britt; King James,23,0,25,2
1739698796624,MUS 19R,A02,827067,Britt; King James,15,0,25,10
1739698796624,MUS 19R,A03,827068,Britt; King James,25,0,25,0
1739698796624,MUS 19R,A04,827069,Britt; King James,22,0,25,3
1739698796624,MUS 19R,A05,827070,Britt; King James,25,0,25,0
1739698796624,MUS 19R,A06,827071,Britt; King James,21,0,25,4
1739698796624,MUS 19R,A07,827072,Britt; King James,24,0,25,1
1739698796624,MUS 19R,A08,827083,Britt; King James,23,0,25,2
1739698796624,MUS 19R,B01,827121,Britt; King James,5,0,5,0
1739698796624,MUS 19R,B02,827122,Britt; King James,5,0,5,0
1739698796624,MUS 19R,B03,827123,Britt; King James,5,0,5,0
1739698796624,MUS 19R,B04,827128,Britt; King James,5,0,5,0
1739698796624,MUS 19R,B05,827129,Britt; King James,5,0,5,0
1739698796624,MUS 19R,B06,827130,Britt; King James,5,0,5,0
1739698796624,MUS 19R,B07,827198,Britt; King James,5,0,5,0
1739698796624,MUS 19R,B08,827199,Britt; King James,5,0,5,0
1739698797654,MUS 32,001,855621,Dresser; Mark Stuart,10,0,10,0
1739698797654,MUS 32,002,855622,Kenyatta; Kamau,10,0,10,0
1739698797654,MUS 32,003,855623,Curtis; Charles Rector,10,0,10,0
1739698797654,MUS 32,004,855624,Carlstrom; Mitchell Kraig,10,0,10,0
1739698797654,MUS 32,005,855625,Terrazas Perez; Wilfrido D,10,0,10,0
1739698797654,MUS 32,006,855628,Ohnishi; Takae,10,0,10,0
1739698797654,MUS 32,007,855629,Burr; Anthony I,10,0,10,0
1739698797654,MUS 32,008,855630,Carlson; Erik,10,0,10,0
1739698797654,MUS 32,009,855631,Staff,10,0,10,0
1739698798681,MUS 32V,A00,827206,Narucki; Susan M,10,0,10,0
1739698798681,MUS 32V,B00,827209,Flores Bucio; Mariana,10,0,10,0
1739698798681,MUS 32V,C00,827210,Zazueta Cervera; Miguel Angel,10,0,10,0
1739698799708,MUS 32VM,A00,827211,Zazueta Cervera; Miguel Angel,19,0,19,0
1739698800736,MUS 43,A00,827216,Yadegari; Shahrokh D,91,0,96,5
1739698801761,MUS 95C,A00,827217,Flores Bucio; Mariana,34,0,40,6
1739698802787,MUS 95D,A00,827219,Yadegari; Shahrokh D,40,0,40,0
1739698803812,MUS 95E,A00,827229,Henson; Matthew Alexander,40,0,40,0
1739698804838,MUS 95F,A00,827332,Carlstrom; Mitchell Kraig,40,0,40,0
1739698805864,MUS 95G,A00,827371,Anderson; Kenneth,386,0,395,9
1739698805864,MUS 95G,B00,827384,Anderson; Kenneth,391,0,395,4
1739698806887,MUS 95JC,A00,827385,Kenyatta; Kamau,25,0,25,0
1739698807916,MUS 95L,A00,827386,Pittman; Katherine Sue,65,0,65,0
1739698808944,MUS 95P,A00,827387,Nourai; Keyavash,17,0,20,3
1739698809968,MUS 95W,A00,827388,Seshadri; Kartik,21,0,25,4
1739698809968,MUS 95W,B00,827389,Seshadri; Kartik,25,0,25,0
1739698810996,MUS 101C,A01,827517,Day; Kevin Alexander,34,0,35,1
1739698812023,MUS 103C,A00,827518,Steiger; Rand,14,0,15,1
1739698813049,MUS 103F,A00,827546,Steiger; Rand,1,0,1,0
1739698814075,MUS 107,A00,827547,Guy; Nancy,15,0,15,0
1739698815101,MUS 111,A00,827548,Liang; Lei,118,0,120,2
1739698816129,MUS 113,A00,827549,Narucki; Susan M,30,0,30,0
1739698817158,MUS 114,A00,827550,Schick; Steven,138,0,140,2
1739698818185,MUS 120C,A01,827563,Leslie Santana; Myrta,24,0,25,1
1739698819211,MUS 130,A00,827567,Ohnishi; Takae,35,0,35,0
1739698820243,MUS 132,001,855633,Dresser; Mark Stuart,10,0,10,0
1739698820243,MUS 132,002,855635,Kenyatta; Kamau,10,0,10,0
1739698820243,MUS 132,003,855637,Curtis; Charles Rector,10,0,10,0
1739698820243,MUS 132,004,855639,Carlstrom; Mitchell Kraig,10,0,10,0
1739698820243,MUS 132,006,855641,Terrazas Perez; Wilfrido D,10,0,10,0
1739698820243,MUS 132,007,855642,Ohnishi; Takae,10,0,10,0
1739698820243,MUS 132,008,855643,Burr; Anthony I,10,0,10,0
1739698820243,MUS 132,009,855646,Carlson; Erik,10,0,10,0
1739698820243,MUS 132,010,855647,Smythe; Cory Benjamin,10,0,10,0
1739698820243,MUS 132,011,855648,Richards; Stephanie F,10,0,10,0
1739698820243,MUS 132,012,855649,Nourai; Keyavash,10,0,10,0
1739698821269,MUS 132R,A00,827568,Narucki; Susan M,2,0,2,0
1739698822295,MUS 132V,A00,827569,Narucki; Susan M,15,0,15,0
1739698822295,MUS 132V,B00,827570,Zazueta Cervera; Miguel Angel,15,0,15,0
1739698822295,MUS 132V,C00,827572,Flores Bucio; Mariana,15,0,15,0
1739698823323,MUS 134,A00,827573,Yadegari; Shahrokh D,30,0,30,0
1739698824354,MUS 137C,A00,827574,Kenyatta; Kamau,35,0,35,0
1739698825382,MUS 143,A00,827575,Yadegari; Shahrokh D,28,0,30,2
1739698826407,MUS 150,A00,872496,Roberts; Matana,28,0,30,2
1739698827433,MUS 151,A00,827577,Hankins; Sarah E.,9,0,20,11
1739698828460,MUS 160B,A00,827579,Dubnov; Shlomo,14,0,15,1
1739698828460,MUS 160B,B00,827581,Freitas Caetano; Marcelo,15,0,15,0
1739698829485,MUS 172,A01,827584,Staff,38,0,45,7
1739698830514,MUS 174C,A00,827585,Erbe; Tom,21,0,27,6
1739698831538,MUS 175,A00,827586,Smyth; Tamara R.,27,0,30,3
1739698832563,MUS 176,A00,827587,Britt; King James,30,0,30,0
1739698833588,MUS 201A,A00,827590,Narucki; Susan M,15,0,15,0
1739698833588,MUS 201A,B00,827592,Dresser; Mark Stuart,15,0,15,0
1739698834614,MUS 201C,A00,827593,Schick; Steven,15,0,15,0
1739698835641,MUS 202,A00,827596,Schick; Steven,40,0,40,0
1739698836666,MUS 203C,A00,827597,McCormack; Timothy Matthew,13,0,15,2
1739698837692,MUS 203D,A00,827598,Davis; Anthony Curtis,10,0,10,0
1739698837692,MUS 203D,B00,827599,Obermueller; Karola,10,0,10,0
1739698837692,MUS 203D,C00,827600,Liang; Lei,10,0,10,0
1739698837692,MUS 203D,D00,827601,Lou; Michelle Siulai,10,0,10,0
1739698837692,MUS 203D,E00,827602,Steiger; Rand,10,0,10,0
1739698837692,MUS 203D,F00,827605,McCormack; Timothy Matthew,10,0,10,0
1739698838720,MUS 204,A00,827607,Obermueller; Karola,24,0,25,1
1739698839745,MUS 205,A00,827608,Hankins; Sarah E.,14,0,15,1
1739698840770,MUS 206,A00,827609,Lou; Michelle Siulai,0,0,0,0
1739698840770,MUS 206,B00,827610,Dresser; Mark Stuart,15,0,15,0
1739698840770,MUS 206,C00,872457,Roberts; Matana,14,0,15,1
1739698841797,MUS 207,A00,827611,Leslie Santana; Myrta,13,0,15,2
1739698841797,MUS 207,B00,872458,Guy; Nancy,15,0,15,0
1739698842822,MUS 210,A00,827612,Davis; Anthony Curtis,15,0,15,0
1739698843916,MUS 229,A00,872460,Liang; Lei,15,0,15,0
1739698844942,MUS 232,001,855654,Dresser; Mark Stuart,10,0,10,0
1739698844942,MUS 232,002,855655,Kenyatta; Kamau,10,0,10,0
1739698844942,MUS 232,003,855656,Curtis; Charles Rector,10,0,10,0
1739698844942,MUS 232,004,855659,Terrazas Perez; Wilfrido D,10,0,10,0
1739698844942,MUS 232,005,855660,Ohnishi; Takae,10,0,10,0
1739698844942,MUS 232,006,855661,Burr; Anthony I,10,0,10,0
1739698844942,MUS 232,007,855662,Carlson; Erik,10,0,10,0
1739698844942,MUS 232,008,855663,Schick; Steven,10,0,10,0
1739698844942,MUS 232,009,855664,Narucki; Susan M,10,0,10,0
1739698845969,MUS 234,A00,827614,Yadegari; Shahrokh D,20,0,20,0
1739698846998,MUS 245,A00,827616,Carlson; Erik,15,0,15,0
1739698848026,MUS 267,A00,827617,Erbe; Tom,13,0,15,2
1739698849053,MUS 270C,A00,827618,Dubnov; Shlomo,18,0,20,2
1739698850079,NANO 100L,A00,808557,Vecchio; Kenneth S,17,0,20,3
1739698851105,NANO 103,A00,808560,Jahed Motlagh; Zeinab,49,0,50,1
1739698852134,NANO 108,A00,808561,Lubarda; Vlado,100,0,100,0
1739698853163,NANO 112,A01,808563,Vazquez Mena; Oscar,69,0,70,1
1739698854187,NANO 115L,A01,808567,Xu; Sheng,32,0,38,6
1739698854187,NANO 115L,B01,808569,Yang; Kesong,38,0,38,0
1739698855217,NANO 120B,A01,808575,Pokorski; Jonathan Kyle,32,0,35,3
1739698855217,NANO 120B,B01,808577,Ong; Shyue Ping,34,0,35,1
1739698856243,NANO 158,A00,808580,Luo; Jian,50,0,50,0
1739698857275,NANO 174,A00,808582,Meyers; Marc,49,0,50,1
1739698858301,NANO 181R,A00,869155,Ong; Shyue Ping,38,0,40,2
1739698859327,NANO 200,A00,808584,Jahed Motlagh; Zeinab,108,0,120,12
1739698860352,NANO 273,A00,808614,Shah; Nisarg,24,0,30,6
1739698861378,NANO 279,A00,808619,Liu; Ping,44,0,50,6
1739698862403,NANO 281R,A00,808633,Ong; Shyue Ping,37,0,60,23
1739698863430,NANO 282,A00,808661,Steinmetz; Nicole F,49,0,50,1
1739698864457,NEU 200C,A00,827621,Miller; Cory T.,15,0,18,3
1739698865482,NEU 276,A01,827623,Castle; Michael James,26,0,28,2
1739698866511,NEU 296,001,866729,Evans; Sean Jeffrey,6,0,10,4
1739698866511,NEU 296,002,866730,Staff,5,0,5,0
1739698866511,NEU 296,003,866731,Staff,5,0,5,0
1739698867548,NEUG 221,A00,827624,Zou; Yimin,8,0,12,4
1739698868574,NEUG 280,A00,827625,Chen; Xu,12,0,12,0
1739698869599,NEUG 296,A00,827626,Bloodgood; Brenda Laurie,9999,0,9999,0
1739698869599,NEUG 296,B00,827627,Allen; Nicola J,9999,0,9999,0
1739698870626,OPTH 296,001,866835,Afshari; Natalie,4,0,5,1
1739698870626,OPTH 296,002,866836,Staff,5,0,5,0
1739698870626,OPTH 296,003,866838,Staff,5,0,5,0
1739698871651,ORTH 296,A00,866851,Staff,5,0,5,0
1739698871651,ORTH 296,001,866849,Schwartz; Alexandra K.,4,0,5,1
1739698871651,ORTH 296,002,866850,Staff,5,0,5,0
1739698872676,PAE 240,A00,866068,Villarreal Jr.; Elias,30,0,30,0
1739698873701,PAE 241,A01,866073,Villarreal Jr.; Elias,30,0,30,0
1739698874728,PAE 242,A00,866077,Villarreal Jr.; Elias,30,0,30,0
1739698875752,PAE 243,A00,866078,Villarreal Jr.; Elias,30,0,30,0
1739698876778,PAE 244,A00,866119,Villarreal Jr.; Elias,30,0,30,0
1739698877806,PAE 245,A01,866083,Villarreal Jr.; Elias,30,0,30,0
1739698878831,PAE 246,A00,866085,Villarreal Jr.; Elias,30,0,30,0
1739698879857,PATH 296,001,866942,Staff,5,0,5,0
1739698879857,PATH 296,002,866945,Staff,5,0,5,0
1739698879857,PATH 296,003,866947,Staff,5,0,5,0
1739698880885,PEDS 296,001,866976,Staff,5,0,5,0
1739698880885,PEDS 296,002,866982,Staff,5,0,5,0
1739698880885,PEDS 296,003,866985,Staff,5,0,5,0
1739698881912,PH 45,A01,818863,Stone; Matthew David,28,0,30,2
1739698881912,PH 45,A02,818864,Stone; Matthew David,26,0,30,4
1739698882940,PH 50,A00,818865,Glockner; Susan Mariscal,291,0,300,9
1739698883969,PH 95,A00,885315,Larsen; Britta Ann,39,0,40,1
1739698884995,PH 101,A00,818868,Tan; Gene Brian,43,0,50,7
1739698886024,PH 102,A01,818870,Rana; Brinda Kanti,17,0,25,8
1739698886024,PH 102,A02,818871,Rana; Brinda Kanti,22,0,25,3
1739698886024,PH 102,B01,818963,Rana; Brinda Kanti,21,0,25,4
1739698886024,PH 102,B02,818965,Rana; Brinda Kanti,24,0,25,1
1739698887050,PH 110,A00,818966,Campbell; Chadwick Karl,58,0,60,2
1739698887050,PH 110,B00,818968,Zoumas-Morse; Christine E.,46,0,50,4
1739698888075,PH 120,A00,818972,Wynn; Adriane Michelle,50,0,60,10
1739698889103,PH 130,A00,818976,Gould; Carlos Francisco,36,0,50,14
1739698890130,PH 155,A00,818977,Fielding-Miller; Rebecca,68,0,70,2
1739698891155,PH 162,A00,872363,Eikey; Elizabeth Victoria,23,0,30,7
1739698892192,PH 194,A00,818984,Zoumas-Morse; Christine E.,0,0,0,0
1739698892192,PH 194,B00,819006,Zoumas-Morse; Christine E.,0,0,0,0
1739698892192,PH 194,C00,819010,Nguyen-Grozavu; France T.,0,0,0,0
1739698892192,PH 194,D00,819013,Nguyen-Grozavu; France T.,0,0,0,0
1739698892192,PH 194,E00,819017,White; Anne Elizabeth Clar,0,0,0,0
1739698892192,PH 194,F00,819024,Marquez; Becky,0,0,0,0
1739698893221,PH 196BH,A01,819028,Binkin; Nancy Jeanne,20,0,20,0
1739698894246,PHAR 219,A00,828488,Ross; Camille,0,0,0,0
1739698895271,PHAR 227,A00,872418,Zhang; Jin,19,0,20,1
1739698896301,PHAR 231,A00,881484,Daneman; Richard & Newton; Alexandra C.,20,0,20,0
1739698896301,PHAR 231,B00,881486,Staff,20,0,20,0
1739698896301,PHAR 231,C00,881489,Schoeneberg; Johannes,20,0,20,0
1739698897325,PHAR 234,A00,881479,Newton; Alexandra C.,20,0,20,0
1739698898354,PHAR 276,A00,828494,Mc Culloch; Andrew Douglas,0,0,0,0
1739698899377,PHAR 295,A00,828499,Joiner; William J.,14,0,15,1
1739698900406,PHB 223,A00,819029,Vaida; Florin,17,0,36,19
1739698901434,PHB 228,A00,819036,Thomas; Ronald G,26,0,36,10
1739698902462,PHB 248,A00,819043,Xu; Ronghui,10,0,25,15
1739698903488,PHB 281,A00,872569,Staff,55,0,65,10
1739698904519,PHIL 1,A00,829682,Grush; Rick Scott,57,0,60,3
1739698905550,PHIL 10,A01,829896,Grush; Rick Scott,44,0,44,0
1739698905550,PHIL 10,A02,829897,Grush; Rick Scott,43,0,44,1
1739698905550,PHIL 10,A03,829898,Grush; Rick Scott,43,0,44,1
1739698905550,PHIL 10,A04,829899,Grush; Rick Scott,42,0,44,2
1739698905550,PHIL 10,A05,829900,Grush; Rick Scott,42,0,44,2
1739698905550,PHIL 10,A06,829901,Grush; Rick Scott,42,0,44,2
1739698906576,PHIL 13,A01,829909,Brandt; Reuven A,0,0,0,0
1739698906576,PHIL 13,A02,829910,Brandt; Reuven A,21,0,25,4
1739698906576,PHIL 13,A03,829911,Brandt; Reuven A,0,0,0,0
1739698906576,PHIL 13,A04,829912,Brandt; Reuven A,25,0,25,0
1739698906576,PHIL 13,A05,829913,Brandt; Reuven A,23,0,25,2
1739698906576,PHIL 13,A06,829914,Brandt; Reuven A,24,0,25,1
1739698907604,PHIL 27,A01,829916,Harrell; Maralee Mae,20,0,25,5
1739698907604,PHIL 27,A02,829917,Harrell; Maralee Mae,21,0,25,4
1739698907604,PHIL 27,A03,829918,Harrell; Maralee Mae,17,0,25,8
1739698907604,PHIL 27,A04,829919,Harrell; Maralee Mae,23,0,25,2
1739698908631,PHIL 28,A01,829921,Lamey; Andy M.,24,0,25,1
1739698908631,PHIL 28,A02,829922,Lamey; Andy M.,24,0,25,1
1739698908631,PHIL 28,A03,829923,Lamey; Andy M.,15,0,25,10
1739698908631,PHIL 28,A04,829924,Lamey; Andy M.,24,0,25,1
1739698908631,PHIL 28,A05,829925,Lamey; Andy M.,23,0,25,2
1739698908631,PHIL 28,A06,829926,Lamey; Andy M.,24,0,25,1
1739698909661,PHIL 33,A01,829928,Tolley; Clinton,23,0,25,2
1739698909661,PHIL 33,A02,829929,Tolley; Clinton,24,0,25,1
1739698910687,PHIL 50,A00,829930,Yuan; Yuan,111,0,120,9
1739698911717,PHIL 60,A00,829989,Marechal; Patricia,33,0,33,0
1739698912742,PHIL 101,A00,829994,Marechal; Patricia,58,0,60,2
1739698913767,PHIL 102,A00,830057,Johnson; Monte,30,0,33,3
1739698914802,PHIL 108,A00,830058,Hardimon; Michael O.,31,0,33,2
1739698915828,PHIL 112,A00,830059,Hardimon; Michael O.,35,0,40,5
1739698916854,PHIL 120,A00,830060,Carr; Jennifer Rose,50,0,55,5
1739698917882,PHIL 125,A00,830063,Carr; Jennifer Rose,32,0,33,1
1739698918911,PHIL 131,A00,830065,Watkins; Eric,32,0,33,1
1739698919940,PHIL 134,A00,830066,Rudolph; Rachel Etta,31,0,33,2
1739698920966,PHIL 145,A00,830069,McKenzie; Kerry V.,54,0,60,6
1739698921994,PHIL 155,A00,830070,Tolley; Clinton,116,0,120,4
1739698923022,PHIL 160,A00,830071,Yuan; Yuan,32,0,33,1
1739698924046,PHIL 162,A00,830072,Lamey; Andy M.,41,0,42,1
1739698925073,PHIL 173,A00,830076,Brandt; Reuven A,108,0,120,12
1739698926099,PHIL 174,A01,830079,Danks; David J,27,0,27,0
1739698926099,PHIL 174,A02,830080,Danks; David J,27,0,27,0
1739698926099,PHIL 174,A03,830081,Danks; David J,27,0,27,0
1739698926099,PHIL 174,A04,830083,Danks; David J,27,0,27,0
1739698926099,PHIL 174,A05,830084,Danks; David J,26,0,27,1
1739698926099,PHIL 174,A06,830089,Danks; David J,27,0,27,0
1739698926099,PHIL 174,A07,830090,Danks; David J,27,0,27,0
1739698926099,PHIL 174,A08,830093,Danks; David J,27,0,27,0
1739698927127,PHIL 201A,A00,830095,Watkins; Eric,17,0,20,3
1739698928157,PHIL 202,A00,830097,Brink; David O.,16,0,20,4
1739698929182,PHIL 209B,A00,830098,Gere; Catherina M.,9,0,10,1
1739698930206,PHIL 209C,A00,830108,McKenzie; Kerry V.,10,0,10,0
1739698931232,PHIL 232,A00,830138,Sher; Gila,18,0,20,2
1739698932256,PHIL 234,A00,830139,Rudolph; Rachel Etta,18,0,20,2
1739698933281,PHIL 271,A00,830142,Vargas; Manuel Rogelio & Fulkerson; Matthew Todd,10,0,10,0
1739698934306,PHIL 275,A00,830179,Watkins; Eric,9,0,10,1
1739698935330,PHIL 277,A00,830185,Tolley; Clinton,9,0,10,1
1739698936358,PHIL 278,A00,830186,Fulkerson; Matthew Todd & Cohen; Jonathan David,10,0,10,0
1739698937381,PHIL 280,A00,830192,Kovaka; Karenc,10,0,10,0
1739698938409,PHIL 281,A00,830207,Tolley; Clinton,10,0,10,0
1739698939436,PHIL 283,A00,830214,Tolley; Clinton & Vargas; Manuel Rogelio,9,0,10,1
1739698940461,PHIL 284,A00,830244,Kovaka; Karenc,10,0,10,0
1739698941486,PHIL 285,A00,830255,Fulkerson; Matthew Todd & Cohen; Jonathan David,18,0,20,2
1739698942513,PHIL 286,A00,830259,Callender; Craig Adam & Chen; Keming,10,0,10,0
1739698943539,PHIL 287,A00,830262,Johnson; Monte,10,0,10,0
1739698944570,PHIL 290,001,828857,Nelkin; Dana Kay,9999,0,9999,0
1739698944570,PHIL 290,002,828858,Bazargan-Forward; Saba,9999,0,9999,0
1739698944570,PHIL 290,003,828861,Brandt; Reuven A,9999,0,9999,0
1739698944570,PHIL 290,004,828864,Brink; David O.,9999,0,9999,0
1739698944570,PHIL 290,005,828868,Callender; Craig Adam,9999,0,9999,0
1739698944570,PHIL 290,006,828869,Carr; Jennifer Rose,9999,0,9999,0
1739698944570,PHIL 290,007,828875,Cartwright; Nancy D.,9999,0,9999,0
1739698944570,PHIL 290,008,828878,Cohen; Jonathan David,9999,0,9999,0
1739698944570,PHIL 290,009,828880,Danks; David J,9999,0,9999,0
1739698944570,PHIL 290,010,828896,Fulkerson; Matthew Todd,9999,0,9999,0
1739698944570,PHIL 290,011,828897,Grush; Rick Scott,9999,0,9999,0
1739698944570,PHIL 290,012,828934,Hardimon; Michael O.,9999,0,9999,0
1739698944570,PHIL 290,013,828950,Harrell; Maralee Mae,9999,0,9999,0
1739698944570,PHIL 290,014,828951,Johnson; Monte,9999,0,9999,0
1739698944570,PHIL 290,015,828956,Kovaka; Karenc,9999,0,9999,0
1739698944570,PHIL 290,016,828959,Lamey; Andy M.,9999,0,9999,0
1739698944570,PHIL 290,017,828963,Marechal; Patricia,9999,0,9999,0
1739698944570,PHIL 290,018,828969,McKenzie; Kerry V.,9999,0,9999,0
1739698944570,PHIL 290,019,828970,Rickless; Samuel Charles,9999,0,9999,0
1739698944570,PHIL 290,020,828971,Sher; Gila,9999,0,9999,0
1739698944570,PHIL 290,021,828983,Shields; Christopher John,9999,0,9999,0
1739698944570,PHIL 290,022,829062,Tolley; Clinton,9999,0,9999,0
1739698944570,PHIL 290,023,829063,Vargas; Manuel Rogelio,9999,0,9999,0
1739698944570,PHIL 290,024,829065,Watkins; Eric,9999,0,9999,0
1739698944570,PHIL 290,025,829067,Chen; Keming,9999,0,9999,0
1739698944570,PHIL 290,026,829069,Yuan; Yuan,9999,0,9999,0
1739698944570,PHIL 290,027,829070,Kocurek; Alexander William,9999,0,9999,0
1739698944570,PHIL 290,028,829073,Rudolph; Rachel Etta,9999,0,9999,0
1739698945603,PHIL 295,001,829074,Bazargan-Forward; Saba,9999,0,9999,0
1739698945603,PHIL 295,002,829076,Brandt; Reuven A,9999,0,9999,0
1739698945603,PHIL 295,003,829080,Brink; David O.,9999,0,9999,0
1739698945603,PHIL 295,004,829081,Callender; Craig Adam,9999,0,9999,0
1739698945603,PHIL 295,005,829082,Carr; Jennifer Rose,9999,0,9999,0
1739698945603,PHIL 295,006,829135,Cartwright; Nancy D.,9999,0,9999,0
1739698945603,PHIL 295,007,829136,Chen; Keming,9999,0,9999,0
1739698945603,PHIL 295,008,829137,Cohen; Jonathan David,9999,0,9999,0
1739698945603,PHIL 295,009,829138,Danks; David J,9999,0,9999,0
1739698945603,PHIL 295,010,829139,Fulkerson; Matthew Todd,9999,0,9999,0
1739698945603,PHIL 295,011,829143,Grush; Rick Scott,9999,0,9999,0
1739698945603,PHIL 295,012,829144,Hardimon; Michael O.,9999,0,9999,0
1739698945603,PHIL 295,013,829145,Harrell; Maralee Mae,9999,0,9999,0
1739698945603,PHIL 295,014,829146,Johnson; Monte,9999,0,9999,0
1739698945603,PHIL 295,015,829147,Kovaka; Karenc,9999,0,9999,0
1739698945603,PHIL 295,016,829148,Lamey; Andy M.,9999,0,9999,0
1739698945603,PHIL 295,017,829149,Marechal; Patricia,9999,0,9999,0
1739698945603,PHIL 295,018,829150,McKenzie; Kerry V.,9999,0,9999,0
1739698945603,PHIL 295,019,829151,Nelkin; Dana Kay,9999,0,9999,0
1739698945603,PHIL 295,020,829152,Rickless; Samuel Charles,9999,0,9999,0
1739698945603,PHIL 295,021,829153,Sher; Gila,9999,0,9999,0
1739698945603,PHIL 295,022,829154,Shields; Christopher John,9999,0,9999,0
1739698945603,PHIL 295,023,829156,Tolley; Clinton,9999,0,9999,0
1739698945603,PHIL 295,024,829157,Vargas; Manuel Rogelio,9999,0,9999,0
1739698945603,PHIL 295,025,829158,Watkins; Eric,9999,0,9999,0
1739698945603,PHIL 295,026,829159,Kocurek; Alexander William,9999,0,9999,0
1739698945603,PHIL 295,027,829160,Rudolph; Rachel Etta,9999,0,9999,0
1739698945603,PHIL 295,028,829161,Yuan; Yuan,9999,0,9999,0
1739698946628,PHYS 1A,A00,830264,Tsai; Philbert S,350,0,360,10
1739698947717,PHYS 1AL,001,830274,Yagil; Avi & Tsai; Philbert S,25,0,30,5
1739698947717,PHYS 1AL,002,830320,Yagil; Avi & Tsai; Philbert S,28,0,30,2
1739698947717,PHYS 1AL,003,830324,Yagil; Avi & Tsai; Philbert S,29,0,30,1
1739698947717,PHYS 1AL,004,830352,Yagil; Avi & Tsai; Philbert S,30,0,30,0
1739698947717,PHYS 1AL,005,830364,Yagil; Avi & Tsai; Philbert S,27,0,30,3
1739698947717,PHYS 1AL,006,830365,Yagil; Avi & Tsai; Philbert S,25,0,30,5
1739698947717,PHYS 1AL,007,830366,Yagil; Avi & Tsai; Philbert S,30,0,30,0
1739698947717,PHYS 1AL,008,830378,Yagil; Avi & Tsai; Philbert S,29,0,30,1
1739698947717,PHYS 1AL,009,830485,Yagil; Avi & Tsai; Philbert S,29,0,30,1
1739698947717,PHYS 1AL,010,830486,Yagil; Avi & Tsai; Philbert S,30,0,30,0
1739698947717,PHYS 1AL,011,830496,Yagil; Avi & Tsai; Philbert S,30,0,30,0
1739698948756,PHYS 1B,A00,830497,Groisman; Alexander,344,0,360,16
1739698949788,PHYS 1BL,001,830498,Yagil; Avi & Tsai; Philbert S,29,0,30,1
1739698949788,PHYS 1BL,002,830499,Yagil; Avi & Tsai; Philbert S,29,0,30,1
1739698949788,PHYS 1BL,003,830500,Yagil; Avi & Tsai; Philbert S,29,0,30,1
1739698949788,PHYS 1BL,004,830501,Yagil; Avi & Tsai; Philbert S,28,0,30,2
1739698949788,PHYS 1BL,005,830502,Yagil; Avi & Tsai; Philbert S,29,0,30,1
1739698949788,PHYS 1BL,006,830503,Yagil; Avi & Tsai; Philbert S,28,0,30,2
1739698949788,PHYS 1BL,007,830504,Yagil; Avi & Tsai; Philbert S,26,0,30,4
1739698949788,PHYS 1BL,008,830505,Yagil; Avi & Tsai; Philbert S,29,0,30,1
1739698949788,PHYS 1BL,009,830507,Yagil; Avi & Tsai; Philbert S,29,0,30,1
1739698949788,PHYS 1BL,010,830508,Yagil; Avi & Tsai; Philbert S,26,0,30,4
1739698949788,PHYS 1BL,011,830509,Yagil; Avi & Tsai; Philbert S,29,0,30,1
1739698949788,PHYS 1BL,012,830510,Yagil; Avi & Tsai; Philbert S,29,0,30,1
1739698950817,PHYS 1C,A00,830511,Popmintchev; Tenio,591,0,600,9
1739698950817,PHYS 1C,B00,830512,Popmintchev; Tenio,562,0,600,38
1739698951848,PHYS 1CL,001,830513,Yagil; Avi & Tsai; Philbert S,29,0,30,1
1739698951848,PHYS 1CL,002,830514,Yagil; Avi & Tsai; Philbert S,30,0,30,0
1739698951848,PHYS 1CL,003,830515,Yagil; Avi & Tsai; Philbert S,24,0,30,6
1739698951848,PHYS 1CL,004,830516,Yagil; Avi & Tsai; Philbert S,26,0,30,4
1739698951848,PHYS 1CL,005,830517,Yagil; Avi & Tsai; Philbert S,24,0,30,6
1739698951848,PHYS 1CL,006,830518,Yagil; Avi & Tsai; Philbert S,30,0,30,0
1739698951848,PHYS 1CL,007,830519,Yagil; Avi & Tsai; Philbert S,26,0,30,4
1739698951848,PHYS 1CL,008,830520,Yagil; Avi & Tsai; Philbert S,25,0,30,5
1739698951848,PHYS 1CL,009,830521,Yagil; Avi & Tsai; Philbert S,28,0,30,2
1739698951848,PHYS 1CL,010,830522,Yagil; Avi & Tsai; Philbert S,29,0,30,1
1739698951848,PHYS 1CL,011,872498,Yagil; Avi & Tsai; Philbert S,30,0,30,0
1739698951848,PHYS 1CL,012,872499,Yagil; Avi & Tsai; Philbert S,30,0,30,0
1739698951848,PHYS 1CL,013,830584,Yagil; Avi & Tsai; Philbert S,18,0,30,12
1739698951848,PHYS 1CL,014,830586,Yagil; Avi & Tsai; Philbert S,27,0,30,3
1739698951848,PHYS 1CL,015,830588,Yagil; Avi & Tsai; Philbert S,26,0,30,4
1739698951848,PHYS 1CL,016,830591,Yagil; Avi & Tsai; Philbert S,24,0,30,6
1739698951848,PHYS 1CL,017,830592,Yagil; Avi & Tsai; Philbert S,29,0,30,1
1739698951848,PHYS 1CL,018,830598,Yagil; Avi & Tsai; Philbert S,27,0,30,3
1739698951848,PHYS 1CL,019,830604,Yagil; Avi & Tsai; Philbert S,29,0,30,1
1739698951848,PHYS 1CL,020,830605,Yagil; Avi & Tsai; Philbert S,28,0,30,2
1739698951848,PHYS 1CL,021,830607,Yagil; Avi & Tsai; Philbert S,27,0,30,3
1739698951848,PHYS 1CL,022,830609,Yagil; Avi & Tsai; Philbert S,28,0,30,2
1739698951848,PHYS 1CL,023,872500,Yagil; Avi & Tsai; Philbert S,28,0,30,2
1739698951848,PHYS 1CL,024,872501,Yagil; Avi & Tsai; Philbert S,30,0,30,0
1739698951848,PHYS 1CL,025,830613,Yagil; Avi & Tsai; Philbert S,29,0,30,1
1739698951848,PHYS 1CL,026,830617,Yagil; Avi & Tsai; Philbert S,30,0,30,0
1739698951848,PHYS 1CL,027,830658,Yagil; Avi & Tsai; Philbert S,30,0,30,0
1739698951848,PHYS 1CL,028,830661,Yagil; Avi & Tsai; Philbert S,29,0,30,1
1739698951848,PHYS 1CL,029,830669,Yagil; Avi & Tsai; Philbert S,25,0,30,5
1739698951848,PHYS 1CL,030,830676,Yagil; Avi & Tsai; Philbert S,30,0,30,0
1739698951848,PHYS 1CL,031,830679,Yagil; Avi & Tsai; Philbert S,24,0,30,6
1739698951848,PHYS 1CL,032,830680,Yagil; Avi & Tsai; Philbert S,28,0,30,2
1739698951848,PHYS 1CL,033,872502,Yagil; Avi & Tsai; Philbert S,30,0,30,0
1739698951848,PHYS 1CL,034,872503,Yagil; Avi & Tsai; Philbert S,27,0,30,3
1739698952878,PHYS 2A,A01,830828,Shotwell; Brian,19,0,30,11
1739698952878,PHYS 2A,A02,830829,Shotwell; Brian,29,0,30,1
1739698952878,PHYS 2A,A03,830830,Shotwell; Brian,30,0,30,0
1739698952878,PHYS 2A,A04,830831,Shotwell; Brian,30,0,30,0
1739698952878,PHYS 2A,A05,830832,Shotwell; Brian,28,0,30,2
1739698952878,PHYS 2A,A06,830849,Shotwell; Brian,27,0,30,3
1739698952878,PHYS 2A,A07,830887,Shotwell; Brian,28,0,30,2
1739698952878,PHYS 2A,A08,830888,Shotwell; Brian,30,0,30,0
1739698952878,PHYS 2A,A09,830889,Shotwell; Brian,30,0,30,0
1739698952878,PHYS 2A,A10,830890,Shotwell; Brian,30,0,30,0
1739698952878,PHYS 2A,A11,830934,Shotwell; Brian,0,0,0,0
1739698952878,PHYS 2A,A12,830938,Shotwell; Brian,0,0,0,0
1739698953913,PHYS 2B,A01,830950,Meyertholen; Andrew D.,29,0,30,1
1739698953913,PHYS 2B,A02,830982,Meyertholen; Andrew D.,30,0,30,0
1739698953913,PHYS 2B,A03,830983,Meyertholen; Andrew D.,30,0,30,0
1739698953913,PHYS 2B,A04,830984,Meyertholen; Andrew D.,30,0,30,0
1739698953913,PHYS 2B,A05,830985,Meyertholen; Andrew D.,25,0,30,5
1739698953913,PHYS 2B,A06,830986,Meyertholen; Andrew D.,30,0,30,0
1739698953913,PHYS 2B,A07,830987,Meyertholen; Andrew D.,28,0,30,2
1739698953913,PHYS 2B,A08,830988,Meyertholen; Andrew D.,29,0,30,1
1739698953913,PHYS 2B,A09,830989,Meyertholen; Andrew D.,30,0,30,0
1739698953913,PHYS 2B,A10,831009,Meyertholen; Andrew D.,29,0,30,1
1739698953913,PHYS 2B,A11,831010,Meyertholen; Andrew D.,24,0,30,6
1739698953913,PHYS 2B,A12,831018,Meyertholen; Andrew D.,30,0,30,0
1739698953913,PHYS 2B,B01,831020,Meyertholen; Andrew D.,21,0,30,9
1739698953913,PHYS 2B,B02,831021,Meyertholen; Andrew D.,30,0,30,0
1739698953913,PHYS 2B,B03,831022,Meyertholen; Andrew D.,29,0,30,1
1739698953913,PHYS 2B,B04,831036,Meyertholen; Andrew D.,28,0,30,2
1739698953913,PHYS 2B,B05,831037,Meyertholen; Andrew D.,29,0,30,1
1739698953913,PHYS 2B,B06,831043,Meyertholen; Andrew D.,30,0,30,0
1739698953913,PHYS 2B,B07,831046,Meyertholen; Andrew D.,30,0,30,0
1739698953913,PHYS 2B,B08,831047,Meyertholen; Andrew D.,30,0,30,0
1739698953913,PHYS 2B,B09,831061,Meyertholen; Andrew D.,29,0,30,1
1739698953913,PHYS 2B,B10,831062,Meyertholen; Andrew D.,29,0,30,1
1739698953913,PHYS 2B,B11,831069,Meyertholen; Andrew D.,30,0,30,0
1739698953913,PHYS 2B,B12,831070,Meyertholen; Andrew D.,30,0,30,0
1739698954941,PHYS 2BL,A01,831108,Sharma; Vivek A.,24,0,24,0
1739698954941,PHYS 2BL,A02,831109,Sharma; Vivek A.,12,0,24,12
1739698954941,PHYS 2BL,A03,831112,Sharma; Vivek A.,22,0,24,2
1739698954941,PHYS 2BL,A04,831113,Sharma; Vivek A.,21,0,24,3
1739698954941,PHYS 2BL,A05,831127,Sharma; Vivek A.,24,0,24,0
1739698954941,PHYS 2BL,A06,831150,Sharma; Vivek A.,17,0,24,7
1739698954941,PHYS 2BL,A07,831327,Sharma; Vivek A.,21,0,24,3
1739698954941,PHYS 2BL,A08,831329,Sharma; Vivek A.,23,0,24,1
1739698954941,PHYS 2BL,A09,831338,Sharma; Vivek A.,24,0,24,0
1739698954941,PHYS 2BL,A10,831345,Sharma; Vivek A.,23,0,24,1
1739698954941,PHYS 2BL,A11,831355,Sharma; Vivek A.,21,0,24,3
1739698954941,PHYS 2BL,A12,831357,Sharma; Vivek A.,24,0,24,0
1739698954941,PHYS 2BL,A13,831428,Sharma; Vivek A.,24,0,24,0
1739698954941,PHYS 2BL,A14,831433,Sharma; Vivek A.,21,0,24,3
1739698954941,PHYS 2BL,A15,831434,Sharma; Vivek A.,21,0,24,3
1739698955971,PHYS 2C,A01,831436,Shotwell; Brian,29,0,30,1
1739698955971,PHYS 2C,A02,831440,Shotwell; Brian,30,0,30,0
1739698955971,PHYS 2C,A03,831441,Shotwell; Brian,27,0,30,3
1739698955971,PHYS 2C,A04,831444,Shotwell; Brian,29,0,30,1
1739698955971,PHYS 2C,A05,831445,Shotwell; Brian,27,0,30,3
1739698955971,PHYS 2C,A06,831446,Shotwell; Brian,30,0,30,0
1739698955971,PHYS 2C,A07,831453,Shotwell; Brian,28,0,30,2
1739698955971,PHYS 2C,A08,831454,Shotwell; Brian,29,0,30,1
1739698955971,PHYS 2C,A09,831469,Shotwell; Brian,25,0,30,5
1739698955971,PHYS 2C,A10,831470,Shotwell; Brian,27,0,30,3
1739698955971,PHYS 2C,A11,831471,Shotwell; Brian,30,0,30,0
1739698955971,PHYS 2C,A12,831481,Shotwell; Brian,27,0,30,3
1739698956997,PHYS 2CL,A01,831597,Ni; Kaixuan,25,0,28,3
1739698956997,PHYS 2CL,A02,831598,Ni; Kaixuan,23,0,28,5
1739698956997,PHYS 2CL,A03,831599,Ni; Kaixuan,27,0,28,1
1739698956997,PHYS 2CL,A04,831601,Ni; Kaixuan,26,0,28,2
1739698956997,PHYS 2CL,A05,831602,Ni; Kaixuan,26,0,28,2
1739698956997,PHYS 2CL,A06,831603,Ni; Kaixuan,26,0,28,2
1739698958025,PHYS 2D,A01,831605,Branson; James G,26,0,30,4
1739698958025,PHYS 2D,A02,831606,Branson; James G,30,0,30,0
1739698958025,PHYS 2D,A03,831607,Branson; James G,30,0,30,0
1739698959058,PHYS 4B,A01,831609,Grinstein; Benjamin,30,0,30,0
1739698959058,PHYS 4B,A02,831610,Grinstein; Benjamin,29,0,30,1
1739698959058,PHYS 4B,A03,831611,Grinstein; Benjamin,29,0,30,1
1739698959058,PHYS 4B,A04,831612,Grinstein; Benjamin,28,0,30,2
1739698960089,PHYS 4E,A01,831622,Intriligator; Kenneth Arthur,39,0,40,1
1739698960089,PHYS 4E,A02,831630,Intriligator; Kenneth Arthur,40,0,40,0
1739698960089,PHYS 4E,A03,831631,Intriligator; Kenneth Arthur,39,0,40,1
1739698961116,PHYS 87,A00,869095,Grinstein; Benjamin,20,0,20,0
1739698962143,PHYS 100C,A01,831698,Barreiro Guerrero; Julio,57,0,60,3
1739698963173,PHYS 105B,A01,831700,Green; Daniel Richard,24,0,24,0
1739698964200,PHYS 120,A01,831702,Yang; Liang,31,0,32,1
1739698964200,PHYS 120,A02,831916,Yang; Liang,30,0,32,2
1739698965230,PHYS 130A,A01,831918,You; Yizhuang,90,0,90,0
1739698966257,PHYS 130B,A01,831921,You; Yizhuang,49,0,50,1
1739698967283,PHYS 137,A01,831924,Intriligator; Kenneth Arthur,33,0,36,3
1739698968313,PHYS 140A,A01,831928,Frano Pereira; Alex M,45,0,50,5
1739698969341,PHYS 141,A00,831929,Zhao; Hongbo,57,0,60,3
1739698970369,PHYS 152B,A01,831932,Hirsch; Jorge Eduardo,17,0,20,3
1739698971400,PHYS 154,A01,872509,Grinstein; Benjamin,21,0,23,2
1739698972428,PHYS 162,A01,831935,Keating; Brian,43,0,46,3
1739698973453,PHYS 170,A01,831938,Oh; Seungeun,23,0,25,2
1739698974480,PHYS 177,A00,831940,Dudko; Olga,18,0,20,2
1739698975506,PHYS 202,A00,831941,Vergassola; Massimo & Diamond; Patrick H,19,0,20,1
1739698976530,PHYS 203B,A01,831943,Fogler; Michael M.,17,0,20,3
1739698977556,PHYS 210A,A01,831946,Arovas; Daniel P,19,0,20,1
1739698978582,PHYS 212C,A01,831948,Grover; Tarun,18,0,20,2
1739698979613,PHYS 215C,A00,831949,McGreevy; John A.,10,0,10,0
1739698980651,PHYS 221A,A00,831953,Tan; Tzer Han,20,0,20,0
1739698981676,PHYS 222A,A00,831954,Ni; Kaixuan,10,0,10,0
1739698982706,PHYS 227,A00,831958,Fuller; George Michael,22,0,25,3
1739698983731,PHYS 228,A00,831961,Flauger; Raphael M,24,0,25,1
1739698984758,PHYS 232,A00,831962,Hirsch; Jorge Eduardo,5,0,5,0
1739698985785,PHYS 239,A00,831963,Goldenfeld; Nigel,7,0,10,3
1739698985785,PHYS 239,B00,831964,Serra; Mattia,8,0,10,2
1739698986809,PHYS 241,A00,831965,Zhao; Hongbo,4,0,5,1
1739698987838,PHYS 250,A00,831969,Di Ventra; Massimiliano,50,0,50,0
1739698988862,PHYS 251,A00,831970,Grinstein; Benjamin,20,0,20,0
1739698989888,PHYS 252,A00,831971,Diamond; Patrick H,10,0,10,0
1739698990912,PHYS 253,A00,831972,Fuller; George Michael,30,0,30,0
1739698991937,PHYS 254,A00,831973,Serra; Mattia,29,0,30,1
1739698992962,PHYS 255,A00,831974,Hwa; Terence T.,30,0,30,0
1739698993991,PHYS 260,A00,831975,Fuller; George Michael,50,0,50,0
1739698995017,PHYS 277,A00,831976,Dudko; Olga,14,0,20,6
1739698996044,POLI 5D,A01,832046,Arnold; David Hall,7,0,8,1
1739698996044,POLI 5D,A02,832047,Arnold; David Hall,8,0,8,0
1739698996044,POLI 5D,A03,832049,Arnold; David Hall,8,0,8,0
1739698996044,POLI 5D,A04,832050,Arnold; David Hall,7,0,8,1
1739698996044,POLI 5D,A05,832051,Arnold; David Hall,8,0,8,0
1739698996044,POLI 5D,B01,832055,Dai; Yinlin,5,0,5,0
1739698996044,POLI 5D,B02,832056,Dai; Yinlin,4,0,5,1
1739698997070,POLI 10D,A01,832058,Noble; Benjamin S,33,0,34,1
1739698997070,POLI 10D,A02,832059,Noble; Benjamin S,33,0,34,1
1739698997070,POLI 10D,A03,832060,Noble; Benjamin S,34,0,34,0
1739698997070,POLI 10D,A04,832061,Noble; Benjamin S,33,0,34,1
1739698997070,POLI 10D,A05,832062,Noble; Benjamin S,33,0,34,1
1739698997070,POLI 10D,A06,832064,Noble; Benjamin S,34,0,34,0
1739698998101,POLI 12D,A01,832067,Thai; Eric,30,0,34,4
1739698998101,POLI 12D,A02,832068,Thai; Eric,32,0,34,2
1739698998101,POLI 12D,A03,832069,Thai; Eric,34,0,34,0
1739698998101,POLI 12D,A04,832070,Thai; Eric,34,0,34,0
1739698998101,POLI 12D,A05,832072,Thai; Eric,33,0,34,1
1739698998101,POLI 12D,A06,832074,Thai; Eric,34,0,34,0
1739698999134,POLI 27,A01,832079,Elgin; Samuel Zincke,27,0,34,7
1739698999134,POLI 27,A02,832081,Elgin; Samuel Zincke,31,0,34,3
1739698999134,POLI 27,A03,832082,Elgin; Samuel Zincke,34,0,34,0
1739698999134,POLI 27,A04,832083,Elgin; Samuel Zincke,32,0,34,2
1739699000159,POLI 28,A01,832085,Elgin; Samuel Zincke,29,0,34,5
1739699000159,POLI 28,A02,832087,Elgin; Samuel Zincke,30,0,34,4
1739699000159,POLI 28,A03,832092,Elgin; Samuel Zincke,32,0,34,2
1739699000159,POLI 28,A04,832093,Elgin; Samuel Zincke,33,0,34,1
1739699001185,POLI 30D,A01,832096,Anderson; Anthony Michael,19,0,28,9
1739699001185,POLI 30D,A02,832098,Anderson; Anthony Michael,23,0,28,5
1739699001185,POLI 30D,A03,832100,Anderson; Anthony Michael,27,0,28,1
1739699001185,POLI 30D,A04,832102,Anderson; Anthony Michael,27,0,28,1
1739699001185,POLI 30D,A05,832103,Anderson; Anthony Michael,20,0,28,8
1739699001185,POLI 30D,A06,832252,Anderson; Anthony Michael,28,0,28,0
1739699002214,POLI 87,A00,881663,Mignozzetti; Umberto,20,0,20,0
1739699003240,POLI 100O,A00,832254,Boehmer; Alison Paige,106,0,115,9
1739699004270,POLI 104Q,A00,832257,Nichter; Maysa,100,0,120,20
1739699005296,POLI 104U,A00,869584,Nichter; Maysa,56,0,75,19
1739699006322,POLI 104V,A00,832258,Staff,43,0,50,7
1739699007350,POLI 110C,A00,832259,Soon; Valerie,49,0,50,1
1739699008379,POLI 119A,A00,832260,Staff,45,0,50,5
1739699009408,POLI 120D,A00,832261,Hansen; Jan Eric,45,0,50,5
1739699010436,POLI 121D,A00,832262,Roberts; Margaret Earling,113,0,115,2
1739699011462,POLI 126AB,A00,832263,Fisk; David Lee,154,0,156,2
1739699012487,POLI 131CR,A00,832264,Hoston; Germaine,131,0,135,4
1739699012487,POLI 131CR,B00,877489,Hoston; Germaine,30,0,30,0
1739699013514,POLI 140D,A00,832265,Wong; Tak Kei,191,0,200,9
1739699014540,POLI 145C,A00,832267,Fisk; David Lee,191,0,196,5
1739699015570,POLI 149,A00,832268,Joseph; Michael F,192,0,196,4
1739699016599,POLI 150A,A00,832269,Wong; Tak Kei,235,0,245,10
1739699017629,POLI 170,A00,872371,Staff,110,0,115,5
1739699018658,POLI 176,A00,832337,Roberts; Margaret Earling,73,0,80,7
1739699019686,POLI 194,A00,832339,Staff,9999,0,9999,0
1739699020714,POLI 194SD,A00,832431,Nichter; Maysa,25,0,25,0
1739699021739,POLI 197SD,001,832432,Nichter; Maysa,25,0,25,0
1739699022768,POLI 198RA,001,832499,Broz; James Lawrence,25,0,25,0
1739699023793,POLI 203B,A00,832500,Slantchev; Branislav,23,0,25,2
1739699024819,POLI 218R,A00,832535,Hoston; Germaine,24,0,25,1
1739699025844,POLI 219,A00,832536,Soon; Valerie,10,0,10,0
1739699026872,POLI 220A,A00,832537,Ferree; Karen E,21,0,25,4
1739699027898,POLI 243,A00,832538,Joseph; Michael F,24,0,25,1
1739699028921,POLI 250,A00,832539,Stout; Christopher Timothy,22,0,25,3
1739699030975,POLI 273,A00,832541,Mignozzetti; Umberto,8,0,25,17
1739699032002,POLI 281,A00,832542,Ban; Pamela M,11,0,12,1
1739699033027,POLI 282,A00,832543,Ferree; Karen E,24,0,25,1
1739699034055,POLI 283,A00,832544,Slantchev; Branislav,23,0,25,2
1739699035081,POLI 285,A00,832545,Ingham; Sean,12,0,12,0
1739699036110,POLI 286,A00,832546,Mignozzetti; Umberto,25,0,25,0
1739699037140,PSY 296,001,867611,Eyler; Lisa T.,4,0,5,1
1739699037140,PSY 296,002,867612,Fettes; Danielle Lynn,4,0,5,1
1739699037140,PSY 296,003,867613,Staff,5,0,5,0
1739699038169,PSYC 1,A00,841780,Hurwitz; Ethan Scott,292,0,300,8
1739699039198,PSYC 3R,A00,841782,Pilegard; Celeste Cristine,297,0,310,13
1739699040228,PSYC 60,A01,862444,Lowe; Angela Beth,34,0,35,1
1739699040228,PSYC 60,A02,862476,Lowe; Angela Beth,33,0,35,2
1739699040228,PSYC 60,A03,862477,Lowe; Angela Beth,34,0,35,1
1739699040228,PSYC 60,A04,862499,Lowe; Angela Beth,32,0,35,3
1739699040228,PSYC 60,A05,862516,Lowe; Angela Beth,35,0,35,0
1739699040228,PSYC 60,A06,862578,Lowe; Angela Beth,34,0,35,1
1739699040228,PSYC 60,A07,862603,Lowe; Angela Beth,34,0,35,1
1739699040228,PSYC 60,B01,862605,Rose; Fred E.,32,0,35,3
1739699040228,PSYC 60,B02,862622,Rose; Fred E.,34,0,35,1
1739699040228,PSYC 60,B03,862658,Rose; Fred E.,33,0,35,2
1739699040228,PSYC 60,B04,862659,Rose; Fred E.,32,0,35,3
1739699040228,PSYC 60,B05,862669,Rose; Fred E.,35,0,35,0
1739699040228,PSYC 60,B06,862680,Rose; Fred E.,33,0,35,2
1739699040228,PSYC 60,B07,862682,Rose; Fred E.,34,0,35,1
1739699041253,PSYC 70,A01,862683,Pilegard; Celeste Cristine,29,0,35,6
1739699041253,PSYC 70,A02,862684,Pilegard; Celeste Cristine,33,0,35,2
1739699041253,PSYC 70,A03,862688,Pilegard; Celeste Cristine,35,0,35,0
1739699041253,PSYC 70,A04,862697,Pilegard; Celeste Cristine,35,0,35,0
1739699041253,PSYC 70,A05,862698,Pilegard; Celeste Cristine,35,0,35,0
1739699041253,PSYC 70,A06,862738,Pilegard; Celeste Cristine,35,0,35,0
1739699042281,PSYC 71,A01,841792,Geller; Emma Harlan,21,0,25,4
1739699042281,PSYC 71,A02,841793,Geller; Emma Harlan,25,0,26,1
1739699042281,PSYC 71,B01,841795,Steiner; Eric Tomas,16,0,21,5
1739699042281,PSYC 71,B02,841797,Steiner; Eric Tomas,20,0,21,1
1739699043305,PSYC 88,A00,841802,Dobkins; Karen R.,52,0,65,13
1739699044334,PSYC 100,A00,841803,Chapman; Eddie Nathaniel,299,0,348,49
1739699045362,PSYC 101,A00,841804,Schachner; Adena,264,0,295,31
1739699046388,PSYC 102,A00,841807,Moranton; Nirelia Melbina-,294,0,295,1
1739699047413,PSYC 104,A00,841810,McCullough; Michael E,193,0,265,72
1739699048437,PSYC 105,A00,841812,Lau; Aubrey,294,0,295,1
1739699049466,PSYC 108,A00,841813,Adrian; Julia Anna,291,0,295,4
1739699050493,PSYC 111B,A01,841865,Geller; Emma Harlan,35,0,35,0
1739699051573,PSYC 116C,A01,841922,Lang; Ariel,25,0,25,0
1739699052598,PSYC 117,A01,872925,Bajic; Daniel Andrew,25,0,25,0
1739699053626,PSYC 118,A01,841931,Miller; Cory T.,39,0,45,6
1739699054653,PSYC 124,A00,841932,Chapman; Eddie Nathaniel,336,0,348,12
1739699055678,PSYC 125,A00,841933,Rose; Fred E.,140,0,146,6
1739699056706,PSYC 127,A00,841934,Dickenson; Janna Alene,17,0,20,3
1739699057732,PSYC 131,A00,841936,Anagnostaras; Stephan,47,0,65,18
1739699058762,PSYC 132,A00,841937,Steiner; Eric Tomas,90,0,120,30
1739699059787,PSYC 137,A00,841939,Winkielman; Piotr,212,0,216,4
1739699060815,PSYC 144,A00,841941,Wixted; John T,293,0,295,2
1739699061844,PSYC 164,A00,841943,Kaplan; Paul,276,0,295,19
1739699062870,PSYC 169,A00,841944,Tallman; Catherine Walsh,271,0,295,24
1739699063896,PSYC 178,A00,841945,Glaser; Dale,132,0,146,14
1739699064922,PSYC 179,A00,841980,Lacefield; Katharine I,290,0,350,60
1739699065948,PSYC 188,A00,842062,Lacefield; Katharine I,233,0,300,67
1739699066975,PSYC 190,A00,842063,Barner; David A.,274,0,300,26
1739699068007,PSYC 193,A00,842067,Brashier; Nadia Marie,214,0,216,2
1739699068007,PSYC 193,B00,842068,Gremel; Christina M,33,0,35,2
1739699068007,PSYC 193,C00,842095,Harris; Christine Renee,20,0,20,0
1739699068007,PSYC 193,D00,842096,Lin; Chujun,59,0,60,1
1739699068007,PSYC 193,E00,842154,Long; Bria,24,0,25,1
1739699068007,PSYC 193,F00,872477,Mukku; Dhananjaya,35,0,35,0
1739699069038,PSYC 193L,A01,842159,Aron; Adam,18,0,21,3
1739699069038,PSYC 193L,B01,842163,Barner; David A.,22,0,24,2
1739699069038,PSYC 193L,C01,842167,Brown; Sandra A,65,0,65,0
1739699070068,PSYC 194C,A01,842196,Heyman; Gail D.,1,0,1,0
1739699071094,PSYC 210,A00,842202,Powell; Lindsey Jane,17,0,20,3
1739699072120,PSYC 222,A00,842339,Gorman; Michael R.,20,0,20,0
1739699073148,PSYC 224,A00,842402,Miller; Cory T.,29,0,30,1
1739699074176,PSYC 242,A00,842579,Walker; Caren Michelle,28,0,30,2
1739699075201,PSYC 270C,A00,842580,Dobkins; Karen R.,19,0,20,1
1739699076230,PSYC 271,A00,842581,Anagnostaras; Stephan,19,0,20,1
1739699077256,PSYC 272,A00,842582,Gentner; Tim,18,0,20,2
1739699077256,PSYC 272,B00,872469,Mukku; Dhananjaya,20,0,20,0
1739699078280,PSYC 274,A00,842583,McCullough; Michael E,30,0,30,0
1739699079304,PSYC 275,A00,842600,Brady; Timothy Francis,29,0,30,1
1739699080329,PSYC 276,A00,842601,McCullough; Michael E,15,0,20,5
1739699081357,PSYC 280,A00,842760,Serences; John Thomas,76,0,80,4
1739699082393,PSYC 296,001,851620,Anagnostaras; Stephan,9999,0,9999,0
1739699082393,PSYC 296,002,851621,Aron; Adam,9999,0,9999,0
1739699082393,PSYC 296,003,851622,Mukku; Dhananjaya,9999,0,9999,0
1739699082393,PSYC 296,004,851623,Barner; David A.,9998,0,9999,1
1739699082393,PSYC 296,005,851624,Schachner; Adena,9999,0,9999,0
1739699082393,PSYC 296,006,851625,Brady; Timothy Francis,9999,0,9999,0
1739699082393,PSYC 296,007,851627,Brashier; Nadia Marie,9999,0,9999,0
1739699082393,PSYC 296,008,851628,Brown; Sandra A,9999,0,9999,0
1739699082393,PSYC 296,009,851629,Carver; Leslie J.,9999,0,9999,0
1739699082393,PSYC 296,010,851630,Chapman; Eddie Nathaniel,9999,0,9999,0
1739699082393,PSYC 296,011,851631,Dickenson; Janna Alene,9999,0,9999,0
1739699082393,PSYC 296,012,851632,Dobkins; Karen R.,9999,0,9999,0
1739699082393,PSYC 296,014,851635,Ferreira; Victor,9999,0,9999,0
1739699082393,PSYC 296,015,851636,Geller; Emma Harlan,9999,0,9999,0
1739699082393,PSYC 296,016,851637,Gentner; Tim,9998,0,9999,1
1739699082393,PSYC 296,017,851642,Gorman; Michael R.,9999,0,9999,0
1739699082393,PSYC 296,018,851644,Gremel; Christina M,9999,0,9999,0
1739699082393,PSYC 296,019,851645,Harris; Christine Renee,9999,0,9999,0
1739699082393,PSYC 296,020,851646,Heyman; Gail D.,9999,0,9999,0
1739699082393,PSYC 296,021,851647,Lin; Chujun,9999,0,9999,0
1739699082393,PSYC 296,022,851648,Long; Bria,9999,0,9999,0
1739699082393,PSYC 296,023,851650,McCullough; Michael E,9999,0,9999,0
1739699082393,PSYC 296,024,851655,Mc Kenzie; Craig R.M.,9999,0,9999,0
1739699082393,PSYC 296,025,851656,Miller; Cory T.,9999,0,9999,0
1739699082393,PSYC 296,026,851657,Oesch; Nicholas W,9999,0,9999,0
1739699082393,PSYC 296,028,851662,Pilegard; Celeste Cristine,9999,0,9999,0
1739699082393,PSYC 296,029,851664,Powell; Lindsey Jane,9999,0,9999,0
1739699082393,PSYC 296,030,851665,Rickard; Timothy C.,9999,0,9999,0
1739699082393,PSYC 296,031,851672,Serences; John Thomas,9999,0,9999,0
1739699082393,PSYC 296,032,851774,Walker; Caren Michelle,9999,0,9999,0
1739699082393,PSYC 296,033,851778,Winkielman; Piotr,9999,0,9999,0
1739699082393,PSYC 296,034,851808,Wixted; John T,9999,0,9999,0
1739699083422,RAD 296,001,867654,Staff,5,0,5,0
1739699083422,RAD 296,002,867659,Staff,5,0,5,0
1739699083422,RAD 296,003,867666,Staff,5,0,5,0
1739699084447,RELI 150,A00,832548,Rahimi; Babak,37,0,40,3
1739699085472,RELI 189,A00,832549,Rahimi; Babak,40,0,40,0
1739699086498,REV 12,A00,869164,Yu; Paul K L,40,0,40,0
1739699087525,REV 20,A00,869165,Yu; Paul K L,40,0,40,0
1739699088554,REV 87,A00,869166,Rodriguez; Bretton Sigfred,19,0,20,1
1739699089583,RMAS 296,001,867895,Murphy; James D,5,0,5,0
1739699089583,RMAS 296,002,867896,Staff,5,0,5,0
1739699089583,RMAS 296,003,867897,Staff,5,0,5,0
1739699090608,RMED 296,001,867854,Duleba; Antoni,4,0,5,1
1739699090608,RMED 296,002,867860,Staff,5,0,5,0
1739699090608,RMED 296,003,867882,Staff,5,0,5,0
1739699091639,SE 3,A01,838151,Van Den Einde; Yael Dahlia,43,0,52,9
1739699091639,SE 3,A02,838152,Van Den Einde; Yael Dahlia,50,0,52,2
1739699091639,SE 3,A03,838153,Van Den Einde; Yael Dahlia,50,0,53,3
1739699091639,SE 3,A04,838154,Van Den Einde; Yael Dahlia,51,0,53,2
1739699091639,SE 3,A05,838155,Van Den Einde; Yael Dahlia,49,0,50,1
1739699092665,SE 101B,A01,838160,Van Den Einde; Yael Dahlia,53,0,56,3
1739699093692,SE 105,A01,838162,Qiao; Yu,85,0,88,3
1739699094717,SE 110A,A01,838164,Staff,53,0,56,3
1739699095757,SE 110B,A00,838166,Zhu; Qiang,123,0,125,2
1739699096784,SE 130B,A01,838174,Krysl; Petr,93,0,100,7
1739699097813,SE 131A,A01,838499,Krysl; Petr,103,0,110,7
1739699098846,SE 140B,A01,838504,Palermo; Alessandro,22,0,24,2
1739699098846,SE 140B,A02,838505,Palermo; Alessandro,21,0,24,3
1739699098846,SE 140B,A03,838507,Palermo; Alessandro,23,0,24,1
1739699098846,SE 140B,A04,871139,Palermo; Alessandro,14,0,24,10
1739699098846,SE 140B,A05,871140,Palermo; Alessandro,0,0,24,24
1739699098846,SE 140B,A06,871141,Palermo; Alessandro,23,0,24,1
1739699099871,SE 143B,A01,838512,Kosmatka; John B,4,0,15,11
1739699099871,SE 143B,A02,838513,Kosmatka; John B,9,0,15,6
1739699100899,SE 150A,A01,838526,Uang; Chia-Ming,94,0,100,6
1739699101925,SE 150B,A01,838538,Morrison; Machel Leigh,36,0,50,14
1739699102951,SE 151B,A00,838540,Tsampras; Georgios,62,0,75,13
1739699103980,SE 160B,A01,838543,Kim; Hyunsun Alicia,96,0,100,4
1739699105005,SE 165,A00,838544,Todd; Michael,1,0,10,9
1739699106036,SE 183,A00,872450,Tomac; Ingrid,0,0,0,3
1739699107061,SE 202,A00,838832,Kosmatka; John B,28,0,30,2
1739699108089,SE 203B,A00,838855,Tsampras; Georgios,49,0,65,16
1739699109119,SE 213,A00,838859,Palermo; Alessandro,21,0,30,9
1739699110144,SE 214,A00,870032,Shing; P. Benson,19,0,40,21
1739699111170,SE 215,A00,838876,Zhu; Qiang,34,0,45,11
1739699112199,SE 224,A00,838921,Conte; Joel P,36,0,50,14
1739699113225,SE 246,A00,838926,McCartney; John Scott,25,0,30,5
1739699114251,SE 249,A01,839605,Tomac; Ingrid,15,0,20,5
1739699115279,SE 251B,A00,838934,Qiao; Yu,17,0,25,8
1739699116308,SE 253B,A00,838942,Kim; Hyonny,30,0,30,0
1739699117337,SE 260B,A00,838947,Kim; Hyunsun Alicia,10,0,10,0
1739699118363,SE 265,A00,838954,Todd; Michael,10,0,20,10
1739699119390,SE 279,A00,838959,Chen; Jiun-Shyan,24,0,30,6
1739699120414,SE 290,A00,838962,Loh; Kenneth J. H.,74,0,100,26
1739699121445,SE 296,001,838963,Asaro; Robert J,9999,0,9999,0
1739699121445,SE 296,002,838980,Chen; Jiun-Shyan,9999,0,9999,0
1739699121445,SE 296,003,838992,Conte; Joel P,9999,0,9999,0
1739699121445,SE 296,004,839039,Elgamal; Ahmed,9999,0,9999,0
1739699121445,SE 296,005,839040,Hutchinson; Tara,9999,0,9999,0
1739699121445,SE 296,006,839041,Jandaghi Semnani; Shabnam,9999,0,9999,0
1739699121445,SE 296,007,839042,Kim; Hyonny,9999,0,9999,0
1739699121445,SE 296,008,839055,Kim; Hyunsun Alicia,9999,0,9999,0
1739699121445,SE 296,009,839059,Kosmatka; John B,9999,0,9999,0
1739699121445,SE 296,010,839087,Krysl; Petr,9999,0,9999,0
1739699121445,SE 296,011,839094,Kuester; Falko,9999,0,9999,0
1739699121445,SE 296,012,839115,Lanza Di Scalea; Francesco,9999,0,9999,0
1739699121445,SE 296,013,839173,Loh; Kenneth J. H.,9999,0,9999,0
1739699121445,SE 296,014,839174,McCartney; John Scott,9999,0,9999,0
1739699121445,SE 296,015,839198,Morrison; Machel Leigh,9999,0,9999,0
1739699121445,SE 296,016,839229,Mosqueda; Gilberto,9999,0,9999,0
1739699121445,SE 296,017,839230,Qiao; Yu,9999,0,9999,0
1739699121445,SE 296,018,839234,Restrepo; Jose,9999,0,9999,0
1739699121445,SE 296,019,839243,Shing; P. Benson,9999,0,9999,0
1739699121445,SE 296,020,839323,Todd; Michael,9999,0,9999,0
1739699121445,SE 296,021,839326,Tomac; Ingrid,9999,0,9999,0
1739699121445,SE 296,022,839327,Tsampras; Georgios,9999,0,9999,0
1739699121445,SE 296,023,839329,Uang; Chia-Ming,9999,0,9999,0
1739699121445,SE 296,024,839340,Van Den Einde; Yael Dahlia,9999,0,9999,0
1739699121445,SE 296,025,839342,Zhu; Qiang,9999,0,9999,0
1739699121445,SE 296,026,839351,Tehrani; Mehran,9999,0,9999,0
1739699121445,SE 296,027,839356,Palermo; Alessandro,9999,0,9999,0
1739699122473,SEV 20,A00,838033,Antonovics; Kate L.,30,0,30,0
1739699123503,SIO 10,A00,839607,Borsa; Adrian Antal,591,0,600,9
1739699124532,SIO 16,A00,839615,Stegman; David,146,0,150,4
1739699125561,SIO 35,A00,839616,Driscoll; Neal W.,189,0,210,21
1739699126592,SIO 50,A01,839691,Cook; Geoffrey W,20,0,22,2
1739699126592,SIO 50,A02,839692,Cook; Geoffrey W,20,0,22,2
1739699127619,SIO 60,A01,839695,Ricke; Katharine L & Lucas; Andrew J.,29,0,34,5
1739699128644,SIO 75,A00,839696,Norris; Richard D.,28,0,30,2
1739699129672,SIO 87,A00,839697,Cook; Geoffrey W,20,0,20,0
1739699129672,SIO 87,B00,839698,Cook; Geoffrey W,20,0,20,0
1739699129672,SIO 87,C00,872480,Feddersen; Falk & Morzfeld; Matthias,15,0,15,0
1739699129672,SIO 87,D00,876215,Jensen; Paul R.,19,0,20,1
1739699130701,SIO 90,A00,839699,Shipp; Lauren Elizabeth,60,0,65,5
1739699131728,SIO 111,A01,839895,Feddersen; Falk,27,0,30,3
1739699132754,SIO 112,A01,839701,Morzfeld; Matthias,38,0,40,2
1739699133779,SIO 113,A01,839703,May; David Alexander,33,0,40,7
1739699134810,SIO 115,A01,872479,Fricker; Helen A.,61,0,65,4
1739699135838,SIO 121,A00,839704,Bowman; Jeff Shovlowsky,25,0,30,5
1739699136868,SIO 135,A01,839706,Fricker; Helen A. & Sandwell; David T,20,0,20,0
1739699136868,SIO 135,A02,872452,Fricker; Helen A. & Sandwell; David T,20,0,20,0
1739699137896,SIO 136,A01,839708,Kacev; David & Shipp; Lauren Elizabeth,29,0,34,5
1739699137896,SIO 136,A02,839709,Kacev; David & Shipp; Lauren Elizabeth,32,0,34,2
1739699138919,SIO 139,A00,839713,Kacev; David,89,0,95,6
1739699139944,SIO 141,A01,839715,Pomeroy; Robert S.,14,0,14,0
1739699140969,SIO 143,A01,839717,Andersson; Andreas Jerry,31,0,35,4
1739699141995,SIO 145,A01,872421,Choy; Carolyn Anela,9,0,18,9
1739699143020,SIO 152,A01,839719,Van Allen; Emily Joyce,17,0,20,3
1739699144048,SIO 153,A01,839722,Capaldi; Tomas,29,0,30,1
1739699145072,SIO 160,A00,839723,Fialko; Yuri A.,26,0,30,4
1739699146100,SIO 173,A00,839724,Xie; Shang-Ping,26,0,30,4
1739699147133,SIO 174,A00,839725,Aluwihare; Lihini & Russell; Lynn M.,26,0,30,4
1739699148157,SIO 176,A00,839726,Merrifield; Sophia T,27,0,30,3
1739699149184,SIO 181,A01,839728,Tresguerres; Martin,20,0,25,5
1739699149184,SIO 181,A02,839729,Tresguerres; Martin,23,0,25,2
1739699149184,SIO 181,A03,839730,Tresguerres; Martin,25,0,25,0
1739699149184,SIO 181,A04,839731,Tresguerres; Martin,23,0,25,2
1739699149184,SIO 181,A05,839732,Tresguerres; Martin,25,0,25,0
1739699149184,SIO 181,A06,839733,Tresguerres; Martin,24,0,25,1
1739699150210,SIO 184,A01,839735,Rouse; Gregory W.,17,0,24,7
1739699150210,SIO 184,A02,839736,Rouse; Gregory W.,20,0,24,4
1739699151235,SIO 190,A01,839738,Lin; Ying-Tsong,18,0,20,2
1739699151235,SIO 190,B01,839740,Kacev; David,26,0,30,4
1739699151235,SIO 190,D01,839742,Gaasterland; Theresa,20,0,20,0
1739699152261,SIO 190L,A00,886144,Staff,28,0,30,2
1739699152261,SIO 190L,A01,886145,Staff,30,0,30,0
1739699153285,SIO 194,A00,851602,Staff,0,0,0,0
1739699154312,SIOB 242C,A01,839746,Gaasterland; Theresa,25,0,25,0
1739699155391,SIOB 243,A00,839748,Gerwick; William Henry,17,0,20,3
1739699156421,SIOB 262,A00,839749,Gerwick; William Henry,25,0,25,0
1739699157451,SIOB 270A,A01,839751,Petrik; Colleen Mary,11,0,15,4
1739699158478,SIOB 278,A00,839752,Jensen; Paul R.,13,0,15,2
1739699158478,SIOB 278,B00,872373,Hechinger; Ryan F.,11,0,15,4
1739699158478,SIOB 278,C00,874430,Allen; Andrew Ellis,14,0,15,1
1739699159507,SIOB 279,A00,871153,Barton; Andrew David,43,0,50,7
1739699160536,SIOB 282,A00,839753,Palenik; Brian,19,0,20,1
1739699161562,SIOB 284,A01,839755,Rouse; Gregory W.,1,0,3,2
1739699161562,SIOB 284,A02,839756,Rouse; Gregory W.,2,0,3,1
1739699162587,SIOB 286,A01,839758,Aburto Oropeza; Marco Octavio,20,0,25,5
1739699163614,SIOB 291,A00,839759,Staff,0,0,0,0
1739699164639,SIOB 297,A00,839760,Allen; Eric,19,0,25,6
1739699165665,SIOC 202B,A00,839761,Stramski; Dariusz & Gabriel; Anne Alice-Agnes,16,0,20,4
1739699166693,SIOC 203C,A01,839763,Young; William Roy,18,0,20,2
1739699167720,SIOC 207C,A00,872521,Vasconcelos; Manuela,5,0,5,0
1739699168744,SIOC 208,A00,839764,Lucas; Andrew J.,45,0,50,5
1739699169771,SIOC 209,A00,872379,Werner; Bradley T.,10,0,10,0
1739699169771,SIOC 209,B00,874420,Watson-Parris; Duncan & Hao; Xuanting,17,0,20,3
1739699170797,SIOC 211B,A00,839779,Feddersen; Falk,5,0,8,3
1739699171822,SIOC 212B,A01,839861,Cessi; Paola,11,0,15,4
1739699172848,SIOC 217C,A00,839862,Lutsko; Nicholas J.,23,0,25,2
1739699173873,SIOC 218A,A00,839863,Send; Uwe,3,0,10,7
1739699174899,SIOC 228,A00,839865,Shi; Yuanyuan,1,0,10,9
1739699175924,SIOC 235,A00,839866,Xie; Shang-Ping,7,0,10,3
1739699176950,SIOC 250,A00,839871,Norris; Joel Roland,20,0,20,0
1739699177974,SIOC 296,A00,871155,Gabriel; Corey John,9,0,20,11
1739699178999,SIOG 200B,A00,839873,Gabriel; Anne Alice-Agnes,19,0,20,1
1739699180029,SIOG 224,A00,839876,Laske; Gabi & Stegman; David,20,0,20,0
1739699181057,SIOG 227C,A00,839879,Fan; Wenyuan & Gabriel; Anne Alice-Agnes,20,0,20,0
1739699182084,SIOG 228,A00,839880,Van Allen; Emily Joyce,14,0,20,6
1739699183108,SIOG 230,A00,839882,Constable; Catherine G,25,0,25,0
1739699184133,SIOG 232,A00,839885,Constable; Steven C & Constable; Catherine G,49,0,50,1
1739699185160,SIOG 236,A01,839890,Fricker; Helen A. & Sandwell; David T,5,0,5,0
1739699185160,SIOG 236,A02,872451,Fricker; Helen A. & Sandwell; David T,5,0,5,0
1739699186187,SIOG 239,A00,839891,Fan; Wenyuan,19,0,20,1
1739699187211,SIOG 268,A00,872652,Martz; Todd R.,9,0,10,1
1739699188238,SOCE 194,A00,851601,Staff,0,0,0,0
1739699189267,SOCG 204,A00,838022,Ng; Kwai,0,0,10,10
1739699190294,SOCG 206,A00,838023,Alvarez; Camila Huerta,6,0,10,4
1739699191319,SOCG 246,A00,838024,Kenworthy; Lane A.,4,0,10,6
1739699192343,SOCG 255B,A00,838025,Gere; Catherina M.,7,0,10,3
1739699193369,SOCG 255C,A00,838026,McKenzie; Kerry V.,7,0,10,3
1739699194394,SOCG 263,A00,838027,Jules-Rosette; Bennetta W.,9,0,10,1
1739699195418,SOCG 278,A00,838030,Watson; Tobias,4,0,10,6
1739699196444,SOCG 280,A00,838031,Fitzgerald; David S,4,0,10,6
1739699197468,SOCG 290,A00,838032,Goldman; Harvey Stern,7,0,10,3
1739699198495,SOCI 2,A01,837726,Payne; Christine Anna,27,0,30,3
1739699198495,SOCI 2,A02,837727,Payne; Christine Anna,30,0,30,0
1739699198495,SOCI 2,A03,837728,Payne; Christine Anna,29,0,30,1
1739699198495,SOCI 2,A04,837729,Payne; Christine Anna,29,0,30,1
1739699198495,SOCI 2,A05,837730,Payne; Christine Anna,30,0,30,0
1739699198495,SOCI 2,A06,837766,Payne; Christine Anna,0,0,0,0
1739699198495,SOCI 2,A07,837769,Payne; Christine Anna,0,0,0,0
1739699198495,SOCI 2,A08,837770,Payne; Christine Anna,0,0,0,0
1739699199519,SOCI 10,A01,869965,Kenworthy; Lane A.,27,0,30,3
1739699199519,SOCI 10,A02,869977,Kenworthy; Lane A.,28,0,30,2
1739699199519,SOCI 10,A03,869985,Kenworthy; Lane A.,30,0,30,0
1739699199519,SOCI 10,A04,869986,Kenworthy; Lane A.,28,0,30,2
1739699200547,SOCI 20,A01,837783,Calderon-Zaks; Michael Aar,35,0,35,0
1739699200547,SOCI 20,A02,837807,Calderon-Zaks; Michael Aar,34,0,35,1
1739699201574,SOCI 60,A01,837816,Sutton; April Marie,28,0,32,4
1739699201574,SOCI 60,A02,837817,Sutton; April Marie,32,0,32,0
1739699201574,SOCI 60,A03,837818,Sutton; April Marie,29,0,32,3
1739699201574,SOCI 60,A04,837819,Sutton; April Marie,31,0,32,1
1739699202600,SOCI 100,A01,837840,Medvetz; Thomas Matthew,29,0,30,1
1739699202600,SOCI 100,A02,837848,Medvetz; Thomas Matthew,30,0,30,0
1739699202600,SOCI 100,A03,837849,Medvetz; Thomas Matthew,30,0,30,0
1739699202600,SOCI 100,A04,837850,Medvetz; Thomas Matthew,28,0,30,2
1739699203628,SOCI 103M,A00,837862,Kilpatrick; Kevin,29,0,30,1
1739699204658,SOCI 104,A00,837863,Arnal; Maud Marie Leonie,28,0,30,2
1739699205685,SOCI 106,A00,837869,Payne; Christine Anna,27,0,30,3
1739699206711,SOCI 109,A00,837870,Kilpatrick; Kevin,29,0,30,1
1739699207735,SOCI 111,A00,837871,Ribas Norris; Janet Vanesa,56,0,56,0
1739699208764,SOCI 111T,A00,837872,Thorpe; Charles Robert,65,0,65,0
1739699209791,SOCI 112,A00,837885,Pitt; Richard Norris,58,0,65,7
1739699210819,SOCI 113,A00,837886,Rogers; Julia Ellen,73,0,75,2
1739699211844,SOCI 115,A00,837889,Sutton; April Marie,63,0,65,2
1739699212870,SOCI 117,A01,851612,Jones; Makeba,9,0,13,4
1739699212870,SOCI 117,A02,851613,Jones; Makeba,13,0,13,0
1739699212870,SOCI 117,A03,851614,Jones; Makeba,12,0,12,0
1739699212870,SOCI 117,A04,851616,Jones; Makeba,12,0,12,0
1739699212870,SOCI 117,B01,870980,Staff,10,0,10,0
1739699212870,SOCI 117,B02,870985,Staff,10,0,10,0
1739699212870,SOCI 117,B03,870987,Staff,10,0,10,0
1739699212870,SOCI 117,B04,871055,Staff,10,0,10,0
1739699213898,SOCI 119,A00,837925,Victoria Torres; Pablo,87,0,90,3
1739699214922,SOCI 125C,A00,872640,Watson; Tobias,55,0,56,1
1739699215952,SOCI 125M,A00,837948,Fitzgerald; David S,45,0,45,0
1739699216978,SOCI 126,A01,851618,Jones; Makeba,18,0,20,2
1739699216978,SOCI 126,A02,837966,Jones; Makeba,20,0,20,0
1739699216978,SOCI 126,A03,837969,Jones; Makeba,20,0,20,0
1739699218005,SOCI 129,A00,837973,Pitt; Richard Norris,72,0,75,3
1739699219031,SOCI 132,A00,837974,Blair-Loy; Mary,74,0,75,1
1739699220057,SOCI 133,A00,837983,Calderon-Zaks; Michael Aar,55,0,56,1
1739699221086,SOCI 134,A00,837989,Rogers; Julia Ellen,45,0,45,0
1739699222111,SOCI 135,A00,838005,Ruiz; Jonathan Joseph,54,0,56,2
1739699223136,SOCI 138,A00,838006,Ruiz; Jonathan Joseph,55,0,56,1
1739699224162,SOCI 139,A00,838007,Ribas Norris; Janet Vanesa,41,0,46,5
1739699225191,SOCI 139A,A00,838008,Estefan; Michel,52,0,56,4
1739699226215,SOCI 140A,A00,838009,Gong; Neil M,66,0,70,4
1739699227239,SOCI 140J,A00,838010,Estefan; Michel,92,0,100,8
1739699228266,SOCI 148,A00,838011,Maron; Asa,34,0,35,1
1739699229289,SOCI 150,A00,838012,Victoria Torres; Pablo,68,0,75,7
1739699230318,SOCI 151,A00,838013,Goldman; Harvey Stern,64,0,65,1
1739699231343,SOCI 156,A00,838014,Ostovany; Khashayar,40,0,40,0
1739699232373,SOCI 157,A00,838015,Crofts; Christine,45,0,56,11
1739699233399,SOCI 158,A00,838016,Ostovany; Khashayar,39,0,40,1
1739699234426,SOCI 160,A00,838017,Medvetz; Thomas Matthew,70,0,70,0
1739699235451,SOCI 161,A00,838018,Arnal; Maud Marie Leonie,49,0,50,1
1739699236480,SOCI 168,A00,838019,Thorpe; Charles Robert,40,0,40,0
1739699237506,SOCI 168E,A00,838021,Crofts; Christine,19,0,35,16
1739699238536,SOCI 174,A00,872915,Shafir; Gershon,28,0,30,2
1739699239565,SOMC 229,A00,867907,Hoang; Mai Phuong,160,0,160,0
1739699240591,SOMC 240,A00,867911,Coyne; Christopher John,160,0,160,0
1739699241617,SOMC 242,A00,867913,Kline; Ahnika Sarah,160,0,160,0
1739699242645,SOMC 244,A00,867940,Evans; Sean Jeffrey,160,0,160,0
1739699243670,SOMC 245C,A01,867952,Noel; Geoffroy Pierre Jean,160,0,160,0
1739699244698,SOMC 246C,A00,867953,Eyler; Lisa T.,160,0,160,0
1739699245724,SOMC 247C,A50,867992,Calcutt; Nigel A,160,0,160,0
1739699246750,SOMC 248C,A00,867993,Joshi; Weena Erin,160,0,160,0
1739699247775,SOMC 249,A00,867994,Bui; Jack D,160,0,160,0
1739699248811,SOMC 250,A00,867997,Reid; Erin G.,160,0,160,0
1739699249837,SOMC 255C,A00,868050,Allison; Matthew,160,0,160,0
1739699250863,SOMI 296,A00,868065,Staff,5,0,5,0
1739699251899,SPPH 161R,A01,864775,Chambers; Christina D,29,0,30,1
1739699251899,SPPH 161R,C01,886226,Chambers; Christina D,20,0,20,0
1739699252925,SPPH 263B,A01,884929,Hook; Vivian Yuan-Ho,98,0,99,1
1739699253950,SPPS 200A,A00,864810,Luli; Alex J,100,0,100,0
1739699254979,SPPS 200B,A00,864827,Luli; Alex J,99,0,99,0
1739699256005,SPPS 200C,A00,864829,Luli; Alex J,99,0,99,0
1739699257031,SPPS 203,A00,864831,Painter; Nathan A.,92,0,99,7
1739699258056,SPPS 205,A01,864838,Bandeira; Nuno Filipe Cabrita,92,0,99,7
1739699259134,SPPS 209,A00,864842,Bounthavong; Mark,93,0,99,6
1739699260161,SPPS 211A,A00,864862,Ferguson; Fleur,92,0,99,7
1739699261189,SPPS 211B,A00,864920,Ferguson; Fleur,96,0,99,3
1739699262215,SPPS 211C,A00,864924,Ferguson; Fleur,93,0,99,6
1739699263242,SPPS 211D,A00,864925,Tsunoda; Shirley M.,99,0,99,0
1739699264271,SPPS 212C,A01,864927,Saunders; Ila Maewal,93,0,99,6
1739699265300,SPPS 213C,A00,864928,Namba; Jennifer Mariko,93,0,99,6
1739699266328,SPPS 218B,A00,864929,Vijapurkar; Ulka,93,0,99,6
1739699267353,SPPS 225,A01,864932,Reed; Chantal,92,0,99,7
1739699268379,SPPS 229,A01,864934,Reid; Erin G.,96,0,99,3
1739699269404,SPPS 237,A00,864935,Mimoto; Mizuho Stacy,96,0,99,3
1739699270433,SPPS 238,A00,864937,Beyhan; Sinem,96,0,99,3
1739699271459,SPPS 239,A01,864942,Bui; Jack D,96,0,99,3
1739699272487,SPPS 241,A01,864944,Tsunoda; Shirley M.,92,0,99,7
1739699273512,SPPS 249,A00,864945,Brandl; Katharina,96,0,99,3
1739699274537,SPPS 250,A00,864946,Tsunoda; Shirley M.,97,0,99,2
1739699275563,SPPS 251,A00,864953,Chen; Timothy,20,0,20,0
1739699276590,SPPS 252,A00,865004,Abdul-Mutakabbir; Jacinda,96,0,99,3
1739699277615,SPPS 253,A00,865006,Tsunoda; Shirley M.,99,0,99,0
1739699278644,SPPS 255,A00,865010,Bounthavong; Mark,98,0,99,1
1739699279669,SPPS 261,A00,865011,Chambers; Christina D,97,0,99,2
1739699280695,SPPS 278,A00,865012,Fricovsky; Eduardo Santiago,98,0,99,1
1739699281720,SPPS 280,A00,865013,Fricovsky; Eduardo Santiago,23,0,23,0
1739699282749,SPPS 281,A00,865014,Gerwick; William Henry,95,0,99,4
1739699283777,SPPS 283,A00,865015,Tsunoda; Shirley M.,98,0,99,1
1739699284803,SURG 296,001,868067,Harris; Jeffrey Paul,4,0,5,1
1739699284803,SURG 296,002,868068,Coffey; Charles Stuart,4,0,5,1
1739699284803,SURG 296,003,868069,Malas; Mahmoud,4,0,5,1
1739699285831,SYN 1,001,836580,Rock; Martin,20,0,20,0
1739699285831,SYN 1,002,836582,Birberick; Brittany Celest,17,0,20,3
1739699285831,SYN 1,003,836583,Meyer; Leslie Rose,20,0,20,0
1739699285831,SYN 1,004,836584,Fish; Gwendolyn Anne,19,0,20,1
1739699285831,SYN 1,005,836585,Fish; Gwendolyn Anne,20,0,20,0
1739699285831,SYN 1,006,836586,Tawater; Hanna Jean,20,0,20,0
1739699285831,SYN 1,007,836590,Fish; Gwendolyn Anne,20,0,20,0
1739699285831,SYN 1,008,836591,Iatarola; Briana Marie,18,0,20,2
1739699285831,SYN 1,009,836592,Browne; Emily,20,0,20,0
1739699285831,SYN 1,010,836594,Staff,20,0,20,0
1739699285831,SYN 1,011,836595,Hom; Kirstyn Courtney,20,0,20,0
1739699285831,SYN 1,012,836599,Hom; Kirstyn Courtney,19,0,20,1
1739699285831,SYN 1,013,836600,Lagapa; Jason,20,0,20,0
1739699285831,SYN 1,014,836603,Deavenport; James Cary,18,0,20,2
1739699285831,SYN 1,015,836606,Girard; Gabrielle,19,0,20,1
1739699285831,SYN 1,016,836607,Deavenport; James Cary,20,0,20,0
1739699285831,SYN 1,017,836622,Girard; Gabrielle,20,0,20,0
1739699285831,SYN 1,018,836653,Atkinson; Arthur Laird,20,0,20,0
1739699285831,SYN 1,019,836656,Girard; Gabrielle,18,0,20,2
1739699285831,SYN 1,020,836658,Atkinson; Arthur Laird,18,0,20,2
1739699285831,SYN 1,021,836659,Staff,20,0,20,0
1739699285831,SYN 1,022,836662,Bishop; Graham,19,0,20,1
1739699285831,SYN 1,023,836663,Bishop; Graham,20,0,20,0
1739699285831,SYN 1,024,836666,Lagapa; Jason,18,0,20,2
1739699285831,SYN 1,025,836723,Lagapa; Jason,20,0,20,0
1739699285831,SYN 1,026,836728,Iatarola; Briana Marie,20,0,20,0
1739699285831,SYN 1,027,836729,Iatarola; Briana Marie,20,0,20,0
1739699285831,SYN 1,028,836730,Difruscio; Mark,20,0,20,0
1739699285831,SYN 1,029,836731,Difruscio; Mark,19,0,20,1
1739699286862,SYN 100,A01,836744,Gladstein; Jill M,12,0,15,3
1739699286862,SYN 100,A02,836745,Gladstein; Jill M,15,0,15,0
1739699286862,SYN 100,B01,836748,Rock; Martin,15,0,15,0
1739699286862,SYN 100,B02,836809,Rock; Martin,14,0,15,1
1739699286862,SYN 100,C01,836812,Browne; Emily,14,0,15,1
1739699286862,SYN 100,C02,836818,Browne; Emily,13,0,15,2
1739699286862,SYN 100,D01,836820,Meyer; Leslie Rose,10,0,15,5
1739699286862,SYN 100,D02,836822,Meyer; Leslie Rose,15,0,15,0
1739699286862,SYN 100,E01,836824,Tawater; Hanna Jean,13,0,15,2
1739699286862,SYN 100,E02,836825,Tawater; Hanna Jean,12,0,15,3
1739699286862,SYN 100,F01,836975,Meyer; Leslie Rose,15,0,15,0
1739699286862,SYN 100,F02,837038,Meyer; Leslie Rose,14,0,15,1
1739699286862,SYN 100,G01,837132,Deavenport; James Cary,13,0,15,2
1739699286862,SYN 100,G02,837133,Deavenport; James Cary,14,0,15,1
1739699286862,SYN 100,H01,837155,Gormally; Brenna,15,0,15,0
1739699286862,SYN 100,H02,872920,Gormally; Brenna,15,0,15,0
1739699286862,SYN 100,I01,837161,Gormally; Brenna,13,0,15,2
1739699286862,SYN 100,I02,837166,Gormally; Brenna,15,0,15,0
1739699286862,SYN 100,J01,837169,Difruscio; Mark,9,0,15,6
1739699286862,SYN 100,J02,837171,Difruscio; Mark,12,0,15,3
1739699286862,SYN 100,K01,837174,Rosenberg; Ryan Glenn,9,0,15,6
1739699286862,SYN 100,K02,837176,Rosenberg; Ryan Glenn,15,0,15,0
1739699286862,SYN 100,L01,837264,Rosenberg; Ryan Glenn,13,0,15,2
1739699286862,SYN 100,L02,837265,Rosenberg; Ryan Glenn,15,0,15,0
1739699286862,SYN 100,M01,837268,Hom; Kirstyn Courtney,12,0,15,3
1739699286862,SYN 100,M02,837269,Hom; Kirstyn Courtney,12,0,15,3
1739699286862,SYN 100,N01,837272,Atkinson; Arthur Laird,14,0,15,1
1739699286862,SYN 100,N02,837275,Atkinson; Arthur Laird,14,0,15,1
1739699286862,SYN 100,O01,837278,Bishop; Graham,13,0,15,2
1739699286862,SYN 100,O02,837284,Bishop; Graham,15,0,15,0
1739699287892,SYN 150,001,837627,Vega; Adrian,20,0,20,0
1739699287892,SYN 150,002,837643,Vega; Adrian,20,0,20,0
1739699288923,TDAC 1,A00,835839,Walsh; Kim C.,19,0,20,1
1739699288923,TDAC 1,B00,835840,Walsh; Kim C.,20,0,20,0
1739699288923,TDAC 1,C00,835841,Walsh; Kim C.,7,0,20,13
1739699288923,TDAC 1,D00,835843,Walsh; Kim C.,19,0,20,1
1739699288923,TDAC 1,E00,835844,Walsh; Kim C.,6,0,20,14
1739699288923,TDAC 1,F00,835845,Walsh; Kim C.,15,0,20,5
1739699289950,TDAC 101,A00,836005,Basso; Beatrice,17,0,20,3
1739699290976,TDAC 102,A00,836006,Harting; Carla Kelso,16,0,20,4
1739699292002,TDAC 105,A00,836007,Barricelli; Marc Alexander,20,0,20,0
1739699293029,TDAC 108,A00,836008,Buescher; Stephen W.,17,0,20,3
1739699293029,TDAC 108,B00,836009,Buescher; Stephen W.,16,0,20,4
1739699293029,TDAC 108,C00,836010,Walsh; Kim C.,20,0,20,0
1739699294054,TDAC 109,A00,836012,Blair; Kyle Adam,20,0,20,0
1739699295081,TDAC 122,A00,836014,Stalling; Vanessa,30,0,30,0
1739699295081,TDAC 122,B00,836015,Perry; Lamar,30,0,30,0
1739699295081,TDAC 122,C00,872388,Celik; Aysan Karagasli,30,0,30,0
1739699295081,TDAC 122,D00,874223,Caban; Andrea Chudnow,30,0,30,0
1739699295081,TDAC 122,E00,874224,Staff,30,0,30,0
1739699296106,TDDE 101,A00,836016,Guirguis; Mark C,20,0,20,0
1739699297131,TDDE 121,A01,836018,Kuhl; Christopher August,16,0,17,1
1739699298155,TDDE 130,A00,836019,Guirguis; Mark C,20,0,20,0
1739699299184,TDDE 131,A00,836020,Petrovich; Victoria A.,19,0,20,1
1739699299184,TDDE 131,B00,872473,Brill; Robert L.,100,0,100,0
1739699300211,TDDE 132,A00,836021,Guirguis; Mark C,20,0,20,0
1739699301238,TDDM 1,A00,835853,Sammartano; Tonnie,40,0,40,0
1739699302263,TDDM 100,A00,836022,Alvarez; Ana Maria,29,0,30,1
1739699303291,TDDR 102,A00,836024,Powell; Lora,19,0,20,1
1739699304313,TDDR 108,A00,836029,Stalling; Vanessa,20,0,20,0
1739699305339,TDDR 111,A00,836039,Castro; Robert Jess,15,0,16,1
1739699305339,TDDR 111,B00,836070,Castro; Robert Jess,16,0,16,0
1739699306365,TDDR 190,A00,836072,Perry; Lamar,35,0,35,0
1739699307392,TDGE 1,A01,835855,Salovey; Todd,19,0,20,1
1739699307392,TDGE 1,A02,835856,Salovey; Todd,20,0,20,0
1739699307392,TDGE 1,A03,835857,Salovey; Todd,19,0,20,1
1739699307392,TDGE 1,A04,835858,Salovey; Todd,20,0,20,0
1739699307392,TDGE 1,A05,835859,Salovey; Todd,19,0,20,1
1739699307392,TDGE 1,A06,835861,Salovey; Todd,17,0,20,3
1739699308418,TDGE 11,A00,835862,Fulton; Julia,224,0,245,21
1739699308418,TDGE 11,B00,835863,Salimi; Rana,158,0,158,0
1739699309450,TDGE 25,A00,835864,Harting; Carla Kelso,15,0,20,5
1739699309450,TDGE 25,B00,835865,Harting; Carla Kelso,14,0,20,6
1739699309450,TDGE 25,C00,835866,Harting; Carla Kelso,19,0,20,1
1739699309450,TDGE 25,D00,835868,Harting; Carla Kelso,16,0,20,4
1739699310480,TDGE 40,A02,835872,Power; Jade Yukana,29,0,30,1
1739699310480,TDGE 40,A03,835873,Power; Jade Yukana,30,0,30,0
1739699311504,TDGE 100,A01,836080,Salovey; Todd,24,0,25,1
1739699311504,TDGE 100,A02,836084,Salovey; Todd,24,0,25,1
1739699312533,TDGE 124,A00,836091,Fulton; Julia,232,0,250,18
1739699313559,TDGE 125,B00,836162,Havis; Allan,215,0,220,5
1739699314589,TDGE 196B,A00,872390,Brown; Bernard Joseph,1,0,1,0
1739699314589,TDGE 196B,B00,872391,Burelle; Julie Sara Veronique,2,0,2,0
1739699314589,TDGE 196B,C00,872392,Celik; Aysan Karagasli,2,0,2,0
1739699314589,TDGE 196B,D00,872394,Havis; Allan,1,0,1,0
1739699314589,TDGE 196B,E00,872396,Mehrishi; Rishika,1,0,1,0
1739699314589,TDGE 196B,F00,872397,Powell; Lora,1,0,1,0
1739699314589,TDGE 196B,G00,872398,Stalling; Vanessa,1,0,1,0
1739699314589,TDGE 196B,H00,872399,Stein; Deborah Isobel,2,0,2,0
1739699315617,TDGR 212,A00,836303,Meyer; Ursula,10,0,10,0
1739699316643,TDGR 219,A00,836305,Portes; Elizabeth Marie,5,0,5,0
1739699317668,TDGR 221B,A00,836306,Caban; Andrea Chudnow,10,0,10,0
1739699318695,TDGR 229,A00,836307,Meyer; Ursula,9,0,9,0
1739699319722,TDGR 233,A00,836308,Staff,9,0,9,0
1739699320747,TDGR 245,A00,836309,Stalling; Vanessa,3,0,3,0
1739699321774,TDGR 250,A00,836311,Staff,5,0,5,0
1739699322804,TDGR 251,A00,836314,Iizuka; Naomi Hisako,5,0,5,0
1739699322804,TDGR 251,B00,836315,Stein; Deborah Isobel,5,0,5,0
1739699323832,TDGR 257B,A00,836388,Stein; Deborah Isobel,7,0,7,0
1739699324857,TDGR 278,A00,836431,Petrovich; Victoria A.,20,0,20,0
1739699325883,TDGR 279,A00,836437,Brill; Robert L.,3,0,3,0
1739699325883,TDGR 279,B00,836440,Petrovich; Victoria A.,3,0,3,0
1739699325883,TDGR 279,C00,836441,McElver; Robert Harrison,3,0,3,0
1739699325883,TDGR 279,D00,836443,Kuhl; Christopher August,3,0,3,0
1739699325883,TDGR 279,E00,836444,Bokovikova; Alina V,3,0,3,0
1739699326911,TDGR 289C,A00,836447,Anderson; Mysia Anyse,10,0,10,0
1739699327936,TDGR 289D,A00,836448,Burelle; Julie Sara Veronique,10,0,10,0
1739699328964,TDGR 292,A00,836449,Anderson; Mysia Anyse,15,0,15,0
1739699329997,TDGR 296,A00,872384,Powell; Lora,10,0,10,0
1739699331027,TDHD 175,A00,836190,Brown; Bernard Joseph,19,0,20,1
1739699332055,TDHT 10,A00,835875,Power; Jade Yukana,24,0,25,1
1739699333085,TDHT 23,A01,835878,Burelle; Julie Sara Veronique,24,0,24,0
1739699333085,TDHT 23,A02,835879,Burelle; Julie Sara Veronique,24,0,24,0
1739699333085,TDHT 23,A03,835880,Burelle; Julie Sara Veronique,22,0,24,2
1739699334113,TDHT 101,A00,836191,Anderson; Mysia Anyse,23,0,25,2
1739699334113,TDHT 101,B00,836193,Staff,24,0,25,1
1739699335141,TDHT 104,A00,836196,Basso; Beatrice,24,0,25,1
1739699336169,TDHT 115,A00,872386,Staff,21,0,25,4
1739699337195,TDMV 1,A00,835881,Caligagan; Maria T.,21,0,30,9
1739699338219,TDMV 2,A00,835882,Weinberg; Sadie,25,0,30,5
1739699339245,TDMV 3,A00,835884,Mack; Kara Shanai',28,0,40,12
1739699340271,TDMV 11,A00,835886,Naves Tannus; Melissa,27,0,30,3
1739699341297,TDMV 20,A00,835890,Smith; Alison D,18,0,20,2
1739699341297,TDMV 20,B00,835920,Brown; Bernard Joseph,40,0,40,0
1739699342324,TDMV 110,A00,836197,Caligagan; Maria T.,29,0,30,1
1739699343352,TDMV 111,A00,836201,Smith; Alison D,26,0,30,4
1739699344378,TDMV 120,A00,836206,Johnston; Holly,30,0,30,0
1739699345405,TDMV 122,A00,836209,Weinberg; Sadie,30,0,30,0
1739699346432,TDMV 123,A00,836214,Johnston; Holly,30,0,30,0
1739699347457,TDMV 130,A00,836216,Mack; Kara Shanai',40,0,40,0
1739699348484,TDMV 138,A00,836222,Jun; Grace Shin Hae,17,0,40,23
1739699349517,TDMV 140,A00,836225,Caligagan; Maria T.,38,0,40,2
1739699349517,TDMV 140,B00,836226,Corrales; Joseph Bernales,39,0,40,1
1739699349517,TDMV 140,C00,836228,Mack; Kara Shanai',30,0,30,0
1739699349517,TDMV 140,D00,836229,Power; Jade Yukana,27,0,30,3
1739699349517,TDMV 140,E00,836232,Lima; Paulo Henrique,30,0,30,0
1739699350543,TDMV 141,A00,836236,Caligagan; Tony,29,0,30,1
1739699351570,TDMV 142,A00,836239,Blanco; Juan Carlos,27,0,30,3
1739699352595,TDMV 143,A00,836288,Fyall; Daunte Edward,29,0,30,1
1739699353620,TDMV 144,A00,836289,Camaya; Michelle Ann,25,0,30,5
1739699353620,TDMV 144,B00,836293,Patnaik; Shibani,30,0,30,0
1739699354647,TDMV 146,A00,836295,Caligagan; Tony,39,0,40,1
1739699355675,TDMV 149,A00,836296,Jun; Grace Shin Hae,38,0,40,2
1739699356700,TDPF 162,A00,836297,Alvarez; Ana Maria,30,0,30,0
1739699357726,TDPR 6,A01,835924,Guirguis; Mark C,50,0,50,0
1739699357726,TDPR 6,A02,835925,Guirguis; Mark C,50,0,50,0
1739699358750,TDPR 102,A00,836298,Guirguis; Mark C,20,0,20,0
1739699359774,TDPR 104,A00,836299,Powell; Lora,15,0,15,0
1739699360799,TDPW 1,A00,835931,Stein; Deborah Isobel,14,0,15,1
1739699360799,TDPW 1,B00,835932,Stein; Deborah Isobel,15,0,15,0
1739699360799,TDPW 1,C00,835934,Stein; Deborah Isobel,15,0,15,0
1739699360799,TDPW 1,D00,835936,Stein; Deborah Isobel,13,0,15,2
1739699360799,TDPW 1,E00,835939,Stein; Deborah Isobel,13,0,15,2
1739699361825,TDPW 102,A00,836300,Iizuka; Naomi Hisako,19,0,20,1
1739699362907,TDTR 10,A00,836002,Wilson; Terry A.,26,0,30,4
1739699363931,TDTR 15,A00,836003,Johnston; Holly,29,0,30,1
1739699364960,TDTR 20,A00,836004,Smith; Alison D,19,0,20,1
1739699365988,TMC 15,A00,836574,Hemans; Patricia Ann Benitez,25,0,27,2
1739699367013,TMC 120,A01,836579,Browne; Errol Tsekani,24,0,25,1
1739699368042,UROL 296,001,868229,Staff,5,0,5,0
1739699368042,UROL 296,002,868230,Staff,5,0,5,0
1739699369070,USP 1,A01,835156,Kwak; Nancy,30,0,30,0
1739699369070,USP 1,A02,835157,Kwak; Nancy,27,0,30,3
1739699369070,USP 1,A03,835158,Kwak; Nancy,29,0,30,1
1739699369070,USP 1,A04,835159,Kwak; Nancy,28,0,30,2
1739699369070,USP 1,A05,835160,Kwak; Nancy,30,0,30,0
1739699369070,USP 1,A06,835161,Kwak; Nancy,30,0,30,0
1739699370096,USP 2,A01,835188,Pezzoli; Keith,34,0,35,1
1739699370096,USP 2,A02,835191,Pezzoli; Keith,33,0,35,2
1739699371125,USP 3,A01,835207,Wickland; Teo Akande,30,0,30,0
1739699371125,USP 3,A02,835290,Wickland; Teo Akande,28,0,30,2
1739699372154,USP 4,A00,835371,Shi; Xiao,24,0,25,1
1739699373183,USP 5,A01,835376,Shenkman; Michael Thomas,30,0,35,5
1739699373183,USP 5,A02,835381,Shenkman; Michael Thomas,34,0,35,1
1739699374211,USP 6,A01,835456,Shvartzberg Carrio; Manuel,35,0,35,0
1739699374211,USP 6,A02,835457,Shvartzberg Carrio; Manuel,35,0,35,0
1739699375237,USP 15,A01,835460,Martin; Isaac,32,0,35,3
1739699375237,USP 15,A02,835461,Martin; Isaac,35,0,35,0
1739699376263,USP 25,A00,835462,Sun; Feiyang,58,0,60,2
1739699377291,USP 60,A01,835468,Wali; Behram,27,0,28,1
1739699378317,USP 100,A00,835469,Moses; Kelema Lee,68,0,70,2
1739699379344,USP 119,A00,835472,Schwaller; Nora Louise,30,0,35,5
1739699380370,USP 124,A00,835475,Hinds; Juli Beth,67,0,70,3
1739699381396,USP 125,A00,835477,Garcia; Guadalupe,22,0,22,0
1739699382422,USP 128B,A01,835530,Lewis; Leslie R,13,0,13,0
1739699383448,USP 131,A00,835537,Wartell; Julie Dara,35,0,65,30
1739699384473,USP 142C,A00,835546,Lerner; Amy M,0,0,0,3
1739699385502,USP 145,A00,835547,Yaghmaee; Saman,142,0,146,4
1739699386529,USP 150,A00,835548,Holmes; Michael Joseph,58,0,60,2
1739699387553,USP 151,A00,835551,Clark; Christopher N,42,0,45,3
1739699388580,USP 152A,A01,835569,Moeder; Nathan L,22,0,22,0
1739699388580,USP 152A,A02,835571,Moeder; Nathan L,21,0,22,1
1739699389606,USP 152B,A00,835581,Moeder; Nathan L,23,0,25,2
1739699390633,USP 153,A00,835641,Shenkman; Michael Thomas,63,0,65,2
1739699391659,USP 158A,A00,835683,Sun; Feiyang,25,0,25,0
1739699392684,USP 159B,A00,835704,Gherini; Paul Pier-Carlo,7,0,8,1
1739699393718,USP 160,A00,835742,Wartell; Julie Dara,25,0,25,0
1739699394746,USP 164,A00,835796,Moses; Kelema Lee,24,0,32,8
1739699395776,USP 165C,A00,835797,Frank; Lawrence Douglas,20,0,20,0
1739699396802,USP 169,A00,835799,Bajaj; Ravi Siddharth,29,0,30,1
1739699397838,USP 170,A00,835800,Entezam; Maryam,61,0,65,4
1739699398865,USP 171,A00,835802,Herzog; Lawrence,65,0,70,5
1739699399891,USP 172,A00,835804,Peerson; Susan,13,0,22,9
1739699400917,USP 175,A00,835805,Velasco; Diego,20,0,22,2
1739699400917,USP 175,B00,835806,Staff,20,0,22,2
1739699401946,USP 177A,A00,835807,Velasco; Diego,21,0,22,1
1739699402975,USP 177B,A00,835814,Peerson; Susan,22,0,25,3
1739699403999,USP 180,A00,835815,Frank; Lawrence Douglas,29,0,30,1
1739699405026,USP 188B,A00,835817,Pezzoli; Keith,30,0,30,0
1739699406053,USP 190,A00,835818,Collins; Caroline Imani,15,0,15,0
1739699407079,USP 191B,A00,835823,Shi; Xiao,18,0,20,2
1739699408109,USP 193,A00,835825,Staff,22,0,22,0
1739699409133,USP 194,A00,835837,Staff,0,0,0,0
1739699410159,USP 198,A00,880741,Moses; Kelema Lee,9999,0,9999,0
1739699411187,USP 265C,A00,835838,Frank; Lawrence Douglas,10,0,10,0
1739699412216,VIS 3,A01,833730,Fayman; Eva,25,0,25,0
1739699412216,VIS 3,A02,833731,Fayman; Eva,22,0,25,3
1739699412216,VIS 3,A03,833806,Fayman; Eva,24,0,25,1
1739699412216,VIS 3,A04,833888,Fayman; Eva,25,0,25,0
1739699412216,VIS 3,A05,833889,Fayman; Eva,25,0,25,0
1739699412216,VIS 3,A06,833890,Fayman; Eva,22,0,25,3
1739699412216,VIS 3,A07,833891,Fayman; Eva,24,0,25,1
1739699412216,VIS 3,A08,833892,Fayman; Eva,23,0,25,2
1739699412216,VIS 3,A09,833893,Fayman; Eva,25,0,25,0
1739699412216,VIS 3,A10,833894,Fayman; Eva,24,0,25,1
1739699412216,VIS 3,A11,833895,Fayman; Eva,25,0,25,0
1739699412216,VIS 3,A12,833896,Fayman; Eva,22,0,25,3
1739699413244,VIS 9,A00,833897,Sprague; Sean Jeffrey,213,0,250,37
1739699414271,VIS 10,A00,833898,Stone; Patricia,238,0,250,12
1739699415297,VIS 21A,A01,833900,Newsome; Elizabeth Ann,32,0,32,0
1739699415297,VIS 21A,A02,833901,Newsome; Elizabeth Ann,31,0,32,1
1739699415297,VIS 21A,A03,833902,Newsome; Elizabeth Ann,32,0,32,0
1739699415297,VIS 21A,A04,833903,Newsome; Elizabeth Ann,31,0,32,1
1739699415297,VIS 21A,A05,833904,Newsome; Elizabeth Ann,32,0,32,0
1739699415297,VIS 21A,A06,833905,Newsome; Elizabeth Ann,32,0,32,0
1739699416326,VIS 22,A01,833907,Williams; Alena J,32,0,32,0
1739699416326,VIS 22,A02,833908,Williams; Alena J,32,0,32,0
1739699416326,VIS 22,A03,833909,Williams; Alena J,30,0,32,2
1739699416326,VIS 22,A04,833910,Williams; Alena J,31,0,32,1
1739699416326,VIS 22,A05,833911,Williams; Alena J,31,0,32,1
1739699416326,VIS 22,A06,833912,Williams; Alena J,32,0,32,0
1739699416326,VIS 22,A07,833913,Williams; Alena J,32,0,32,0
1739699416326,VIS 22,A08,833914,Williams; Alena J,32,0,32,0
1739699416326,VIS 22,A09,833915,Williams; Alena J,32,0,32,0
1739699416326,VIS 22,A10,833916,Williams; Alena J,32,0,32,0
1739699416326,VIS 22,A11,833917,Williams; Alena J,31,0,32,1
1739699416326,VIS 22,A12,833918,Williams; Alena J,32,0,32,0
1739699417354,VIS 31,A00,833919,Dominguez; Ricardo,308,0,320,12
1739699418380,VIS 32,A01,833921,Yoldas; Pinar,31,0,32,1
1739699418380,VIS 32,A02,833922,Yoldas; Pinar,31,0,32,1
1739699419405,VIS 41,A01,833924,D'Elena-Tweed; Jessica Erin,25,0,25,0
1739699419405,VIS 41,A02,833925,D'Elena-Tweed; Jessica Erin,20,0,25,5
1739699419405,VIS 41,A03,833926,D'Elena-Tweed; Jessica Erin,25,0,25,0
1739699419405,VIS 41,A04,833927,D'Elena-Tweed; Jessica Erin,22,0,25,3
1739699419405,VIS 41,A05,833928,D'Elena-Tweed; Jessica Erin,25,0,25,0
1739699419405,VIS 41,A06,833929,D'Elena-Tweed; Jessica Erin,25,0,25,0
1739699420433,VIS 70N,A01,833931,Garnett; Mariah J,22,0,22,0
1739699420433,VIS 70N,A02,833932,Garnett; Mariah J,21,0,22,1
1739699420433,VIS 70N,A03,833972,Garnett; Mariah J,22,0,22,0
1739699420433,VIS 70N,A04,833974,Garnett; Mariah J,20,0,22,2
1739699420433,VIS 70N,A05,834047,Garnett; Mariah J,22,0,22,0
1739699420433,VIS 70N,A06,834048,Garnett; Mariah J,22,0,22,0
1739699421459,VIS 85A,A01,834098,Balboni; Francesca Jean,32,0,34,2
1739699421459,VIS 85A,A02,834099,Balboni; Francesca Jean,33,0,34,1
1739699422488,VIS 87,A00,872413,Mullin; Jennifer S & Twomey; Robert Daniel,10,0,10,0
1739699423513,VIS 100A,A00,834100,Cruz; Edwin Teddy,7,0,15,8
1739699424539,VIS 102,A00,834103,Cruz; Edwin Teddy,140,0,146,6
1739699425567,VIS 105A,A00,834105,Adler; Amy,29,0,30,1
1739699426596,VIS 105B,A00,834106,Tonies; Joshua Vanjaymes,26,0,30,4
1739699427621,VIS 105C,A00,834107,Herc-Balaszek; Malgorzata,14,0,15,1
1739699428647,VIS 106A,A00,834184,Staff,25,0,25,0
1739699428647,VIS 106A,B00,834185,Chew Ii; Troy Lamarr,24,0,25,1
1739699429676,VIS 106B,A00,834191,Ortiz-Torres; Ruben,24,0,25,1
1739699430702,VIS 106C,A00,834192,Staff,12,0,15,3
1739699431728,VIS 107A,A00,834193,Staff,21,0,25,4
1739699432753,VIS 107B,A00,834194,Pylypchuk; Jonathan,22,0,25,3
1739699433778,VIS 110A,A00,834217,Dinco; Dino,14,0,15,1
1739699434804,VIS 110B,A00,834218,Iglesias; Janelle Ann,13,0,15,2
1739699435828,VIS 110D,A00,834220,Tonies; Joshua Vanjaymes,14,0,15,1
1739699436853,VIS 110F,A00,834224,Fayman; Eva,15,0,15,0
1739699437878,VIS 110N,A00,834226,Adler; Amy,15,0,15,0
1739699438903,VIS 113BN,A00,834227,Staff,14,0,15,1
1739699439927,VIS 117E,A00,834229,Newsome; Elizabeth Ann,11,0,15,4
1739699440957,VIS 121AN,A00,834231,Tronzo; William,72,0,75,3
1739699441985,VIS 124E,A00,834312,Rose; Jordan M,70,0,75,5
1739699443011,VIS 127B,A00,834313,Shen; Kuiyi,146,0,146,0
1739699444035,VIS 128A,A00,834314,Tronzo; William,73,0,75,2
1739699445060,VIS 133,A01,834317,Cantrell; Joe Leo,33,0,34,1
1739699445060,VIS 133,A02,834318,Cantrell; Joe Leo,34,0,34,0
1739699446088,VIS 133A,A00,834409,Chevalier; Clarissa Maria,15,0,15,0
1739699447117,VIS 134,A00,834422,Staff,70,0,75,5
1739699448143,VIS 141B,A00,834423,Stalbaum; Brett,13,0,15,2
1739699449173,VIS 145B,A00,834455,Akten; Mehmet,13,0,15,2
1739699449173,VIS 145B,B00,834467,Alexander; Amy J,14,0,15,1
1739699450204,VIS 146A,A00,834482,Paden; Jonathon Dean,18,0,22,4
1739699451229,VIS 147A,A01,834484,Stalbaum; Brett,20,0,22,2
1739699451229,VIS 147A,A02,834485,Stalbaum; Brett,22,0,22,0
1739699451229,VIS 147A,A03,834493,Stalbaum; Brett,21,0,22,1
1739699451229,VIS 147A,A04,834494,Stalbaum; Brett,20,0,22,2
1739699452254,VIS 147B,A00,834495,Paden; Jonathon Dean,15,0,15,0
1739699453280,VIS 149,A00,834496,Yoldas; Pinar,12,0,15,3
1739699454312,VIS 150A,A00,834506,Staff,11,0,15,4
1739699455342,VIS 152D,A01,834679,Wardwell; Mariana Razo,33,0,34,1
1739699455342,VIS 152D,A02,834754,Wardwell; Mariana Razo,34,0,34,0
1739699455342,VIS 152D,A03,834757,Wardwell; Mariana Razo,32,0,34,2
1739699455342,VIS 152D,A04,834760,Wardwell; Mariana Razo,33,0,34,1
1739699456370,VIS 159,A01,834850,Cartwright; Lisa,34,0,34,0
1739699456370,VIS 159,A02,834851,Cartwright; Lisa,30,0,34,4
1739699456370,VIS 159,A03,834852,Cartwright; Lisa,32,0,34,2
1739699456370,VIS 159,A04,834853,Cartwright; Lisa,34,0,34,0
1739699456370,VIS 159,A05,834855,Cartwright; Lisa,31,0,34,3
1739699456370,VIS 159,A06,834857,Cartwright; Lisa,34,0,34,0
1739699457397,VIS 160A,A00,871872,Paden; Jonathon Dean,15,0,15,0
1739699458422,VIS 160B,A00,834858,Akten; Mehmet,8,0,15,7
1739699458422,VIS 160B,B00,834860,Twomey; Robert Daniel,12,0,15,3
1739699458422,VIS 160B,C00,834861,Alexander; Amy J,13,0,15,2
1739699459447,VIS 164,A00,834867,Sprague; Sean Jeffrey,21,0,22,1
1739699459447,VIS 164,B00,834868,Zurita; Dmitri,22,0,22,0
1739699460473,VIS 167,A00,835011,Staff,22,0,22,0
1739699461502,VIS 168,A00,835015,Zurita; Dmitri,21,0,22,1
1739699462528,VIS 169A,A00,881456,Cross; Brian R,21,0,22,1
1739699463554,VIS 171,A00,835016,Cross; Brian R,20,0,22,2
1739699464580,VIS 172,A00,835090,Trigilio; Michael,20,0,22,2
1739699465606,VIS 174,A00,835102,Stone; Patricia,18,0,22,4
1739699465606,VIS 174,B00,835113,Zurita; Dmitri,21,0,22,1
1739699466687,VIS 177,A00,835114,Crandall; Jordan,22,0,22,0
1739699467712,VIS 179,A00,835118,Segade; Alexandro Abraham,22,0,22,0
1739699468736,VIS 180A,A00,835120,Dinco; Dino,22,0,22,0
1739699469763,VIS 180B,A00,835121,Miller; Nicole L,21,0,22,1
1739699470788,VIS 182,A00,835141,Dinco; Dino,17,0,22,5
1739699471817,VIS 185,A00,835142,Miller; Nicole L,22,0,22,0
1739699472842,VIS 190,A00,835143,Dominguez; Ricardo,15,0,15,0
1739699472842,VIS 190,B00,835144,D'Elena-Tweed; Jessica Erin,13,0,15,2
1739699472842,VIS 190,C00,835146,Yoldas; Pinar,15,0,15,0
1739699473869,VIS 202,A00,835148,Garnett; Mariah J,12,0,15,3
1739699474894,VIS 203,A00,835149,Iglesias; Janelle Ann,9,0,15,6
1739699475921,VIS 206,A00,835150,Kester; Grant,9,0,15,6
1739699476951,VIS 208,A00,835151,Moss; Ceci,15,0,15,0
1739699477978,VIS 211,A00,871767,Dean; Danielle Adobi,4,0,15,11
1739699479006,VIS 220,A00,835152,Williams; Alena J,11,0,15,4
1739699480033,VIS 258,A00,835153,Shen; Kuiyi,11,0,15,4
1739699481063,WCWP 10A,001,833211,Dhir; Simrita,20,0,20,0
1739699481063,WCWP 10A,002,833218,Dhir; Simrita,19,0,20,1
1739699481063,WCWP 10A,003,833221,Staff,0,0,0,0
1739699481063,WCWP 10A,006,833232,Susi; Natalie,0,0,0,0
1739699481063,WCWP 10A,011,833250,Staff,0,0,0,0
1739699481063,WCWP 10A,012,833255,Windham; Emily,18,0,20,2
1739699481063,WCWP 10A,013,833258,Windham; Emily,14,0,20,6
1739699481063,WCWP 10A,014,833259,Holloway Ii; Mathew,19,0,20,1
1739699481063,WCWP 10A,015,833261,Windham; Emily,17,0,20,3
1739699481063,WCWP 10A,016,833262,Holloway Ii; Mathew,20,0,20,0
1739699481063,WCWP 10A,017,833263,Holloway Ii; Mathew,20,0,20,0
1739699481063,WCWP 10A,018,872017,Escobar; Jordan Christophe,20,0,20,0
1739699481063,WCWP 10A,019,872087,Escobar; Jordan Christophe,19,0,20,1
1739699481063,WCWP 10A,020,872122,Escobar; Jordan Christophe,19,0,20,1
1739699481063,WCWP 10A,021,872361,Martiniuk; Jill,20,0,20,0
1739699481063,WCWP 10A,022,872362,Martiniuk; Jill,20,0,20,0
1739699481063,WCWP 10A,023,872364,Martiniuk; Jill,20,0,20,0
1739699481063,WCWP 10A,024,872365,Welji; Haleema Nazir,0,0,0,0
1739699482100,WCWP 10B,003,833318,Merryman; Walter,20,0,20,0
1739699482100,WCWP 10B,005,833340,Merryman; Walter,19,0,20,1
1739699482100,WCWP 10B,006,833342,Merryman; Walter,18,0,20,2
1739699482100,WCWP 10B,007,833358,Staff,0,0,0,0
1739699482100,WCWP 10B,008,833359,Ornelas; Tricia,18,0,20,2
1739699482100,WCWP 10B,009,833364,Ornelas; Tricia,16,0,20,4
1739699482100,WCWP 10B,010,833371,Uriarte; Emma,9,0,20,11
1739699482100,WCWP 10B,011,833378,Gagnon; Jeffrey C,0,0,0,0
1739699482100,WCWP 10B,012,833395,Uriarte; Emma,17,0,20,3
1739699482100,WCWP 10B,013,833397,Uriarte; Emma,13,0,20,7
1739699482100,WCWP 10B,014,833398,Staff,0,0,0,0
1739699482100,WCWP 10B,019,833421,Staff,0,0,0,0
1739699482100,WCWP 10B,020,833422,Staff,0,0,0,0
1739699482100,WCWP 10B,021,833423,Staff,0,0,0,0
1739699482100,WCWP 10B,022,833455,Gagnon; Jeffrey C,15,0,16,1
1739699482100,WCWP 10B,023,833489,Gagnon; Jeffrey C,14,0,16,2
1739699482100,WCWP 10B,024,833614,Staff,0,0,0,0
1739699482100,WCWP 10B,025,833615,Gagnon; Jeffrey C,15,0,16,1
1739699482100,WCWP 10B,026,833635,Gagnon; Jeffrey C,16,0,16,0
1739699482100,WCWP 10B,027,833667,Staff,0,0,0,0
1739699482100,WCWP 10B,028,874686,Gagnon; Jeffrey C,14,0,16,2
1739699482100,WCWP 10B,029,874687,Gagnon; Jeffrey C,15,0,16,1
1739699483131,WCWP 100,A00,833668,McCleary; Keith Long,20,0,20,0
1739699483131,WCWP 100,B00,833669,McCleary; Keith Long,19,0,20,1
1739699483131,WCWP 100,C00,833673,Twohig; Niall Ivan,19,0,20,1
1739699483131,WCWP 100,D00,833677,Twohig; Niall Ivan,19,0,20,1
1739699483131,WCWP 100,E00,833678,Young; Mark T,18,0,20,2
1739699483131,WCWP 100,F00,833679,Young; Mark T,19,0,20,1
1739699484156,WES 207,A00,833201,Staff,20,0,20,0
1739699485182,WES 265,A00,833205,Staff,20,0,20,0
1739699487469,AAS 10R,A01,807278,Butler; Elizabeth Annette,28,0,34,6
1739699487469,AAS 10R,A02,807279,Butler; Elizabeth Annette,30,0,34,4
1739699488495,AAS 170R,A00,807281,Butler; Elizabeth Annette,26,0,28,2
1739699489520,AESE 261,A00,804942,Staff,30,0,30,0
1739699490544,AESE 278D,A00,804945,Staff,30,0,30,0
1739699491570,AESE 278E,A00,804981,Staff,30,0,30,0
1739699492596,AESE 279A,A00,804985,Staff,30,0,30,0
1739699493626,ANAR 100,A00,872378,Dunseth; Zachary Clark,19,0,20,1
1739699494653,ANAR 104,A01,803045,Shtienberg; Gilad,24,0,25,1
1739699494653,ANAR 104,A02,803066,Shtienberg; Gilad,0,0,0,0
1739699495683,ANAR 111,A00,803067,Dunseth; Zachary Clark,25,0,25,0
1739699496712,ANAR 138,A00,803079,Algaze; Guillermo,12,0,15,3
1739699497738,ANAR 155,A00,803081,Braswell; Geoffrey E.,19,0,25,6
1739699498764,ANBI 111,A00,803085,Staff,22,0,25,3
1739699499789,ANBI 116,A00,803087,Wilder; Linnea Lorene,149,0,150,1
1739699500820,ANBI 139,A00,870761,Gagneux; Pascal,138,0,145,7
1739699501850,ANBI 144,A00,803091,Wilder; Linnea Lorene,70,0,75,5
1739699502878,ANBI 149,A00,803093,Non; Amy L,20,0,20,0
1739699503904,ANBI 174,A00,803096,Strum; Shirley C.,15,0,15,0
1739699504930,ANES 296,001,866120,Suresh; Preetham John,4,0,5,1
1739699504930,ANES 296,002,866141,Staff,5,0,5,0
1739699504930,ANES 296,003,866168,Staff,5,0,5,0
1739699505958,ANSC 100,A00,803098,Bialecki; Jon Anthony,23,0,25,2
1739699505958,ANSC 100,B00,871150,Rabinowitz; Dan,20,0,20,0
1739699506986,ANSC 101,A00,803099,Sloane; Julia Kathryn,35,0,40,5
1739699508011,ANSC 117,A00,803100,Martin Sandino; Amanda Maria Yoland,16,0,18,2
1739699509036,ANSC 134,A00,803104,Petterson; John C.,25,0,25,0
1739699510069,ANSC 137,A00,803105,Stewart; Alexander B,39,0,40,1
1739699511095,ANSC 147,A00,803106,Stewart; Alexander B,36,0,40,4
1739699512122,ANSC 148,A00,803110,Schonberg; Jeffrey,45,0,46,1
1739699513153,ANSC 173,A00,803119,Brenner; Suzanne A,10,0,12,2
1739699514178,ANSC 180,A00,803121,Hankins; Joseph D.,22,0,25,3
1739699515205,ANSC 191,A00,803124,Yeh; Rihan Wen Xin,11,0,12,1
1739699516237,ANTH 2,A01,803000,Marchetto; Maria Carolina,32,0,33,1
1739699516237,ANTH 2,A02,803001,Marchetto; Maria Carolina,32,0,33,1
1739699516237,ANTH 2,A03,803005,Marchetto; Maria Carolina,30,0,33,3
1739699516237,ANTH 2,A04,803006,Marchetto; Maria Carolina,30,0,33,3
1739699516237,ANTH 2,A05,803007,Marchetto; Maria Carolina,33,0,33,0
1739699516237,ANTH 2,A06,803008,Marchetto; Maria Carolina,31,0,31,0
1739699517264,ANTH 3,A01,803012,Algaze; Guillermo,30,0,30,0
1739699517264,ANTH 3,A02,803013,Algaze; Guillermo,30,0,30,0
1739699517264,ANTH 3,A03,803015,Algaze; Guillermo,30,0,30,0
1739699517264,ANTH 3,A04,803016,Algaze; Guillermo,30,0,30,0
1739699518289,ANTH 4,A01,803020,Yeh; Rihan Wen Xin,27,0,30,3
1739699518289,ANTH 4,A02,803021,Yeh; Rihan Wen Xin,30,0,30,0
1739699518289,ANTH 4,A03,803022,Yeh; Rihan Wen Xin,30,0,30,0
1739699518289,ANTH 4,A04,803024,Yeh; Rihan Wen Xin,30,0,30,0
1739699519316,ANTH 10,A00,803025,Stewart; Alexander B,73,0,80,7
1739699520347,ANTH 21,A01,803027,Stone; Annika Britt,38,0,40,2
1739699520347,ANTH 21,A02,803030,Stone; Annika Britt,36,0,40,4
1739699520347,ANTH 21,A03,803031,Stone; Annika Britt,39,0,40,1
1739699520347,ANTH 21,A04,803032,Stone; Annika Britt,39,0,40,1
1739699521373,ANTH 23,A01,803034,Stone; Annika Britt,39,0,40,1
1739699521373,ANTH 23,A02,803036,Stone; Annika Britt,39,0,40,1
1739699521373,ANTH 23,A03,803037,Stone; Annika Britt,40,0,40,0
1739699521373,ANTH 23,A04,803038,Stone; Annika Britt,40,0,40,0
1739699522400,ANTH 87,A00,875928,Staff,20,0,20,0
1739699523438,ANTH 103,A00,803126,Hankins; Joseph D.,98,0,100,2
1739699524468,ANTH 105,A00,803130,Rabinowitz; Dan,73,0,75,2
1739699525498,ANTH 109,A00,803133,Staff,38,0,40,2
1739699526526,ANTH 110,A00,803135,Staff,15,0,20,5
1739699527556,ANTH 128B,A01,803139,Lewis; Leslie R,12,0,12,0
1739699528582,ANTH 196C,A00,803147,Varma; Saiba,20,0,20,0
1739699529608,ANTH 198,001,886925,Varma; Saiba,15,0,15,0
1739699530640,ANTH 200,A00,803150,Pedersen; David,15,0,15,0
1739699531668,ANTH 230,A00,889211,Gagneux; Pascal,17,0,20,3
1739699532694,ANTH 272,A00,803155,Gere; Catherina M.,9,0,10,1
1739699533720,ANTH 273,A00,803158,McKenzie; Kerry V.,10,0,10,0
1739699534751,ANTH 288,A00,803189,Braswell; Geoffrey E.,25,0,25,0
1739699535787,ANTH 295,001,887807,Algaze; Guillermo,3,0,3,0
1739699535787,ANTH 295,002,887809,Braswell; Geoffrey E.,3,0,3,0
1739699535787,ANTH 295,003,887890,Brenner; Suzanne A,3,0,3,0
1739699535787,ANTH 295,004,887891,Csordas; Thomas J.,3,0,3,0
1739699535787,ANTH 295,005,887909,Fox; Patrick Keolu Ozer,3,0,3,0
1739699535787,ANTH 295,006,887940,Gagneux; Pascal,3,0,3,0
1739699535787,ANTH 295,007,887941,Goldstein; Paul S,3,0,3,0
1739699535787,ANTH 295,008,887942,Hankins; Joseph D.,3,0,3,0
1739699535787,ANTH 295,009,887948,Jassal; Aftab,3,0,3,0
1739699535787,ANTH 295,010,887949,Jenkins; Janis A.,3,0,3,0
1739699535787,ANTH 295,011,887950,Jimenez Cano; Nayeli Guada,3,0,3,0
1739699535787,ANTH 295,012,887951,Kaiser; Bronwyn Nicole,3,0,3,0
1739699535787,ANTH 295,013,887955,Kang; Byung Chu,3,0,3,0
1739699535787,ANTH 295,014,887957,Marchetto; Maria Carolina,3,0,3,0
1739699535787,ANTH 295,015,887960,Non; Amy L,3,0,3,0
1739699535787,ANTH 295,016,887961,Pedersen; David,3,0,3,0
1739699535787,ANTH 295,017,887962,Rivera-Collazo; Isabel C,3,0,3,0
1739699535787,ANTH 295,018,887963,Varma; Saiba,3,0,3,0
1739699535787,ANTH 295,019,887969,Yeh; Rihan Wen Xin,3,0,3,0
1739699536815,ANTH 296,001,888015,Braswell; Geoffrey E.,3,0,3,0
1739699536815,ANTH 296,002,888024,Marchetto; Maria Carolina,3,0,3,0
1739699536815,ANTH 296,003,888035,Rivera-Collazo; Isabel C,3,0,3,0
1739699536815,ANTH 296,004,888050,Varma; Saiba,3,0,3,0
1739699536815,ANTH 296,005,888055,Algaze; Guillermo,3,0,3,0
1739699536815,ANTH 296,006,888067,Brenner; Suzanne A,3,0,3,0
1739699536815,ANTH 296,007,888075,Csordas; Thomas J.,3,0,3,0
1739699536815,ANTH 296,008,888081,Fox; Patrick Keolu Ozer,3,0,3,0
1739699536815,ANTH 296,009,888084,Gagneux; Pascal,3,0,3,0
1739699536815,ANTH 296,010,888086,Goldstein; Paul S,2,0,3,1
1739699536815,ANTH 296,011,888089,Hankins; Joseph D.,3,0,3,0
1739699536815,ANTH 296,012,888093,Jassal; Aftab,3,0,3,0
1739699536815,ANTH 296,013,888095,Jenkins; Janis A.,3,0,3,0
1739699536815,ANTH 296,014,888099,Jimenez Cano; Nayeli Guada,3,0,3,0
1739699536815,ANTH 296,015,888101,Kaiser; Bronwyn Nicole,3,0,3,0
1739699536815,ANTH 296,016,888102,Kang; Byung Chu,3,0,3,0
1739699536815,ANTH 296,017,888106,Levy; Thomas E,3,0,3,0
1739699536815,ANTH 296,018,888109,Non; Amy L,3,0,3,0
1739699536815,ANTH 296,019,888111,Pedersen; David,3,0,3,0
1739699536815,ANTH 296,020,888112,Postero; Nancy Grey,3,0,3,0
1739699536815,ANTH 296,021,888116,Semendeferi; Ekaterini,3,0,3,0
1739699536815,ANTH 296,022,888118,Yeh; Rihan Wen Xin,3,0,3,0
1739699537841,ASTR 2,A01,803214,Nadler; Ethan Oliver,296,0,300,4
1739699538866,ASTR 15,A01,803221,Wright; Shelley Adams,47,0,50,3
1739699539892,ASTR 18,A01,803234,Arnold; Kam S,30,0,30,0
1739699540919,ASTR 60,A01,803300,Burgasser; Adam Jonathan,14,0,15,1
1739699540919,ASTR 60,A02,803301,Burgasser; Adam Jonathan,15,0,15,0
1739699540919,ASTR 60,A03,803302,Burgasser; Adam Jonathan,15,0,15,0
1739699540919,ASTR 60,A04,803303,Burgasser; Adam Jonathan,15,0,15,0
1739699541948,ASTR 87,A00,871154,Burgasser; Adam Jonathan,20,0,20,0
1739699542979,ASTR 103,A01,803305,Diamond; Patrick H,30,0,30,0
1739699544009,ASTR 106,A01,803307,Boggs; Steven Edward,30,0,30,0
1739699545038,ASTR 123,A01,803343,Keres; Dusan,35,0,39,4
1739699546063,ASTR 154,A01,803345,Hosseinzadeh; Griffin Alex,40,0,40,0
1739699547092,ASTR 211,A00,803346,Broekgaarden; Floor Suzan,12,0,15,3
1739699548117,ASTR 250,A00,803347,Theissen; Christopher Alexander & Hosseinzadeh; Griffin Alex,26,0,30,4
1739699549143,ASTR 251,A00,803359,Theissen; Christopher Alexander & Hosseinzadeh; Griffin Alex,28,0,30,2
1739699550170,AUD 236,A00,804989,Harris; Jeffrey Paul,5,0,5,0
1739699551195,AUD 260,A01,804994,Zettner; Erika,13,0,13,0
1739699552221,AUD 272,A00,804997,Zettner; Erika,13,0,13,0
1739699553250,AUD 275,A00,805001,Zettner; Erika,13,0,13,0
1739699554275,AUD 284,A00,805004,Zettner; Erika,13,0,13,0
1739699555304,AUD 291,A00,805008,Zettner; Erika,13,0,13,0
1739699556331,AUD 296,A00,805013,Zettner; Erika,6,0,6,0
1739699557362,AWP 3,001,802590,O'Neil; Courtney L,9,0,9,0
1739699557362,AWP 3,002,802591,O'Neil; Courtney L,9,0,9,0
1739699557362,AWP 3,003,802592,Kolodezh; Samuel,8,0,9,1
1739699557362,AWP 3,004,802593,Zimmerman; Guy,9,0,9,0
1739699557362,AWP 3,005,802594,Vaughn; Kelsey Sara,9,0,9,0
1739699557362,AWP 3,006,802595,Vaughn; Kelsey Sara,9,0,9,0
1739699557362,AWP 3,007,802597,Given; William Allan,9,0,9,0
1739699558391,AWP 4A,A00,802601,Ajo; Frances Margaret,10,0,10,0
1739699558391,AWP 4A,B00,802602,Ajo; Frances Margaret,9,0,10,1
1739699558391,AWP 4A,C00,880738,Bauer; Holly Jean,10,0,10,0
1739699559452,AWP 4B,001,802603,Steinberg; Stacy A,0,0,0,0
1739699559452,AWP 4B,002,802604,Steinberg; Stacy A,0,0,0,2
1739699559452,AWP 4B,003,802605,Gilmore; Lauren Monica,0,0,0,1
1739699559452,AWP 4B,004,802606,Gilmore; Lauren Monica,0,0,0,0
1739699559452,AWP 4B,007,802609,Bolin; Jillian,0,0,0,0
1739699559452,AWP 4B,008,802610,Bolin; Jillian,0,0,0,0
1739699559452,AWP 4B,009,802611,Zroka; Amy Liane,0,0,0,0
1739699559452,AWP 4B,010,802612,Zroka; Amy Liane,0,0,0,0
1739699559452,AWP 4B,011,802614,Christie; Veronica Ann,0,0,0,0
1739699559452,AWP 4B,012,802672,Christie; Veronica Ann,0,0,0,0
1739699559452,AWP 4B,013,802673,Jones; William Jadie,0,0,0,0
1739699559452,AWP 4B,014,802676,Jones; William Jadie,0,0,0,1
1739699559452,AWP 4B,015,802677,Heiser; Jerrod A,0,0,0,0
1739699559452,AWP 4B,016,802679,Heiser; Jerrod A,0,0,0,1
1739699559452,AWP 4B,017,802683,Bourdeau; Joseph Albert,0,0,0,0
1739699559452,AWP 4B,018,802684,Bourdeau; Joseph Albert,0,0,0,1
1739699559452,AWP 4B,019,802690,Wilson; Natalie Ann,0,0,0,0
1739699559452,AWP 4B,020,802691,Wilson; Natalie Ann,0,0,0,0
1739699559452,AWP 4B,021,802692,Stanton; Jennifer K,0,0,0,0
1739699559452,AWP 4B,022,802693,Stanton; Jennifer K,0,0,0,1
1739699559452,AWP 4B,023,802696,Riggle; Amanda L,0,0,0,1
1739699559452,AWP 4B,024,802699,Riggle; Amanda L,0,0,0,0
1739699559452,AWP 4B,025,802702,Homenick; Erik Christopher,0,0,0,0
1739699559452,AWP 4B,026,802703,Homenick; Erik Christopher,0,0,0,0
1739699559452,AWP 4B,027,802705,Ornelas Jr.; David Paul,0,0,0,0
1739699559452,AWP 4B,028,802706,Grant; Melinda G,0,0,0,0
1739699559452,AWP 4B,029,802707,Grant; Melinda G,0,0,0,0
1739699559452,AWP 4B,030,802708,Ornelas Jr.; David Paul,0,0,0,0
1739699559452,AWP 4B,031,802709,Falcon; Jennifer A,0,0,0,0
1739699559452,AWP 4B,032,802710,Falcon; Jennifer A,0,0,0,0
1739699559452,AWP 4B,033,802711,Westerfeld; Kevin John,0,0,0,0
1739699559452,AWP 4B,034,802712,Tiernan; Christa Michelle,0,0,0,0
1739699559452,AWP 4B,035,802714,Tiernan; Christa Michelle,0,0,0,0
1739699559452,AWP 4B,036,802980,Westerfeld; Kevin John,0,0,0,0
1739699559452,AWP 4B,038,802982,Gardella; Alexander Drew,0,0,0,0
1739699559452,AWP 4B,039,802983,Gardella; Alexander Drew,0,0,0,0
1739699559452,AWP 4B,040,802985,Coulter; Jane Elisabeth,0,0,0,0
1739699559452,AWP 4B,041,802986,Spicer; Jacqueline,0,0,0,0
1739699559452,AWP 4B,042,802987,Spicer; Jacqueline,0,0,0,0
1739699559452,AWP 4B,043,802989,Tsurska Svetina; Olena,0,0,0,0
1739699559452,AWP 4B,044,802990,Tsurska Svetina; Olena,0,0,0,1
1739699559452,AWP 4B,045,802991,Chandler; Bailee Daniele,0,0,0,0
1739699559452,AWP 4B,046,802993,Chandler; Bailee Daniele,0,0,0,1
1739699559452,AWP 4B,047,802994,Hall; Graham T,0,0,0,0
1739699559452,AWP 4B,048,802995,Hall; Graham T,0,0,0,0
1739699560480,AWP 10R,001,871136,Gocsik; Karen Marie,13,0,15,2
1739699561506,BENG 87,A00,886240,Sah; Robert Lie-Yuan,20,0,20,0
1739699561506,BENG 87,B00,886257,Sah; Robert Lie-Yuan,20,0,20,0
1739699562534,BENG 100,A01,805026,Alexandrov; Ludmil B,30,0,30,0
1739699562534,BENG 100,A02,805028,Alexandrov; Ludmil B,29,0,30,1
1739699562534,BENG 100,A03,805030,Alexandrov; Ludmil B,30,0,30,0
1739699562534,BENG 100,A04,805031,Alexandrov; Ludmil B,29,0,30,1
1739699563566,BENG 102,A00,805032,Chapelin; Fanny,52,0,56,4
1739699564597,BENG 103B,A00,805039,Fraley; Stephanie I.,116,0,120,4
1739699565626,BENG 112B,A01,805055,Shi; Lingyan,22,0,23,1
1739699565626,BENG 112B,A02,805056,Shi; Lingyan,20,0,23,3
1739699566654,BENG 125,A01,805058,Hasty; Jeff M,14,0,32,18
1739699566654,BENG 125,A02,805059,Hasty; Jeff M,31,0,32,1
1739699566654,BENG 125,A03,805060,Hasty; Jeff M,31,0,32,1
1739699566654,BENG 125,A04,805102,Hasty; Jeff M,32,0,32,0
1739699566654,BENG 125,A05,805109,Hasty; Jeff M,19,0,32,13
1739699567684,BENG 130,A00,805118,Kravets; Vira V.,37,0,40,3
1739699568715,BENG 134,A01,805171,Smarr; Benjamin,34,0,40,6
1739699569742,BENG 140B,A01,805175,Cabrales; Pedro,27,0,30,3
1739699569742,BENG 140B,A02,805176,Cabrales; Pedro,29,0,30,1
1739699569742,BENG 140B,A03,805177,Cabrales; Pedro,28,0,30,2
1739699570822,BENG 160,A50,805180,Aguado; Brian Alberto,18,0,25,7
1739699570822,BENG 160,A51,805181,Aguado; Brian Alberto,23,0,25,2
1739699570822,BENG 160,A52,805182,Aguado; Brian Alberto,25,0,25,0
1739699571848,BENG 168,A01,805184,Khojah; Reem I,30,0,30,0
1739699572875,BENG 172,A50,805187,Cabrales; Pedro & Sah; Robert Lie-Yuan,13,0,20,7
1739699572875,BENG 172,A51,805188,Cabrales; Pedro & Sah; Robert Lie-Yuan,19,0,20,1
1739699573901,BENG 182,A01,805190,Bafna; Vineet,29,0,35,6
1739699574928,BENG 186A,A01,805192,Kwon; Ester Jihae,0,0,25,25
1739699574928,BENG 186A,A02,805193,Kwon; Ester Jihae,23,0,25,2
1739699574928,BENG 186A,A04,805195,Kwon; Ester Jihae,17,0,25,8
1739699575955,BENG 186B,A01,805230,Aran; Kiana,39,0,40,1
1739699576985,BENG 187A,A00,805231,Taylor Amos; Alyssa C,152,0,170,18
1739699578012,BENG 187D,A00,805243,Taylor Amos; Alyssa C,34,0,60,26
1739699578012,BENG 187D,B00,805249,Taylor Amos; Alyssa C,50,0,60,10
1739699578012,BENG 187D,C00,805286,Taylor Amos; Alyssa C,41,0,60,19
1739699579037,BENG 190,A00,872568,Khojah; Reem I,24,0,40,16
1739699580062,BENG 193,A00,805288,Engler; Adam J.,0,0,0,0
1739699581091,BENG 196,A00,803380,Engler; Adam J.,9999,0,9999,0
1739699582120,BENG 197,A00,803381,Engler; Adam J.,9999,0,9999,0
1739699583150,BENG 203,A00,805307,Bafna; Vineet & Zhong; Sheng,20,0,20,0
1739699584183,BENG 207,A00,805308,Kwon; Ester Jihae,1,0,40,39
1739699584183,BENG 207,B00,805309,Taylor Amos; Alyssa C,0,0,30,30
1739699584183,BENG 207,C00,805310,Spang; Martin Thomas,15,0,40,25
1739699585212,BENG 209,A00,805311,Scholtes Acevedo; Claire,30,0,30,0
1739699586240,BENG 213,A00,805312,Palsson; Bernhard O.,16,0,20,4
1739699587265,BENG 224,A00,805313,Prado; Gustavo Rotelli,0,0,20,30
1739699588291,BENG 226,A01,805315,Staff,74,0,140,66
1739699589319,BENG 227,A00,805316,Fraley; Stephanie I.,42,0,120,78
1739699590347,BENG 230C,A00,805318,King; Kevin R,59,0,90,31
1739699591376,BENG 232,A01,805320,Sah; Robert Lie-Yuan,16,0,70,54
1739699592400,BENG 233,A00,805364,Shah; Sameer B,21,0,50,29
1739699593427,BENG 234,A00,805365,Silva; Gabriel,22,0,70,48
1739699594455,BENG 235,A00,805366,Bintu; Bogdan,18,0,40,22
1739699595484,BENG 276,A00,805367,Mc Culloch; Andrew Douglas,0,0,0,0
1739699596514,BENG 280C,A01,805370,McVeigh; Elliot R.,37,0,56,19
1739699597541,BENG 281,A00,805371,Smarr; Benjamin,40,0,110,70
1739699598571,BENG 283,A00,805372,Ghassemian; Majid & Sanchez Roige; Alexandra & Chavez; Alejandro,5,0,5,0
1739699599597,BENG 285,A00,805374,Alexandrov; Ludmil B,8,0,8,0
1739699600623,BENG 292,A01,805387,Ross; Camille,20,0,20,0
1739699601651,BENG 294C,A00,805396,Engler; Adam J.,0,0,0,0
1739699602677,BENG 295,A00,803924,Watson; John Thomas,9999,0,9999,0
1739699603702,BGGN 205,A00,851551,Daugherty; Matthew Dorton,53,0,60,7
1739699604727,BGGN 207,A01,851553,Ross; Camille,0,0,0,0
1739699605751,BGGN 215,A00,851554,Petrie; Katherine Lynn,0,0,30,30
1739699606781,BGGN 232,A00,851556,Briggs; Steven & Troemel; Emily Ruth,0,0,30,30
1739699607806,BGGN 239,A01,851558,Kronenberg; Mitchell E.,22,0,30,8
1739699608830,BGGN 240,A01,851560,Aoi; Mikio C,1,0,5,4
1739699608830,BGGN 240,A02,851561,Aoi; Mikio C,5,0,5,0
1739699608830,BGGN 240,A03,851562,Aoi; Mikio C,2,0,5,3
1739699608830,BGGN 240,A04,851564,Aoi; Mikio C,4,0,5,1
1739699609856,BGGN 249C,A00,851566,Miller; Cory T.,0,0,0,0
1739699610886,BGGN 255,A00,851567,Root; Cory Matthew,9,0,30,21
1739699611913,BGGN 267,A01,851569,Benna; Marcus K & Aljadeff; Johnatan,0,0,2,2
1739699611913,BGGN 267,A02,851570,Benna; Marcus K & Aljadeff; Johnatan,2,0,2,0
1739699611913,BGGN 267,A03,851571,Benna; Marcus K & Aljadeff; Johnatan,1,0,1,0
1739699611913,BGGN 267,A04,851572,Benna; Marcus K & Aljadeff; Johnatan,1,0,1,0
1739699612951,BGGN 271,001,881551,Ackerman; Susan,9999,0,9999,0
1739699612951,BGGN 271,002,881552,Akbari; Omar Sultan,9997,0,9999,2
1739699612951,BGGN 271,003,881553,Allen; Nicola J,9998,0,9999,1
1739699612951,BGGN 271,004,881554,Alperin; Mariann,9998,0,9999,1
1739699612951,BGGN 271,005,881555,Antal; Corina Elena,9999,0,9999,0
1739699612951,BGGN 271,006,881561,Boss; Gerard R.,9998,0,9999,1
1739699612951,BGGN 271,007,881562,Bouvet; Michael,9999,0,9999,0
1739699612951,BGGN 271,008,881563,Breen; Ellen C.,9999,0,9999,0
1739699612951,BGGN 271,009,881564,Bui; Jack D,9999,0,9999,0
1739699612951,BGGN 271,010,881565,Burnett; Lindsey,9998,0,9999,1
1739699612951,BGGN 271,011,881566,Caffrey; Conor,9998,0,9999,1
1739699612951,BGGN 271,012,881567,Castle; Michael James,9998,0,9999,1
1739699612951,BGGN 271,013,881568,Chang; John Tzu-yu,9999,0,9999,0
1739699612951,BGGN 271,014,881569,Cheng; Christine Shiang-Ling,9999,0,9999,0
1739699612951,BGGN 271,015,881612,Cheresh; David A.,9997,0,9999,2
1739699612951,BGGN 271,016,881616,Cherqui; Stephanie,9999,0,9999,0
1739699612951,BGGN 271,017,881620,Chu; Hiutung,9998,0,9999,1
1739699612951,BGGN 271,018,881627,Church; Kellie Breen,9999,0,9999,0
1739699612951,BGGN 271,019,881637,Cleland; Elsa Eleanor,9998,0,9999,1
1739699612951,BGGN 271,020,881638,Croker; Ben Adam,9999,0,9999,0
1739699612951,BGGN 271,021,881639,Crotty Alexander; Laura E,9997,0,9999,2
1739699612951,BGGN 271,022,881640,Daugherty; Matthew Dorton,9999,0,9999,0
1739699612951,BGGN 271,023,881641,De Silva; Shermin,9998,0,9999,1
1739699612951,BGGN 271,024,881642,Dhar; Debanjan,9999,0,9999,0
1739699612951,BGGN 271,025,881643,Doherty; Taylor Alan,9998,0,9999,1
1739699612951,BGGN 271,026,881644,Dore; Kim Bohemie,9998,0,9999,1
1739699612951,BGGN 271,027,881645,Dulawa; Stephanie Carole,9999,0,9999,0
1739699612951,BGGN 271,028,881646,Farley; Emma Kristen,9998,0,9999,1
1739699612951,BGGN 271,029,881647,Feng; Gen-Sheng,9998,0,9999,1
1739699612951,BGGN 271,030,881648,Fisch; Kathleen Marie,9995,0,9999,4
1739699612951,BGGN 271,031,881649,George; Olivier,9998,0,9999,1
1739699612951,BGGN 271,032,881650,Ghosh; Pradipta,9998,0,9999,1
1739699612951,BGGN 271,033,881651,Glasgow; Stacey Marie,9997,0,9999,2
1739699612951,BGGN 271,034,881652,Golden; James W,9999,0,9999,0
1739699612951,BGGN 271,035,881653,Gonzalez Gamboa; Ivonne,9999,0,9999,0
1739699612951,BGGN 271,036,881654,Goren; Alon M,9999,0,9999,0
1739699612951,BGGN 271,037,881655,Guatelli; John C,9998,0,9999,1
1739699612951,BGGN 271,038,881656,Guma; Monica,9999,0,9999,0
1739699612951,BGGN 271,039,881657,Gustafsson; Asa Birgitta,9998,0,9999,1
1739699612951,BGGN 271,040,881658,Hamdoun; Amr,9999,0,9999,0
1739699612951,BGGN 271,041,881659,Hao; Nan,9999,0,9999,0
1739699612951,BGGN 271,042,881660,Hasty; Jeff M,9998,0,9999,1
1739699612951,BGGN 271,043,881661,Jiang; Qingfei,9999,0,9999,0
1739699612951,BGGN 271,044,881664,Jin; Yishi,9998,0,9999,1
1739699612951,BGGN 271,045,881665,Joiner; William J.,9999,0,9999,0
1739699612951,BGGN 271,046,881666,Joshi; Shweta,9998,0,9999,1
1739699612951,BGGN 271,047,881667,Ju; Won-Kyu,9998,0,9999,1
1739699612951,BGGN 271,048,881668,Jun; Suckjoon,9999,0,9999,0
1739699612951,BGGN 271,049,881669,Kaech; Susan Michelle,9999,0,9999,0
1739699612951,BGGN 271,050,881670,Kauffman; Alexander,9997,0,9999,2
1739699612951,BGGN 271,051,881672,Koloski; Miranda Jane,9998,0,9999,1
1739699612951,BGGN 271,052,881673,Komiyama; Takaki,9998,0,9999,1
1739699612951,BGGN 271,053,881674,Kronenberg; Mitchell E.,9999,0,9999,0
1739699612951,BGGN 271,054,881675,Kufareva; Irina,9998,0,9999,1
1739699612951,BGGN 271,055,881676,Lee; Yun Sok,9999,0,9999,0
1739699612951,BGGN 271,056,881677,Leutgeb; Stefan,9999,0,9999,0
1739699612951,BGGN 271,057,881678,Li; Willis Xiaowei,9998,0,9999,1
1739699612951,BGGN 271,058,881679,Lim; Byungkook,9999,0,9999,0
1739699612951,BGGN 271,059,881680,Lo; Stanley M.,9998,0,9999,1
1739699612951,BGGN 271,060,881681,Lopez Ramirez; Miguel Alej,9999,0,9999,0
1739699612951,BGGN 271,061,881740,Lu; Li-Fan,9999,0,9999,0
1739699612951,BGGN 271,062,881741,Lu; Pengzhe,9998,0,9999,1
1739699612951,BGGN 271,063,881743,Lyons; Deirdre Colleen,9998,0,9999,1
1739699612951,BGGN 271,064,881744,Lyumkis; Dmitry Evgenievich,9999,0,9999,0
1739699612951,BGGN 271,065,881746,McConville; Patrick James,9999,0,9999,0
1739699612951,BGGN 271,066,881749,Mertens; Jerome Stefan,9997,0,9999,2
1739699612951,BGGN 271,067,881751,Morris; Gerald P,9999,0,9999,0
1739699612951,BGGN 271,068,881752,Muroyama; Andrew David,9999,0,9999,0
1739699612951,BGGN 271,069,881757,Murre; Cornelis,9999,0,9999,0
1739699612951,BGGN 271,070,881758,Nieh; James Charles,9997,0,9999,2
1739699612951,BGGN 271,071,881759,Niwa; Maho,9999,0,9999,0
1739699612951,BGGN 271,072,881760,Parast; Mana,9999,0,9999,0
1739699612951,BGGN 271,073,881761,Perry; Michael William,9999,0,9999,0
1739699612951,BGGN 271,074,881762,Pillus; Lorraine,9998,0,9999,1
1739699612951,BGGN 271,075,881765,Pogliano; Joseph,9998,0,9999,1
1739699612951,BGGN 271,076,881767,Pruneda-Paz; Jose L.,9999,0,9999,0
1739699612951,BGGN 271,077,881768,Rana; Tariq,9999,0,9999,0
1739699612951,BGGN 271,078,881769,Rao; Anjana,9999,0,9999,0
1739699612951,BGGN 271,079,881771,Raz; Eyal,9998,0,9999,1
1739699612951,BGGN 271,080,881772,Ren; Bing,9999,0,9999,0
1739699612951,BGGN 271,081,881775,Rifkin; Scott,9998,0,9999,1
1739699612951,BGGN 271,082,881777,Risbrough; Victoria Blythe,9999,0,9999,0
1739699612951,BGGN 271,083,881778,Rose; Noah Hartmann,9999,0,9999,0
1739699612951,BGGN 271,084,881779,Saier; Milton H.,9998,0,9999,1
1739699612951,BGGN 271,085,881781,Saltiel; Alan,9997,0,9999,2
1739699612951,BGGN 271,086,881782,Sanchez-Lopez; Elsa,9998,0,9999,1
1739699612951,BGGN 271,087,881784,Schroeder; Julian I,9999,0,9999,0
1739699612951,BGGN 271,088,881794,Sebat; Lilia Mikhailovna,9998,0,9999,1
1739699612951,BGGN 271,089,881796,Sen; George L,9999,0,9999,0
1739699612951,BGGN 271,090,881797,Shaner; Nathan C.,9999,0,9999,0
1739699612951,BGGN 271,091,881804,Shurin; Jonathan,9998,0,9999,1
1739699612951,BGGN 271,092,881819,Sicklick; Jason Keith,9999,0,9999,0
1739699612951,BGGN 271,093,881908,Signer; Robert,9999,0,9999,0
1739699612951,BGGN 271,094,881909,Simonson; Tatum Sasha Summ,9999,0,9999,0
1739699612951,BGGN 271,095,881923,Steinmetz; Nicole F,9999,0,9999,0
1739699612951,BGGN 271,096,881924,Su; Chih-Ying,9999,0,9999,0
1739699612951,BGGN 271,097,881936,Telese; Francesca,9999,0,9999,0
1739699612951,BGGN 271,098,881955,Towers; Christina Garlingt,9998,0,9999,1
1739699612951,BGGN 271,099,881956,Wahlin; Karl Jonas,9997,0,9999,2
1739699612951,BGGN 271,100,882046,Webster; Nicholas J G,9998,0,9999,1
1739699612951,BGGN 271,101,882047,Weiskopf; Daniela,9999,0,9999,0
1739699612951,BGGN 271,102,882130,Welsbie; Derek,9999,0,9999,0
1739699612951,BGGN 271,103,882167,Wildonger; Jill Cathleen,9999,0,9999,0
1739699612951,BGGN 271,104,882168,Yeo; Eugene Wei-Ming,9998,0,9999,1
1739699612951,BGGN 271,105,882175,Ying; Wei,9998,0,9999,1
1739699612951,BGGN 271,106,882196,Young; Jared W.,9998,0,9999,1
1739699612951,BGGN 271,107,882235,Zage; Peter,9999,0,9999,0
1739699612951,BGGN 271,108,882236,Zengler; Karsten B,9999,0,9999,0
1739699612951,BGGN 271,109,882237,Zhang; Jin,9999,0,9999,0
1739699612951,BGGN 271,110,882238,Zhao; Yunde,9999,0,9999,0
1739699612951,BGGN 271,111,882239,Zheng; Ye,9998,0,9999,1
1739699612951,BGGN 271,112,882288,Zhou; Huilin,9999,0,9999,0
1739699612951,BGGN 271,113,882289,Zou; Yimin,9998,0,9999,1
1739699612951,BGGN 271,114,882290,Zuniga; Elina I,9999,0,9999,0
1739699613977,BGGN 273,A01,851574,Mueller; Liam O'Connor,13,0,50,37
1739699615003,BGGN 275,A00,851577,Flagg; Matthew Paul,0,0,0,5
1739699616030,BGGN 276,A00,851578,Flagg; Matthew Paul,0,0,0,5
1739699617059,BGGN 292,A00,851579,Shiau; Andrew K,35,0,35,0
1739699618084,BGGN 293,A00,851580,Wilhelm; James E.,0,0,0,5
1739699619113,BGGN 295,A00,851581,Juavinett; Ashley Lauren,0,0,30,30
1739699620139,BGJC 204,A00,851584,Lu; Li-Fan & Chang; John Tzu-yu,9991,0,9999,8
1739699621182,BGRD 200,001,883698,Ackerman; Susan,9999,0,9999,0
1739699621182,BGRD 200,002,883700,Akbari; Omar Sultan,9998,0,9999,1
1739699621182,BGRD 200,003,883710,Allen; Eric,9999,0,9999,0
1739699621182,BGRD 200,004,883736,Allen; Nicola J,9998,0,9999,1
1739699621182,BGRD 200,005,883737,Alperin; Mariann,9998,0,9999,1
1739699621182,BGRD 200,006,883765,Amaro; Rommie E,9999,0,9999,0
1739699621182,BGRD 200,007,883766,Antal; Corina Elena,9999,0,9999,0
1739699621182,BGRD 200,008,883827,Asahina; Kenta,9999,0,9999,0
1739699621182,BGRD 200,009,883879,Augustine; Vineet,9999,0,9999,0
1739699621182,BGRD 200,010,883881,Ayres; Janelle Samantha,9998,0,9999,1
1739699621182,BGRD 200,011,883883,Banghart; Matthew Ryan,9999,0,9999,0
1739699621182,BGRD 200,012,883884,Barton; Andrew David,9999,0,9999,0
1739699621182,BGRD 200,013,883886,Benna; Marcus K,9999,0,9999,0
1739699621182,BGRD 200,014,883887,Bennett; Eric J,9998,0,9999,1
1739699621182,BGRD 200,015,883888,Biering; Scott B,9999,0,9999,0
1739699621182,BGRD 200,016,883890,Bloodgood; Brenda Laurie,9999,0,9999,0
1739699621182,BGRD 200,017,883891,Boss; Gerard R.,9999,0,9999,0
1739699621182,BGRD 200,018,883893,Bouvet; Michael,9999,0,9999,0
1739699621182,BGRD 200,019,883894,Breen; Ellen C.,9999,0,9999,0
1739699621182,BGRD 200,020,883895,Briggs; Steven,9999,0,9999,0
1739699621182,BGRD 200,021,883896,Bui; Jack D,9999,0,9999,0
1739699621182,BGRD 200,022,883897,Burnett; Lindsey,9998,0,9999,1
1739699621182,BGRD 200,023,883899,Caffrey; Conor,9998,0,9999,1
1739699621182,BGRD 200,024,883908,Callaway; Edward M,9999,0,9999,0
1739699621182,BGRD 200,025,883911,Castle; Michael James,9999,0,9999,0
1739699621182,BGRD 200,026,883915,Chaim; Isaac,9998,0,9999,1
1739699621182,BGRD 200,027,883916,Chang; John Tzu-yu,9999,0,9999,0
1739699621182,BGRD 200,028,883917,Chen; Xu,9999,0,9999,0
1739699621182,BGRD 200,029,883919,Cheng; Christine Shiang-Ling,9999,0,9999,0
1739699621182,BGRD 200,030,883921,Cheresh; David A.,9997,0,9999,2
1739699621182,BGRD 200,031,883924,Cherqui; Stephanie,9999,0,9999,0
1739699621182,BGRD 200,032,883929,Chu; Hiutung,9998,0,9999,1
1739699621182,BGRD 200,033,883931,Church; Kellie Breen,9999,0,9999,0
1739699621182,BGRD 200,034,883933,Cleland; Elsa Eleanor,9998,0,9999,1
1739699621182,BGRD 200,035,883934,Cooper; Kimberly Lynn,9999,0,9999,0
1739699621182,BGRD 200,036,883935,Coufal; Nicole Gabriele,9999,0,9999,0
1739699621182,BGRD 200,037,883938,Croker; Ben Adam,9999,0,9999,0
1739699621182,BGRD 200,038,883939,Crotty Alexander; Laura E,9997,0,9999,2
1739699621182,BGRD 200,039,883940,Daugherty; Matthew Dorton,9999,0,9999,0
1739699621182,BGRD 200,040,883941,De Silva; Shermin,9998,0,9999,1
1739699621182,BGRD 200,041,883946,Desai; Arshad,9999,0,9999,0
1739699621182,BGRD 200,042,883949,Dhar; Debanjan,9999,0,9999,0
1739699621182,BGRD 200,043,883993,Dickinson; Alexandra Jazz,9999,0,9999,0
1739699621182,BGRD 200,044,884003,Dixon; Jesse,9999,0,9999,0
1739699621182,BGRD 200,045,884008,Doherty; Taylor Alan,9998,0,9999,1
1739699621182,BGRD 200,046,884028,Dore; Kim Bohemie,9998,0,9999,1
1739699621182,BGRD 200,047,884082,Dulawa; Stephanie Carole,9999,0,9999,0
1739699621182,BGRD 200,048,884084,Ecker; Joseph R,9999,0,9999,0
1739699621182,BGRD 200,049,884107,Engle; Dannielle D,9999,0,9999,0
1739699621182,BGRD 200,050,884337,Ernst; Andreas,9999,0,9999,0
1739699621182,BGRD 200,051,884338,Esko; Jeffrey D.,9999,0,9999,0
1739699621182,BGRD 200,052,884339,Farley; Emma Kristen,9998,0,9999,1
1739699621182,BGRD 200,053,884340,Feldstein; Ariel E,9999,0,9999,0
1739699621182,BGRD 200,054,884341,Feng; Gen-Sheng,9998,0,9999,1
1739699621182,BGRD 200,055,884342,Fisch; Kathleen Marie,9995,0,9999,4
1739699621182,BGRD 200,056,884343,Friedman; Rick Adam,9999,0,9999,0
1739699621182,BGRD 200,057,884344,Furnari; Frank,9999,0,9999,0
1739699621182,BGRD 200,058,884345,Gage; Fred H,9999,0,9999,0
1739699621182,BGRD 200,059,884346,George; Olivier,9998,0,9999,1
1739699621182,BGRD 200,060,884347,Ghosh; Pradipta,9998,0,9999,1
1739699621182,BGRD 200,061,884348,Glasgow; Stacey Marie,9997,0,9999,2
1739699621182,BGRD 200,062,884349,Glass; Christopher,9999,0,9999,0
1739699621182,BGRD 200,063,884350,Golden; James W,9999,0,9999,0
1739699621182,BGRD 200,064,884352,Golden; Susan S.,9999,0,9999,0
1739699621182,BGRD 200,065,884354,Gonzalez Gamboa; Ivonne,9999,0,9999,0
1739699621182,BGRD 200,066,884355,Goren; Alon M,9999,0,9999,0
1739699621182,BGRD 200,067,884356,Guatelli; John C,9998,0,9999,1
1739699621182,BGRD 200,068,884357,Guma; Monica,9999,0,9999,0
1739699621182,BGRD 200,069,884360,Gustafsson; Asa Birgitta,9998,0,9999,1
1739699621182,BGRD 200,070,884361,Gutkind; Jorge Silvio,9999,0,9999,0
1739699621182,BGRD 200,071,884362,Hamdoun; Amr,9999,0,9999,0
1739699621182,BGRD 200,072,884364,Hampton; Randolph Y.,9999,0,9999,0
1739699621182,BGRD 200,073,884367,Hao; Nan,9999,0,9999,0
1739699621182,BGRD 200,074,884368,Hargreaves; Diana Clare,9999,0,9999,0
1739699621182,BGRD 200,075,884369,Hasty; Jeff M,9998,0,9999,1
1739699621182,BGRD 200,076,884370,Hollern; Daniel Patrick,9999,0,9999,0
1739699621182,BGRD 200,077,884372,Holway; David A.,9999,0,9999,0
1739699621182,BGRD 200,078,884374,Huffaker; Alisa,9999,0,9999,0
1739699621182,BGRD 200,079,884375,Hui; Enfu,9999,0,9999,0
1739699621182,BGRD 200,080,884376,Hwa; Terence T.,9999,0,9999,0
1739699621182,BGRD 200,081,884377,Ideker; Trey,9999,0,9999,0
1739699621182,BGRD 200,082,884378,Jackrel; Sara,9998,0,9999,1
1739699621182,BGRD 200,083,884380,Jiang; Qingfei,9999,0,9999,0
1739699621182,BGRD 200,084,884382,Jin; Yishi,9998,0,9999,1
1739699621182,BGRD 200,085,884384,Joiner; William J.,9999,0,9999,0
1739699621182,BGRD 200,086,884385,Joshi; Shweta,9998,0,9999,1
1739699621182,BGRD 200,087,884386,Ju; Won-Kyu,9998,0,9999,1
1739699621182,BGRD 200,088,884387,Jun; Suckjoon,9999,0,9999,0
1739699621182,BGRD 200,089,884388,Kadonaga; James T,9999,0,9999,0
1739699621182,BGRD 200,090,884389,Kaech; Susan Michelle,9999,0,9999,0
1739699621182,BGRD 200,091,884391,Kauffman; Alexander,9997,0,9999,2
1739699621182,BGRD 200,092,884392,Kleinfeld; David,9999,0,9999,0
1739699621182,BGRD 200,093,884393,Knight; Robin,9999,0,9999,0
1739699621182,BGRD 200,094,884394,Koloski; Miranda Jane,9998,0,9999,1
1739699621182,BGRD 200,095,884395,Komiyama; Takaki,9998,0,9999,1
1739699621182,BGRD 200,096,884396,Kosuri; Pallav,9999,0,9999,0
1739699621182,BGRD 200,097,884397,Kronenberg; Mitchell E.,9999,0,9999,0
1739699621182,BGRD 200,099,884400,Kryazhimskiy; Sergey A,9999,0,9999,0
1739699621182,BGRD 200,100,884401,Kufareva; Irina,9998,0,9999,1
1739699621182,BGRD 200,101,884402,Lee; Kuo Fen,9999,0,9999,0
1739699621182,BGRD 200,102,884403,Lee; Yun Sok,9999,0,9999,0
1739699621182,BGRD 200,103,884404,Leutgeb; Jill K.,9999,0,9999,0
1739699621182,BGRD 200,104,884405,Leutgeb; Stefan,9999,0,9999,0
1739699621182,BGRD 200,105,884406,Li; Willis Xiaowei,9998,0,9999,1
1739699621182,BGRD 200,106,884407,Lim; Byungkook,9998,0,9999,1
1739699621182,BGRD 200,107,884410,Lo; Stanley M.,9998,0,9999,1
1739699621182,BGRD 200,108,884414,Looger; Loren Lee,9999,0,9999,0
1739699621182,BGRD 200,109,884415,Lopez Ramirez; Miguel Alej,9999,0,9999,0
1739699621182,BGRD 200,110,884416,Lovett-Barron; Matthew Rod,9999,0,9999,0
1739699621182,BGRD 200,111,884418,Lu; Li-Fan,9998,0,9999,1
1739699621182,BGRD 200,112,884419,Lu; Pengzhe,9998,0,9999,1
1739699621182,BGRD 200,113,884421,Lykke-Andersen; Jens,9999,0,9999,0
1739699621182,BGRD 200,114,884423,Lyons; Deirdre Colleen,9998,0,9999,1
1739699621182,BGRD 200,115,884424,Lyumkis; Dmitry Evgenievich,9999,0,9999,0
1739699621182,BGRD 200,116,884425,Manor; Uri,9999,0,9999,0
1739699621182,BGRD 200,117,884426,Mayfield; Stephen P.,9998,0,9999,1
1739699621182,BGRD 200,118,884427,McConville; Patrick James,9999,0,9999,0
1739699621182,BGRD 200,119,884428,McDonnell; Lisa Marie,9999,0,9999,0
1739699621182,BGRD 200,120,884429,Mertens; Jerome Stefan,9997,0,9999,2
1739699621182,BGRD 200,121,884430,Meyer; Justin Raymond,9999,0,9999,0
1739699621182,BGRD 200,122,884431,Morris; Gerald P,9999,0,9999,0
1739699621182,BGRD 200,123,884432,Mueller; Lena,9999,0,9999,0
1739699621182,BGRD 200,124,884433,Muotri; Alysson,9999,0,9999,0
1739699621182,BGRD 200,125,884434,Muroyama; Andrew David,9997,0,9999,2
1739699621182,BGRD 200,126,884435,Murre; Cornelis,9999,0,9999,0
1739699621182,BGRD 200,127,884436,Neal; Sonya E,9999,0,9999,0
1739699621182,BGRD 200,128,884438,Nieh; James Charles,9997,0,9999,2
1739699621182,BGRD 200,129,884441,Nimmerjahn; Axel,9999,0,9999,0
1739699621182,BGRD 200,130,884444,Niwa; Maho,9999,0,9999,0
1739699621182,BGRD 200,131,884445,Nizet; Victor F.,9998,0,9999,1
1739699621182,BGRD 200,132,884446,Oegema; Karen,9999,0,9999,0
1739699621182,BGRD 200,133,884447,Panda; Satchidananda,9999,0,9999,0
1739699621182,BGRD 200,134,884448,Parast; Mana,9999,0,9999,0
1739699621182,BGRD 200,135,884449,Pasquinelli; Amy,9998,0,9999,1
1739699621182,BGRD 200,136,884450,Pekkurnaz Banghart; Gulcin,9999,0,9999,0
1739699621182,BGRD 200,137,884451,Perry; Michael William,9999,0,9999,0
1739699621182,BGRD 200,138,884452,Pillus; Lorraine,9998,0,9999,1
1739699621182,BGRD 200,139,884454,Pogliano; Joseph,9998,0,9999,1
1739699621182,BGRD 200,140,884456,Pogliano; Kit J.,9999,0,9999,0
1739699621182,BGRD 200,141,884457,Pride; David Tevis,9999,0,9999,0
1739699621182,BGRD 200,142,884458,Pruneda-Paz; Jose L.,9999,0,9999,0
1739699621182,BGRD 200,143,884459,Ramanan; Deepshika,9998,0,9999,1
1739699621182,BGRD 200,144,884460,Rana; Tariq,9999,0,9999,0
1739699621182,BGRD 200,145,884461,Rao; Anjana,9999,0,9999,0
1739699621182,BGRD 200,146,884462,Raz; Eyal,9998,0,9999,1
1739699621182,BGRD 200,147,884464,Reck-Peterson; Samara L,9999,0,9999,0
1739699621182,BGRD 200,148,884468,Ren; Bing,9999,0,9999,0
1739699621182,BGRD 200,149,884469,Rennison; Diana,9999,0,9999,0
1739699621182,BGRD 200,150,884471,Reyes De Barboza; Nabora S,9999,0,9999,0
1739699621182,BGRD 200,151,884472,Rifkin; Scott,9998,0,9999,1
1739699621182,BGRD 200,152,884482,Risbrough; Victoria Blythe,9999,0,9999,0
1739699621182,BGRD 200,153,884484,Rivera; Fabian Chavez,9999,0,9999,0
1739699621182,BGRD 200,154,884486,Rohner; Patrick Thomas,9999,0,9999,0
1739699621182,BGRD 200,155,884488,Rose; Noah Hartmann,9999,0,9999,0
1739699621182,BGRD 200,156,884491,Rosenfeld; Michael G,9999,0,9999,0
1739699621182,BGRD 200,157,884493,Russell; Alistair B,9999,0,9999,0
1739699621182,BGRD 200,158,884494,Saier; Milton H.,9998,0,9999,1
1739699621182,BGRD 200,159,884496,Saltiel; Alan,9997,0,9999,2
1739699621182,BGRD 200,160,884498,Sanchez-Lopez; Elsa,9999,0,9999,0
1739699621182,BGRD 200,161,884502,Saphire; Erica Ollmann,9999,0,9999,0
1739699621182,BGRD 200,162,884504,Schroeder; Julian I,9999,0,9999,0
1739699621182,BGRD 200,163,884508,Sebat; Lilia Mikhailovna,9998,0,9999,1
1739699621182,BGRD 200,164,884510,Sen; George L,9999,0,9999,0
1739699621182,BGRD 200,165,884513,Shah; Sameer B,9999,0,9999,0
1739699621182,BGRD 200,166,884515,Shaner; Nathan C.,9999,0,9999,0
1739699621182,BGRD 200,167,884517,Sharpee; Tatyana,9999,0,9999,0
1739699621182,BGRD 200,168,884519,Shaw; Reuben,9998,0,9999,1
1739699621182,BGRD 200,169,884522,Shurin; Jonathan,9998,0,9999,1
1739699621182,BGRD 200,170,884524,Sicklick; Jason Keith,9999,0,9999,0
1739699621182,BGRD 200,171,884526,Signer; Robert,9999,0,9999,0
1739699621182,BGRD 200,172,884530,Simonson; Tatum Sasha Summ,9999,0,9999,0
1739699621182,BGRD 200,173,884533,Soncin; Francesca,9999,0,9999,0
1739699621182,BGRD 200,174,884535,Steinmetz; Nicole F,9999,0,9999,0
1739699621182,BGRD 200,175,884536,Su; Chih-Ying,9999,0,9999,0
1739699621182,BGRD 200,176,884537,Suel; Gurol Mehmet,9999,0,9999,0
1739699621182,BGRD 200,177,884538,Sun; Xin,9999,0,9999,0
1739699621182,BGRD 200,178,884540,Telese; Francesca,9999,0,9999,0
1739699621182,BGRD 200,179,884543,Towers; Christina Garlingt,9998,0,9999,1
1739699621182,BGRD 200,180,884544,Traver; David,9999,0,9999,0
1739699621182,BGRD 200,181,884545,Troemel; Emily Ruth,9999,0,9999,0
1739699621182,BGRD 200,182,884546,Valdez-Jasso; Daniela,9999,0,9999,0
1739699621182,BGRD 200,183,884549,Vijayanand; Pandurangan,9999,0,9999,0
1739699621182,BGRD 200,184,884552,Villa Rodriguez; Elizabeth,9999,0,9999,0
1739699621182,BGRD 200,185,884553,Wahlin; Karl Jonas,9997,0,9999,2
1739699621182,BGRD 200,186,884555,Wang; Jean Yin Jen,9998,0,9999,1
1739699621182,BGRD 200,187,884556,Webster; Nicholas J G,9998,0,9999,1
1739699621182,BGRD 200,188,884557,Welsbie; Derek,9999,0,9999,0
1739699621182,BGRD 200,189,884600,Wildonger; Jill Cathleen,9998,0,9999,1
1739699621182,BGRD 200,190,884644,Winzeler; Elizabeth A,9998,0,9999,1
1739699621182,BGRD 200,191,884686,Yaksh; Tony L.,9999,0,9999,0
1739699621182,BGRD 200,192,884695,Yelon; Deborah,9999,0,9999,0
1739699621182,BGRD 200,193,884698,Yeo; Eugene Wei-Ming,9998,0,9999,1
1739699621182,BGRD 200,194,884706,Ying; Wei,9998,0,9999,1
1739699621182,BGRD 200,195,884707,Young; Jared W.,9998,0,9999,1
1739699621182,BGRD 200,196,884737,Zage; Peter,9999,0,9999,0
1739699621182,BGRD 200,197,884740,Zengler; Karsten B,9999,0,9999,0
1739699621182,BGRD 200,198,884749,Zhang; Dong-Er,9999,0,9999,0
1739699621182,BGRD 200,199,884750,Zhang; Jin,9999,0,9999,0
1739699621182,BGRD 200,200,884751,Zhao; Yunde,9999,0,9999,0
1739699621182,BGRD 200,201,884766,Zheng; Binhai,9999,0,9999,0
1739699621182,BGRD 200,202,884774,Zheng; Ye,9998,0,9999,1
1739699621182,BGRD 200,203,884849,Zhou; Huilin,9999,0,9999,0
1739699621182,BGRD 200,204,884894,Zou; Yimin,9998,0,9999,1
1739699621182,BGRD 200,205,884895,Zuniga; Elina I,9999,0,9999,0
1739699622210,BGSE 200,A00,851586,Tour; Ella & Petrie; Katherine Lynn,9989,0,9999,10
1739699623236,BGSE 205,A00,851588,Bennett; Eric J,46,0,50,4
1739699623236,BGSE 205,C00,851589,Bennett; Eric J,43,0,50,7
1739699623236,BGSE 205,D00,851590,Bennett; Eric J,48,0,50,2
1739699623236,BGSE 205,E00,851591,Bennett; Eric J,49,0,50,1
1739699624261,BIBC 102,A01,864157,Hampton; Randolph Y.,48,0,73,25
1739699624261,BIBC 102,A02,864159,Hampton; Randolph Y.,66,0,73,7
1739699624261,BIBC 102,A03,864171,Hampton; Randolph Y.,69,0,73,4
1739699624261,BIBC 102,A04,864227,Hampton; Randolph Y.,63,0,73,10
1739699625289,BIBC 103,A01,850483,Coleman; Aaron B.,19,0,24,5
1739699625289,BIBC 103,A02,850484,Coleman; Aaron B.,24,0,24,0
1739699625289,BIBC 103,B01,850487,Coleman; Aaron B.,21,0,24,3
1739699625289,BIBC 103,B02,850489,Coleman; Aaron B.,24,0,24,0
1739699625289,BIBC 103,C01,850492,Burg; Michael,15,0,24,9
1739699625289,BIBC 103,C02,850493,Burg; Michael,23,0,24,1
1739699626319,BIBC 104,A01,850495,Zhao; Yunde,49,0,50,1
1739699626319,BIBC 104,A02,850496,Zhao; Yunde,50,0,50,0
1739699626319,BIBC 104,A03,850500,Zhao; Yunde,48,0,50,2
1739699626319,BIBC 104,A04,850501,Zhao; Yunde,48,0,50,2
1739699627345,BIBC 194,A00,850502,Ernst; Andreas,20,0,32,12
1739699627345,BIBC 194,B00,850503,Saier; Milton H.,21,0,32,11
1739699628373,BICD 100,A01,864248,Biering; Scott B,70,0,73,3
1739699628373,BICD 100,A02,864249,Biering; Scott B,72,0,73,1
1739699628373,BICD 100,A03,864274,Biering; Scott B,73,0,73,0
1739699628373,BICD 100,A04,864287,Biering; Scott B,70,0,73,3
1739699628373,BICD 100,B01,864290,Reinagel; Pam,70,0,73,3
1739699628373,BICD 100,B02,864291,Reinagel; Pam,72,0,73,1
1739699628373,BICD 100,B03,864294,Reinagel; Pam,72,0,73,1
1739699628373,BICD 100,B04,864299,Reinagel; Pam,73,0,73,0
1739699628373,BICD 100,C01,864303,Nguyen; Vu Quang,72,0,73,1
1739699628373,BICD 100,C02,864314,Nguyen; Vu Quang,71,0,73,2
1739699628373,BICD 100,C03,864347,Nguyen; Vu Quang,72,0,73,1
1739699628373,BICD 100,C04,864362,Nguyen; Vu Quang,73,0,73,0
1739699629402,BICD 110,A01,850512,Ernst; Andreas,42,0,73,31
1739699629402,BICD 110,A02,850513,Ernst; Andreas,53,0,73,20
1739699629402,BICD 110,A03,850516,Ernst; Andreas,61,0,73,12
1739699629402,BICD 110,A04,850518,Ernst; Andreas,53,0,73,20
1739699630430,BICD 123,A01,850521,Zhao; Yunde,29,0,36,7
1739699631458,BICD 140,A01,850561,Lu; Li-Fan,50,0,61,11
1739699631458,BICD 140,A02,850563,Lu; Li-Fan,57,0,61,4
1739699631458,BICD 140,A03,850569,Lu; Li-Fan,57,0,61,4
1739699631458,BICD 140,A04,850577,Lu; Li-Fan,60,0,62,2
1739699632499,BICD 158,A01,850601,Bier; Ethan,30,0,36,6
1739699632499,BICD 158,A02,850644,Bier; Ethan,32,0,36,4
1739699632499,BICD 158,A03,850655,Bier; Ethan,33,0,36,3
1739699632499,BICD 158,A04,850656,Bier; Ethan,36,0,37,1
1739699633530,BIEB 121,A00,850668,Butler; Shannon Rhey,25,0,32,7
1739699633530,BIEB 121,B00,850674,Butler; Shannon Rhey,21,0,32,11
1739699634556,BIEB 146,A01,850680,Petrie; Katherine Lynn,91,0,99,8
1739699634556,BIEB 146,A02,850682,Petrie; Katherine Lynn,81,0,99,18
1739699634556,BIEB 146,A03,850684,Petrie; Katherine Lynn,95,0,99,4
1739699634556,BIEB 146,A04,850687,Petrie; Katherine Lynn,94,0,98,4
1739699635585,BIEB 148,A01,850691,Rose; Noah Hartmann,25,0,36,11
1739699635585,BIEB 148,A02,850706,Rose; Noah Hartmann,34,0,36,2
1739699635585,BIEB 148,A03,850778,Rose; Noah Hartmann,34,0,36,2
1739699635585,BIEB 148,A04,850779,Rose; Noah Hartmann,26,0,36,10
1739699636610,BIEB 152,A01,850784,Wodarz; Dominik Franz Xave,70,0,75,5
1739699636610,BIEB 152,A02,850785,Wodarz; Dominik Franz Xave,73,0,75,2
1739699636610,BIEB 152,A03,850786,Wodarz; Dominik Franz Xave,69,0,75,6
1739699636610,BIEB 152,A04,850789,Wodarz; Dominik Franz Xave,68,0,75,7
1739699637656,BIEB 154,A01,850792,Stockwell; Sarah R,15,0,15,0
1739699637656,BIEB 154,A02,850795,Stockwell; Sarah R,15,0,15,0
1739699637656,BIEB 154,A03,850796,Stockwell; Sarah R,13,0,15,2
1739699637656,BIEB 154,A04,850854,Stockwell; Sarah R,15,0,15,0
1739699638681,BIEB 159,A00,850856,Jackrel; Sara,33,0,36,3
1739699639713,BIEB 164,A01,850859,De Silva; Shermin,47,0,50,3
1739699639713,BIEB 164,A02,850862,De Silva; Shermin,42,0,50,8
1739699639713,BIEB 164,A03,850863,De Silva; Shermin,45,0,50,5
1739699639713,BIEB 164,A04,850865,De Silva; Shermin,45,0,50,5
1739699640745,BILD 1,A01,860138,Patrick; Gentry,62,0,62,0
1739699640745,BILD 1,A02,860253,Patrick; Gentry,61,0,62,1
1739699640745,BILD 1,A03,860277,Patrick; Gentry,61,0,62,1
1739699640745,BILD 1,A04,860281,Patrick; Gentry,61,0,64,3
1739699640745,BILD 1,B01,860381,Gonzalez Gamboa; Ivonne,51,0,62,11
1739699640745,BILD 1,B02,860382,Gonzalez Gamboa; Ivonne,61,0,62,1
1739699640745,BILD 1,B03,860383,Gonzalez Gamboa; Ivonne,59,0,62,3
1739699640745,BILD 1,B04,860384,Gonzalez Gamboa; Ivonne,63,0,64,1
1739699640745,BILD 1,C01,860385,Cooper; Andrew Michael,61,0,62,1
1739699640745,BILD 1,C02,860386,Cooper; Andrew Michael,59,0,62,3
1739699640745,BILD 1,C03,860387,Cooper; Andrew Michael,62,0,62,0
1739699640745,BILD 1,C04,860388,Cooper; Andrew Michael,64,0,64,0
1739699641772,BILD 2,A01,860389,Reyes Gonzalez; Catalina,87,0,99,12
1739699641772,BILD 2,A02,860390,Reyes Gonzalez; Catalina,96,0,99,3
1739699641772,BILD 2,A03,860391,Reyes Gonzalez; Catalina,99,0,99,0
1739699641772,BILD 2,A04,860392,Reyes Gonzalez; Catalina,98,0,98,0
1739699642799,BILD 3,A01,860393,Stockwell; Sarah R,68,0,70,2
1739699642799,BILD 3,A02,860394,Stockwell; Sarah R,66,0,70,4
1739699642799,BILD 3,A03,860395,Stockwell; Sarah R,69,0,70,1
1739699642799,BILD 3,A04,860396,Stockwell; Sarah R,66,0,68,2
1739699642799,BILD 3,B01,860397,Hammond; LaTisha Marie,48,0,63,15
1739699642799,BILD 3,B02,860398,Hammond; LaTisha Marie,54,0,60,6
1739699642799,BILD 3,B03,860399,Hammond; LaTisha Marie,57,0,60,3
1739699642799,BILD 3,B04,860400,Hammond; LaTisha Marie,60,0,62,2
1739699642799,BILD 3,C01,860401,Hammond; LaTisha Marie,60,0,62,2
1739699642799,BILD 3,C02,860402,Hammond; LaTisha Marie,58,0,63,5
1739699642799,BILD 3,C03,860403,Hammond; LaTisha Marie,59,0,60,1
1739699642799,BILD 3,C04,860404,Hammond; LaTisha Marie,60,0,60,0
1739699643828,BILD 4,A01,850172,Ochoa Mikrut; Stacy Daniel,22,0,24,2
1739699643828,BILD 4,A02,850250,Ochoa Mikrut; Stacy Daniel,24,0,24,0
1739699643828,BILD 4,A03,850251,Ochoa Mikrut; Stacy Daniel,22,0,24,2
1739699643828,BILD 4,A04,850252,Ochoa Mikrut; Stacy Daniel,23,0,24,1
1739699643828,BILD 4,A05,850253,Ochoa Mikrut; Stacy Daniel,24,0,24,0
1739699643828,BILD 4,A06,850254,Ochoa Mikrut; Stacy Daniel,24,0,24,0
1739699643828,BILD 4,A07,850255,Ochoa Mikrut; Stacy Daniel,24,0,24,0
1739699643828,BILD 4,A08,850257,Ochoa Mikrut; Stacy Daniel,23,0,24,1
1739699643828,BILD 4,B01,850259,Reuther; Keefe,18,0,24,6
1739699643828,BILD 4,B02,850260,Reuther; Keefe,22,0,24,2
1739699643828,BILD 4,B03,850261,Reuther; Keefe,24,0,24,0
1739699643828,BILD 4,B04,850263,Reuther; Keefe,22,0,24,2
1739699643828,BILD 4,B05,850264,Reuther; Keefe,23,0,24,1
1739699643828,BILD 4,B06,850265,Reuther; Keefe,24,0,24,0
1739699643828,BILD 4,B07,850266,Reuther; Keefe,24,0,24,0
1739699643828,BILD 4,B08,850267,Reuther; Keefe,24,0,24,0
1739699643828,BILD 4,C01,850269,Gonzalez Gamboa; Ivonne,19,0,24,5
1739699643828,BILD 4,C02,850270,Gonzalez Gamboa; Ivonne,24,0,24,0
1739699643828,BILD 4,C03,850271,Gonzalez Gamboa; Ivonne,24,0,24,0
1739699643828,BILD 4,C04,850273,Gonzalez Gamboa; Ivonne,24,0,24,0
1739699643828,BILD 4,C05,850283,Gonzalez Gamboa; Ivonne,23,0,24,1
1739699643828,BILD 4,C06,850329,Gonzalez Gamboa; Ivonne,23,0,24,1
1739699643828,BILD 4,C07,850331,Gonzalez Gamboa; Ivonne,24,0,24,0
1739699643828,BILD 4,C08,850336,Gonzalez Gamboa; Ivonne,23,0,24,1
1739699644856,BILD 5,A01,860586,Reuther; Keefe,63,0,65,2
1739699644856,BILD 5,A02,860597,Reuther; Keefe,62,0,65,3
1739699644856,BILD 5,A03,860600,Reuther; Keefe,65,0,65,0
1739699644856,BILD 5,A04,860672,Reuther; Keefe,64,0,65,1
1739699644856,BILD 5,B01,860673,Yang; Mingyu,65,0,65,0
1739699644856,BILD 5,B02,860681,Yang; Mingyu,64,0,65,1
1739699644856,BILD 5,B03,860686,Yang; Mingyu,65,0,65,0
1739699644856,BILD 5,B04,860687,Yang; Mingyu,65,0,65,0
1739699644856,BILD 5,C01,860694,Day; Christopher D,62,0,65,3
1739699644856,BILD 5,C02,860697,Day; Christopher D,65,0,65,0
1739699644856,BILD 5,C03,860709,Day; Christopher D,63,0,65,2
1739699644856,BILD 5,C04,860714,Day; Christopher D,65,0,65,0
1739699645884,BILD 30,A01,850343,Madigan; Cressida Ariana,28,0,28,0
1739699645884,BILD 30,A02,850344,Madigan; Cressida Ariana,28,0,28,0
1739699645884,BILD 30,A03,850345,Madigan; Cressida Ariana,26,0,28,2
1739699645884,BILD 30,A04,850349,Madigan; Cressida Ariana,30,0,31,1
1739699646910,BILD 88,A00,850480,Kurle; Carolyn M.,20,0,20,0
1739699647942,BIMM 100,A01,860726,Farley; Emma Kristen,35,0,48,13
1739699647942,BIMM 100,A02,860737,Farley; Emma Kristen,43,0,48,5
1739699647942,BIMM 100,A03,860771,Farley; Emma Kristen,46,0,48,2
1739699647942,BIMM 100,A04,860812,Farley; Emma Kristen,45,0,48,3
1739699647942,BIMM 100,B01,860817,Wildonger; Jill Cathleen,35,0,48,13
1739699647942,BIMM 100,B02,860838,Wildonger; Jill Cathleen,38,0,48,10
1739699647942,BIMM 100,B03,860839,Wildonger; Jill Cathleen,44,0,48,4
1739699647942,BIMM 100,B04,860840,Wildonger; Jill Cathleen,46,0,48,2
1739699648977,BIMM 101,A01,850871,Meaders; Clara Leigh,0,0,24,24
1739699648977,BIMM 101,A02,850872,Meaders; Clara Leigh,2,0,24,22
1739699648977,BIMM 101,B01,850876,Day; Christopher D,23,0,24,1
1739699648977,BIMM 101,B02,850877,Day; Christopher D,22,0,24,2
1739699648977,BIMM 101,C01,850880,Cooper; Andrew Michael,17,0,24,7
1739699648977,BIMM 101,C02,850887,Cooper; Andrew Michael,22,0,24,2
1739699648977,BIMM 101,D01,850890,Grossman; Emily N,19,0,24,5
1739699648977,BIMM 101,D02,850894,Grossman; Emily N,20,0,24,4
1739699648977,BIMM 101,E01,850897,Grossman; Emily N,19,0,24,5
1739699648977,BIMM 101,E02,850900,Grossman; Emily N,22,0,24,2
1739699648977,BIMM 101,F01,850906,Rusert; Jessica Marie,21,0,24,3
1739699648977,BIMM 101,F02,850910,Rusert; Jessica Marie,24,0,24,0
1739699648977,BIMM 101,G01,850920,Rusert; Jessica Marie,20,0,24,4
1739699648977,BIMM 101,G02,850921,Rusert; Jessica Marie,24,0,24,0
1739699650004,BIMM 118,A01,850923,David; Michael,26,0,29,3
1739699650004,BIMM 118,A02,850926,David; Michael,27,0,29,2
1739699650004,BIMM 118,A03,850927,David; Michael,25,0,29,4
1739699650004,BIMM 118,A04,850928,David; Michael,27,0,28,1
1739699651031,BIMM 120,A01,850932,Saier; Milton H.,78,0,87,9
1739699651031,BIMM 120,A02,850934,Saier; Milton H.,71,0,87,16
1739699651031,BIMM 120,A03,850986,Saier; Milton H.,81,0,87,6
1739699651031,BIMM 120,A04,851000,Saier; Milton H.,84,0,87,3
1739699652065,BIMM 121,A01,851020,Gustafson-Brown; Cindy,18,0,24,6
1739699652065,BIMM 121,A02,851023,Gustafson-Brown; Cindy,23,0,24,1
1739699652065,BIMM 121,B01,851032,Gustafson-Brown; Cindy,15,0,24,9
1739699652065,BIMM 121,B02,851058,Gustafson-Brown; Cindy,19,0,24,5
1739699652065,BIMM 121,C01,851077,Staff,2,0,24,22
1739699652065,BIMM 121,C02,851081,Staff,19,0,24,5
1739699652065,BIMM 121,D01,851152,Staff,15,0,24,9
1739699652065,BIMM 121,D02,851169,Staff,23,0,24,1
1739699653091,BIMM 134,A01,851210,Burg; Michael,95,0,103,8
1739699653091,BIMM 134,A02,851211,Burg; Michael,93,0,103,10
1739699653091,BIMM 134,A03,851212,Burg; Michael,93,0,103,10
1739699653091,BIMM 134,A04,851213,Burg; Michael,95,0,101,6
1739699654117,BIMM 143,A01,851215,Grant; Barry J,28,0,40,12
1739699654117,BIMM 143,B01,851218,Bozinovic; Goran,38,0,40,2
1739699654117,BIMM 143,C01,851220,Bozinovic; Goran,40,0,40,0
1739699655148,BIMM 182,A01,851597,Bafna; Vineet,31,0,50,19
1739699656174,BIMM 194,A00,851222,Russell; Alistair B,23,0,32,9
1739699657204,BIOM 202,A01,806511,Sheikh; Farah,21,0,40,19
1739699658230,BIOM 218,A00,806606,Gagneux; Pascal,10,0,12,2
1739699659256,BIOM 219,A00,806612,Ross; Camille,1,0,1,0
1739699660283,BIOM 222,A00,872553,Esko; Jeffrey D.,0,0,0,0
1739699661311,BIOM 229,A00,806613,Gagneux; Pascal,12,0,12,0
1739699662341,BIOM 231,A00,881485,Daneman; Richard & Newton; Alexandra C.,0,0,0,0
1739699662341,BIOM 231,B00,881487,Staff,0,0,0,0
1739699662341,BIOM 231,C00,881488,Schoeneberg; Johannes,0,0,0,0
1739699663364,BIOM 234,A00,881480,Newton; Alexandra C.,0,0,0,0
1739699664389,BIOM 242,A00,806624,Hamilton; Bruce Alan,0,0,0,0
1739699665416,BIOM 246,A00,872559,Gordts; Philip & Lewis; Amanda Lark & Godula; Kamil & Gagneux; Pascal & Esko; Jeffrey D. & Bode; Lars,0,0,0,0
1739699666444,BIOM 252,A00,806625,Ayyagari; Radha,7,0,20,13
1739699667470,BIOM 283,A00,806628,Ghassemian; Majid,0,0,0,0
1739699668496,BIOM 295,A00,806638,Joiner; William J.,0,0,0,0
1739699669524,BIPN 100,A01,860405,Augustine; Vineet,32,0,36,4
1739699669524,BIPN 100,A02,860406,Augustine; Vineet,35,0,36,1
1739699669524,BIPN 100,A03,860407,Augustine; Vineet,35,0,36,1
1739699669524,BIPN 100,A04,860408,Augustine; Vineet,36,0,37,1
1739699669524,BIPN 100,B01,860409,George; Monique Leana,27,0,36,9
1739699669524,BIPN 100,B02,860410,George; Monique Leana,33,0,36,3
1739699669524,BIPN 100,B03,860411,George; Monique Leana,31,0,36,5
1739699669524,BIPN 100,B04,860412,George; Monique Leana,31,0,37,6
1739699669524,BIPN 100,C01,860413,Maita; Isabella Vincenza,36,0,36,0
1739699669524,BIPN 100,C02,860414,Maita; Isabella Vincenza,35,0,36,1
1739699669524,BIPN 100,C03,860415,Maita; Isabella Vincenza,33,0,36,3
1739699669524,BIPN 100,C04,860416,Maita; Isabella Vincenza,36,0,37,1
1739699669524,BIPN 100,D01,860417,Marino; Marc J,47,0,50,3
1739699669524,BIPN 100,D02,860418,Marino; Marc J,48,0,50,2
1739699669524,BIPN 100,D03,860419,Marino; Marc J,48,0,50,2
1739699669524,BIPN 100,D04,860420,Marino; Marc J,50,0,50,0
1739699669524,BIPN 100,E01,860421,Yang; Mingyu,36,0,36,0
1739699669524,BIPN 100,E02,860422,Yang; Mingyu,34,0,36,2
1739699669524,BIPN 100,E03,860423,Yang; Mingyu,36,0,36,0
1739699669524,BIPN 100,E04,860424,Yang; Mingyu,37,0,37,0
1739699670551,BIPN 102,A01,851476,Reyes Gonzalez; Catalina,45,0,54,9
1739699670551,BIPN 102,A02,851477,Reyes Gonzalez; Catalina,48,0,54,6
1739699670551,BIPN 102,A03,851478,Reyes Gonzalez; Catalina,53,0,54,1
1739699670551,BIPN 102,A04,851479,Reyes Gonzalez; Catalina,51,0,54,3
1739699671577,BIPN 105,A01,851482,Armour; Jon Christopher,13,0,21,8
1739699671577,BIPN 105,A02,851483,Armour; Jon Christopher,20,0,21,1
1739699671577,BIPN 105,B01,851487,Armour; Jon Christopher,10,0,21,11
1739699671577,BIPN 105,B02,851488,Armour; Jon Christopher,20,0,21,1
1739699672608,BIPN 140,A01,851492,Owens; Melinda Tsao-Ying,37,0,40,3
1739699672608,BIPN 140,A02,851493,Owens; Melinda Tsao-Ying,38,0,40,2
1739699672608,BIPN 140,A03,851494,Owens; Melinda Tsao-Ying,39,0,40,1
1739699672608,BIPN 140,A04,851495,Owens; Melinda Tsao-Ying,32,0,38,6
1739699673634,BIPN 144,A01,851498,Zou; Yimin,35,0,40,5
1739699673634,BIPN 144,A02,851499,Zou; Yimin,35,0,40,5
1739699673634,BIPN 144,A03,851500,Zou; Yimin,40,0,40,0
1739699673634,BIPN 144,A04,851501,Zou; Yimin,37,0,38,1
1739699674716,BIPN 145,A01,851505,Maita; Isabella Vincenza,33,0,42,9
1739699674716,BIPN 145,B01,851507,Juavinett; Ashley Lauren,36,0,42,6
1739699674716,BIPN 145,C01,851512,Marino; Marc J,34,0,42,8
1739699675742,BIPN 147,A01,851516,Sejnowski; Terrence J,5,0,16,11
1739699675742,BIPN 147,A02,851517,Sejnowski; Terrence J,16,0,16,0
1739699675742,BIPN 147,A03,851520,Sejnowski; Terrence J,13,0,16,3
1739699675742,BIPN 147,A04,851521,Sejnowski; Terrence J,14,0,16,2
1739699676769,BIPN 152,A01,860841,Halpain; Shelley,32,0,44,12
1739699676769,BIPN 152,A02,860842,Halpain; Shelley,43,0,44,1
1739699676769,BIPN 152,A03,860843,Halpain; Shelley,42,0,44,2
1739699676769,BIPN 152,A04,860844,Halpain; Shelley,40,0,43,3
1739699677795,BIPN 162,A01,851524,Aoi; Mikio C,7,0,8,1
1739699677795,BIPN 162,A02,851525,Aoi; Mikio C,7,0,8,1
1739699677795,BIPN 162,A03,851527,Aoi; Mikio C,6,0,8,2
1739699677795,BIPN 162,A04,851529,Aoi; Mikio C,6,0,6,0
1739699678821,BIPN 164,A01,851531,Benna; Marcus K & Aljadeff; Johnatan,13,0,14,1
1739699678821,BIPN 164,A02,851532,Benna; Marcus K & Aljadeff; Johnatan,13,0,14,1
1739699678821,BIPN 164,A03,851533,Benna; Marcus K & Aljadeff; Johnatan,13,0,14,1
1739699678821,BIPN 164,A04,851535,Benna; Marcus K & Aljadeff; Johnatan,12,0,12,0
1739699679867,BIPN 194,A00,851536,Glasgow; Stacey Marie,29,0,32,3
1739699679867,BIPN 194,B00,851537,Augustine; Vineet,28,0,32,4
1739699679867,BIPN 194,C00,851539,Reinagel; Pam,31,0,32,1
1739699680892,BISP 170,A00,851540,French; Kathleen Ann,28,0,30,2
1739699681918,BISP 182,A00,869152,Pogliano; Joseph,9999,0,9999,0
1739699682948,BISP 194,A00,851542,Greenspan; Ralph J.,10,0,32,22
1739699682948,BISP 194,B00,851543,Nguyen; Vu Quang,25,0,32,7
1739699682948,BISP 194,C00,869153,Patrick; Gentry,23,0,32,9
1739699683991,BNFO 281,A00,805637,Gaasterland; Theresa,94,0,100,6
1739699685018,BNFO 283,A00,805640,Chavez; Alejandro & D'Antonio; Matteo,48,0,50,2
1739699685018,BNFO 283,B00,805642,Carter; Hannah Kathryn & Sanchez Roige; Alexandra,47,0,50,3
1739699686047,BNFO 285,A00,805666,Alexandrov; Ludmil B,6,0,8,2
1739699687076,BNFO 294,A01,805680,Ross; Camille,49,0,50,1
1739699688110,CAT 3,A01,813335,Marchisotto; Jennifer Anne,16,0,16,0
1739699688110,CAT 3,A02,813336,Marchisotto; Jennifer Anne,16,0,16,0
1739699688110,CAT 3,A03,813341,Marchisotto; Jennifer Anne,8,0,16,8
1739699688110,CAT 3,A04,813343,Marchisotto; Jennifer Anne,12,0,16,4
1739699688110,CAT 3,A05,813345,Marchisotto; Jennifer Anne,16,0,16,0
1739699688110,CAT 3,A06,813346,Marchisotto; Jennifer Anne,12,0,16,4
1739699688110,CAT 3,A07,813347,Marchisotto; Jennifer Anne,15,0,16,1
1739699688110,CAT 3,A08,813349,Marchisotto; Jennifer Anne,15,0,16,1
1739699688110,CAT 3,A09,813350,Marchisotto; Jennifer Anne,16,0,16,0
1739699688110,CAT 3,A10,813365,Marchisotto; Jennifer Anne,15,0,16,1
1739699688110,CAT 3,A11,813366,Marchisotto; Jennifer Anne,5,0,16,11
1739699688110,CAT 3,A12,813384,Marchisotto; Jennifer Anne,16,0,16,0
1739699688110,CAT 3,A13,813385,Marchisotto; Jennifer Anne,16,0,16,0
1739699688110,CAT 3,A14,813434,Marchisotto; Jennifer Anne,15,0,16,1
1739699688110,CAT 3,B01,813444,Popko; Elizabeth Ashley,16,0,16,0
1739699688110,CAT 3,B02,813445,Popko; Elizabeth Ashley,12,0,16,4
1739699688110,CAT 3,B03,813464,Popko; Elizabeth Ashley,14,0,16,2
1739699688110,CAT 3,B04,813465,Popko; Elizabeth Ashley,7,0,16,9
1739699688110,CAT 3,B05,813466,Popko; Elizabeth Ashley,12,0,16,4
1739699688110,CAT 3,B06,813475,Popko; Elizabeth Ashley,13,0,16,3
1739699688110,CAT 3,B07,813531,Popko; Elizabeth Ashley,15,0,16,1
1739699688110,CAT 3,B08,813538,Popko; Elizabeth Ashley,15,0,16,1
1739699688110,CAT 3,B09,813539,Popko; Elizabeth Ashley,11,0,16,5
1739699688110,CAT 3,B10,813543,Popko; Elizabeth Ashley,12,0,16,4
1739699688110,CAT 3,B11,813545,Popko; Elizabeth Ashley,16,0,16,0
1739699688110,CAT 3,B12,813551,Popko; Elizabeth Ashley,16,0,16,0
1739699688110,CAT 3,B13,813552,Popko; Elizabeth Ashley,15,0,16,1
1739699688110,CAT 3,B14,813554,Popko; Elizabeth Ashley,16,0,16,0
1739699688110,CAT 3,B15,813556,Popko; Elizabeth Ashley,16,0,16,0
1739699688110,CAT 3,B16,813558,Popko; Elizabeth Ashley,16,0,16,0
1739699688110,CAT 3,C01,813564,Glaser; Amelia,15,0,16,1
1739699688110,CAT 3,C02,813578,Glaser; Amelia,13,0,16,3
1739699688110,CAT 3,C03,813602,Glaser; Amelia,4,0,16,12
1739699688110,CAT 3,C04,813604,Glaser; Amelia,3,0,16,13
1739699688110,CAT 3,C05,813606,Glaser; Amelia,14,0,16,2
1739699688110,CAT 3,C06,813607,Glaser; Amelia,14,0,16,2
1739699688110,CAT 3,C07,813609,Glaser; Amelia,14,0,16,2
1739699688110,CAT 3,C08,813611,Glaser; Amelia,16,0,16,0
1739699688110,CAT 3,C09,813613,Glaser; Amelia,15,0,16,1
1739699688110,CAT 3,C10,813614,Glaser; Amelia,13,0,16,3
1739699688110,CAT 3,C11,813617,Glaser; Amelia,14,0,16,2
1739699688110,CAT 3,C12,813618,Glaser; Amelia,16,0,16,0
1739699688110,CAT 3,C13,813622,Glaser; Amelia,15,0,16,1
1739699688110,CAT 3,C14,813623,Glaser; Amelia,15,0,16,1
1739699688110,CAT 3,D01,813625,Bigham; David Joseph,11,0,16,5
1739699688110,CAT 3,D02,813627,Bigham; David Joseph,8,0,16,8
1739699688110,CAT 3,D03,813632,Bigham; David Joseph,15,0,16,1
1739699688110,CAT 3,D04,813637,Bigham; David Joseph,15,0,16,1
1739699688110,CAT 3,D05,813641,Bigham; David Joseph,16,0,16,0
1739699688110,CAT 3,D06,813642,Bigham; David Joseph,15,0,16,1
1739699688110,CAT 3,D07,813644,Bigham; David Joseph,15,0,16,1
1739699688110,CAT 3,D08,813645,Bigham; David Joseph,15,0,16,1
1739699688110,CAT 3,D09,813648,Bigham; David Joseph,15,0,16,1
1739699688110,CAT 3,D10,813651,Bigham; David Joseph,16,0,16,0
1739699688110,CAT 3,D11,813654,Bigham; David Joseph,16,0,16,0
1739699688110,CAT 3,D12,813656,Bigham; David Joseph,16,0,16,0
1739699688110,CAT 3,D13,813657,Bigham; David Joseph,16,0,16,0
1739699688110,CAT 3,D14,813658,Bigham; David Joseph,16,0,16,0
1739699688110,CAT 3,D15,813662,Bigham; David Joseph,15,0,16,1
1739699688110,CAT 3,D16,813663,Bigham; David Joseph,16,0,16,0
1739699689135,CAT 3CE,A01,813665,Bronstein; Phoebe Malan,25,0,25,0
1739699690161,CAT 87,A00,813667,Bronstein; Phoebe Malan,20,0,20,0
1739699690161,CAT 87,B00,886854,Geibel; William,20,0,20,0
1739699691187,CAT 98,001,881482,Geibel; William,20,0,20,0
1739699692212,CAT 124,A01,813672,Geibel; William,20,0,20,0
1739699692212,CAT 124,B01,813675,Rose; Becca Rae,20,0,20,0
1739699693251,CAT 125,A00,813692,Marchisotto; Jennifer Anne,17,0,20,3
1739699693251,CAT 125,B00,813696,Bigham; David Joseph,18,0,20,2
1739699693251,CAT 125,C00,813698,Vanderschuit; Maya Alysia,20,0,20,0
1739699693251,CAT 125,D00,813700,Vanderschuit; Maya Alysia,20,0,20,0
1739699693251,CAT 125,E00,813703,Vanderschuit; Maya Alysia,20,0,20,0
1739699693251,CAT 125,F00,813711,Morales; Celeste Georgianna,19,0,20,1
1739699693251,CAT 125,G00,813714,Morales; Celeste Georgianna,18,0,20,2
1739699693251,CAT 125,H00,813717,Morales; Celeste Georgianna,20,0,20,0
1739699693251,CAT 125,I00,813720,Rose; Becca Rae,20,0,20,0
1739699693251,CAT 125,J00,813744,Rose; Becca Rae,19,0,20,1
1739699693251,CAT 125,K00,813761,Tosun; Adriana,18,0,20,2
1739699693251,CAT 125,L00,813762,Tosun; Adriana,19,0,20,1
1739699693251,CAT 125,M00,872512,Delaville; Romain,19,0,20,1
1739699693251,CAT 125,N00,872514,Irwin; Matthew Joseph,18,0,20,2
1739699693251,CAT 125,O00,872516,Irwin; Matthew Joseph,20,0,20,0
1739699693251,CAT 125,P00,872517,Irwin; Matthew Joseph,19,0,20,1
1739699694283,CAT 125R,A00,813763,Smith; Lauryn Alissa,17,0,20,3
1739699694283,CAT 125R,B00,813764,Smith; Lauryn Alissa,18,0,20,2
1739699694283,CAT 125R,C00,813765,Smith; Lauryn Alissa,20,0,20,0
1739699694283,CAT 125R,D00,813766,Hyland; Tina Mae,16,0,20,4
1739699694283,CAT 125R,E00,813767,Hyland; Tina Mae,15,0,20,5
1739699694283,CAT 125R,F00,813768,Hyland; Tina Mae,19,0,20,1
1739699694283,CAT 125R,G00,813769,Tosun; Adriana,17,0,20,3
1739699695311,CCE 1,A00,815913,Merryman; Ashley,39,0,40,1
1739699695311,CCE 1,D00,815916,Garcia; Kathryn Mary,39,0,40,1
1739699695311,CCE 1,E00,815918,Labat Ii; Michael Luis,36,0,40,4
1739699695311,CCE 1,F00,815919,Bigley; Michele Heather,39,0,40,1
1739699695311,CCE 1,G00,815921,Santos; Vabianna Daria,40,0,40,0
1739699695311,CCE 1,H00,815922,Lee; Kassandra,39,0,40,1
1739699696351,CCE 3,001,815923,Kenley; Nicole,15,0,20,5
1739699696351,CCE 3,002,815924,Quijada; David,19,0,20,1
1739699696351,CCE 3,003,815926,Crawford; James,20,0,20,0
1739699696351,CCE 3,004,815963,Williams; Danielle,20,0,20,0
1739699696351,CCE 3,005,815964,Merryman; Ashley,20,0,20,0
1739699696351,CCE 3,006,815965,Merryman; Ashley,20,0,20,0
1739699696351,CCE 3,007,815966,Lee; Kassandra,19,0,20,1
1739699696351,CCE 3,008,815967,Lee; Kassandra,20,0,20,0
1739699696351,CCE 3,009,816009,Garcia; Kathryn Mary,19,0,20,1
1739699696351,CCE 3,010,816011,Garcia; Kathryn Mary,19,0,20,1
1739699696351,CCE 3,011,816012,Labat Ii; Michael Luis,18,0,20,2
1739699696351,CCE 3,012,816013,Labat Ii; Michael Luis,20,0,20,0
1739699696351,CCE 3,013,816014,Bigley; Michele Heather,18,0,20,2
1739699696351,CCE 3,014,816015,Santos; Vabianna Daria,20,0,20,0
1739699696351,CCE 3,015,816016,Santos; Vabianna Daria,20,0,20,0
1739699696351,CCE 3,016,889148,Crawford; James,39,0,40,1
1739699697380,CENG 101B,A00,808970,Chen; Shaochen,50,0,50,0
1739699698409,CENG 101C,A00,808971,Li; Yanran,144,0,146,2
1739699699435,CENG 113,A00,808993,Li; Wan-Lu,67,0,70,3
1739699699435,CENG 113,B00,808994,Chen; Zheng,70,0,70,0
1739699700460,CENG 124B,A00,808995,Drews; Aaron,46,0,60,14
1739699700460,CENG 124B,B00,809012,Powell; Alyssa,51,0,60,9
1739699701491,CENG 160,A00,809013,Powell; Alyssa,65,0,70,5
1739699702520,CENG 170,A01,809059,Drews; Aaron,28,0,30,2
1739699703551,CENG 176B,A01,809097,Opatkiewicz; Justin Paul,55,0,60,5
1739699703551,CENG 176B,B01,809104,Shah; Nisarg,47,0,48,1
1739699704577,CENG 205,A00,809106,Jahed Motlagh; Zeinab,41,0,60,19
1739699705604,CENG 260,A00,809107,Powell; Alyssa,30,0,30,0
1739699706633,CENG 273,A00,809114,Shah; Nisarg,23,0,30,7
1739699707657,CGS 2B,A01,812749,Whitley; Leila Marie,23,0,25,2
1739699707657,CGS 2B,A02,812761,Whitley; Leila Marie,24,0,24,0
1739699708682,CGS 87,A00,812765,Wesling; Megan E.,20,0,20,0
1739699709708,CGS 100B,A00,812766,Whitley; Leila Marie,30,0,33,3
1739699710733,CGS 105,A01,812868,Wesling; Megan E.,22,0,23,1
1739699710733,CGS 105,A02,812869,Wesling; Megan E.,22,0,23,1
1739699710733,CGS 105,A03,812872,Wesling; Megan E.,23,0,23,0
1739699711758,CGS 106,A00,812873,Whitley; Leila Marie,46,0,50,4
1739699712788,CGS 112,A00,812902,Cuong; Marisol,30,0,30,0
1739699713818,CGS 114,A00,812906,Cuong; Marisol,20,0,22,2
1739699714851,CGS 117,A00,812907,Martin Sandino; Amanda Maria Yoland,13,0,16,3
1739699715883,CGS 120,A00,812908,Hankins; Joseph D.,21,0,22,1
1739699716909,CGS 121,A00,812916,Martin Sandino; Amanda Maria Yoland,20,0,20,0
1739699717934,CGS 122,A00,812917,Martin Sandino; Amanda Maria Yoland,19,0,20,1
1739699718959,CGS 147,A00,872913,Staff,20,0,20,0
1739699719987,CGS 196B,A00,812923,Taylor-Garcia; Daphne,0,0,0,0
1739699719987,CGS 196B,B00,812971,Hankins; Joseph D.,0,0,0,0
1739699719987,CGS 196B,C00,812978,Perez; Roy,0,0,0,0
1739699721015,CGS 198,001,812980,Anderson; Patrick W.,0,0,0,0
1739699721015,CGS 198,002,813054,Anderson; Patrick W.,0,0,0,0
1739699721015,CGS 198,003,813102,Anderson; Patrick W.,0,0,0,0
1739699721015,CGS 198,004,813257,Anderson; Patrick W.,0,0,0,0
1739699722045,CGS 200,A00,813286,Okonkwo; Holly,0,0,0,0
1739699723073,CHEM 6A,A01,860027,Lam; Tin Yiu,40,0,40,0
1739699723073,CHEM 6A,A02,860042,Lam; Tin Yiu,37,0,40,3
1739699723073,CHEM 6A,A03,860049,Lam; Tin Yiu,35,0,40,5
1739699723073,CHEM 6A,A04,860050,Lam; Tin Yiu,37,0,40,3
1739699723073,CHEM 6A,A05,860051,Lam; Tin Yiu,35,0,40,5
1739699723073,CHEM 6A,A06,860052,Lam; Tin Yiu,40,0,40,0
1739699723073,CHEM 6A,A07,860065,Lam; Tin Yiu,40,0,40,0
1739699723073,CHEM 6A,A08,860068,Lam; Tin Yiu,39,0,40,1
1739699724100,CHEM 6B,A01,859962,Lam; Tin Yiu,39,0,40,1
1739699724100,CHEM 6B,A02,859975,Lam; Tin Yiu,40,0,40,0
1739699724100,CHEM 6B,A03,859990,Lam; Tin Yiu,36,0,40,4
1739699724100,CHEM 6B,A04,859994,Lam; Tin Yiu,39,0,40,1
1739699724100,CHEM 6B,A05,859999,Lam; Tin Yiu,40,0,40,0
1739699724100,CHEM 6B,A06,860019,Lam; Tin Yiu,40,0,40,0
1739699724100,CHEM 6B,A07,860024,Lam; Tin Yiu,40,0,40,0
1739699724100,CHEM 6B,B01,861221,Zajac; Eva L,34,0,40,6
1739699724100,CHEM 6B,B02,861224,Zajac; Eva L,36,0,40,4
1739699724100,CHEM 6B,B03,861229,Zajac; Eva L,39,0,40,1
1739699724100,CHEM 6B,B04,861232,Zajac; Eva L,38,0,40,2
1739699724100,CHEM 6B,B05,861239,Zajac; Eva L,37,0,40,3
1739699724100,CHEM 6B,B06,861240,Zajac; Eva L,36,0,40,4
1739699724100,CHEM 6B,B07,861242,Zajac; Eva L,40,0,40,0
1739699725129,CHEM 6C,A01,861431,Hopkins; Patrycja Anna,35,0,40,5
1739699725129,CHEM 6C,A02,861466,Hopkins; Patrycja Anna,38,0,40,2
1739699725129,CHEM 6C,A03,861467,Hopkins; Patrycja Anna,40,0,40,0
1739699725129,CHEM 6C,A04,861530,Hopkins; Patrycja Anna,40,0,40,0
1739699725129,CHEM 6C,A05,861531,Hopkins; Patrycja Anna,38,0,40,2
1739699725129,CHEM 6C,A06,861622,Hopkins; Patrycja Anna,40,0,40,0
1739699725129,CHEM 6C,A07,861649,Hopkins; Patrycja Anna,39,0,40,1
1739699725129,CHEM 6C,A08,861650,Hopkins; Patrycja Anna,0,0,0,0
1739699725129,CHEM 6C,B01,861651,Zajac; Eva L,31,0,40,9
1739699725129,CHEM 6C,B02,861763,Zajac; Eva L,37,0,40,3
1739699725129,CHEM 6C,B03,861768,Zajac; Eva L,38,0,40,2
1739699725129,CHEM 6C,B04,861770,Zajac; Eva L,38,0,40,2
1739699725129,CHEM 6C,B05,861771,Zajac; Eva L,35,0,40,5
1739699725129,CHEM 6C,B06,861773,Zajac; Eva L,39,0,40,1
1739699725129,CHEM 6C,B07,861777,Zajac; Eva L,40,0,40,0
1739699725129,CHEM 6C,B08,861781,Zajac; Eva L,0,0,0,0
1739699725129,CHEM 6C,D01,859938,Stallings; Dontarie M,39,0,40,1
1739699725129,CHEM 6C,D02,859942,Stallings; Dontarie M,32,0,40,8
1739699725129,CHEM 6C,D03,859943,Stallings; Dontarie M,38,0,40,2
1739699725129,CHEM 6C,D04,859952,Stallings; Dontarie M,38,0,40,2
1739699725129,CHEM 6C,D05,859953,Stallings; Dontarie M,19,0,40,21
1739699725129,CHEM 6C,D06,859959,Stallings; Dontarie M,37,0,40,3
1739699725129,CHEM 6C,D07,859960,Stallings; Dontarie M,37,0,40,3
1739699725129,CHEM 6C,D08,859961,Stallings; Dontarie M,0,0,0,0
1739699725129,CHEM 6C,E01,861810,Debelouchina; Galia T,40,0,40,0
1739699725129,CHEM 6C,E02,861860,Debelouchina; Galia T,40,0,40,0
1739699725129,CHEM 6C,E03,861879,Debelouchina; Galia T,39,0,40,1
1739699725129,CHEM 6C,E04,861880,Debelouchina; Galia T,39,0,40,1
1739699725129,CHEM 6C,E05,861890,Debelouchina; Galia T,39,0,40,1
1739699725129,CHEM 6C,E06,861908,Debelouchina; Galia T,40,0,40,0
1739699725129,CHEM 6C,E07,861910,Debelouchina; Galia T,40,0,40,0
1739699725129,CHEM 6C,E08,861911,Debelouchina; Galia T,0,0,0,0
1739699726154,CHEM 6CH,A01,859928,Tezcan; Faik,39,0,40,1
1739699727191,CHEM 7L,A01,844470,Piercy; Marc Anthony,17,0,24,7
1739699727191,CHEM 7L,A02,844472,Piercy; Marc Anthony,21,0,24,3
1739699727191,CHEM 7L,A03,844473,Piercy; Marc Anthony,22,0,24,2
1739699727191,CHEM 7L,A04,844475,Piercy; Marc Anthony,24,0,24,0
1739699727191,CHEM 7L,A05,844476,Piercy; Marc Anthony,23,0,24,1
1739699727191,CHEM 7L,A06,844482,Piercy; Marc Anthony,22,0,24,2
1739699727191,CHEM 7L,A07,844490,Piercy; Marc Anthony,20,0,24,4
1739699727191,CHEM 7L,A08,844493,Piercy; Marc Anthony,24,0,24,0
1739699727191,CHEM 7L,A09,844496,Piercy; Marc Anthony,23,0,24,1
1739699727191,CHEM 7L,A10,844503,Piercy; Marc Anthony,24,0,24,0
1739699727191,CHEM 7L,B01,844506,Piercy; Marc Anthony,2,0,24,22
1739699727191,CHEM 7L,B02,844508,Piercy; Marc Anthony,23,0,24,1
1739699727191,CHEM 7L,B03,844661,Piercy; Marc Anthony,22,0,24,2
1739699727191,CHEM 7L,B04,844716,Piercy; Marc Anthony,24,0,24,0
1739699727191,CHEM 7L,B05,844717,Piercy; Marc Anthony,21,0,24,3
1739699727191,CHEM 7L,B06,844719,Piercy; Marc Anthony,22,0,24,2
1739699727191,CHEM 7L,B07,844841,Piercy; Marc Anthony,24,0,24,0
1739699727191,CHEM 7L,B08,845021,Piercy; Marc Anthony,23,0,24,1
1739699727191,CHEM 7L,B09,845022,Piercy; Marc Anthony,23,0,24,1
1739699727191,CHEM 7L,B10,845184,Piercy; Marc Anthony,24,0,24,0
1739699728224,CHEM 7LM,A01,845187,Leigh; Brian,24,0,24,0
1739699728224,CHEM 7LM,A02,845321,Leigh; Brian,21,0,21,0
1739699728224,CHEM 7LM,A03,845322,Leigh; Brian,24,0,24,0
1739699728224,CHEM 7LM,A04,845340,Leigh; Brian,19,0,21,2
1739699728224,CHEM 7LM,A05,845350,Leigh; Brian,23,0,24,1
1739699728224,CHEM 7LM,A06,845398,Leigh; Brian,21,0,21,0
1739699728224,CHEM 7LM,A07,845399,Leigh; Brian,18,0,24,6
1739699728224,CHEM 7LM,A08,845406,Leigh; Brian,20,0,21,1
1739699729255,CHEM 11,A01,861914,Albizati; Kim F.,37,0,40,3
1739699729255,CHEM 11,A02,861934,Albizati; Kim F.,38,0,40,2
1739699729255,CHEM 11,A03,861939,Albizati; Kim F.,40,0,40,0
1739699729255,CHEM 11,A04,861940,Albizati; Kim F.,40,0,40,0
1739699729255,CHEM 11,A05,861951,Albizati; Kim F.,36,0,40,4
1739699729255,CHEM 11,A06,861975,Albizati; Kim F.,40,0,40,0
1739699730281,CHEM 40A,A01,861976,Hopkins; Patrycja Anna,32,0,40,8
1739699730281,CHEM 40A,A02,861977,Hopkins; Patrycja Anna,36,0,40,4
1739699730281,CHEM 40A,A03,861978,Hopkins; Patrycja Anna,37,0,40,3
1739699730281,CHEM 40A,A04,862061,Hopkins; Patrycja Anna,38,0,40,2
1739699730281,CHEM 40A,A05,862062,Hopkins; Patrycja Anna,38,0,40,2
1739699730281,CHEM 40A,A06,862063,Hopkins; Patrycja Anna,37,0,40,3
1739699730281,CHEM 40A,A07,862064,Hopkins; Patrycja Anna,39,0,40,1
1739699730281,CHEM 40A,A08,862065,Hopkins; Patrycja Anna,37,0,40,3
1739699731361,CHEM 40B,A01,862066,Weizman; Haim,29,0,40,11
1739699731361,CHEM 40B,A02,862067,Weizman; Haim,38,0,40,2
1739699731361,CHEM 40B,A03,862077,Weizman; Haim,40,0,40,0
1739699731361,CHEM 40B,A04,862085,Weizman; Haim,37,0,40,3
1739699731361,CHEM 40B,A05,862086,Weizman; Haim,34,0,40,6
1739699731361,CHEM 40B,A06,862087,Weizman; Haim,40,0,40,0
1739699731361,CHEM 40B,A07,862088,Weizman; Haim,39,0,40,1
1739699731361,CHEM 40B,A08,862089,Weizman; Haim,0,0,0,0
1739699732392,CHEM 41B,A01,860069,Klosterman; Jeremy K,32,0,40,8
1739699732392,CHEM 41B,A02,860074,Klosterman; Jeremy K,38,0,40,2
1739699732392,CHEM 41B,A03,860081,Klosterman; Jeremy K,39,0,40,1
1739699733418,CHEM 41C,A01,862090,Romero; Nathan A,39,0,40,1
1739699733418,CHEM 41C,A02,862091,Romero; Nathan A,40,0,40,0
1739699733418,CHEM 41C,A03,862092,Romero; Nathan A,39,0,40,1
1739699733418,CHEM 41C,A04,862213,Romero; Nathan A,39,0,40,1
1739699733418,CHEM 41C,A05,862214,Romero; Nathan A,38,0,40,2
1739699733418,CHEM 41C,A06,862215,Romero; Nathan A,40,0,40,0
1739699733418,CHEM 41C,A07,862216,Romero; Nathan A,38,0,40,2
1739699734448,CHEM 43A,A01,845450,Ternansky; Robert J.,15,0,24,9
1739699734448,CHEM 43A,A02,845676,Ternansky; Robert J.,21,0,24,3
1739699734448,CHEM 43A,A03,845679,Ternansky; Robert J.,21,0,24,3
1739699734448,CHEM 43A,A04,845682,Ternansky; Robert J.,23,0,24,1
1739699734448,CHEM 43A,A05,845684,Ternansky; Robert J.,22,0,24,2
1739699734448,CHEM 43A,A06,845686,Ternansky; Robert J.,19,0,24,5
1739699734448,CHEM 43A,A07,845692,Ternansky; Robert J.,22,0,24,2
1739699734448,CHEM 43A,A08,845694,Ternansky; Robert J.,17,0,24,7
1739699734448,CHEM 43A,A09,845697,Ternansky; Robert J.,24,0,24,0
1739699734448,CHEM 43A,A10,845698,Ternansky; Robert J.,23,0,24,1
1739699734448,CHEM 43A,A11,845700,Ternansky; Robert J.,23,0,24,1
1739699734448,CHEM 43A,A12,845702,Ternansky; Robert J.,24,0,24,0
1739699734448,CHEM 43A,A13,845704,Ternansky; Robert J.,22,0,24,2
1739699734448,CHEM 43A,B01,845707,Ternansky; Robert J.,23,0,24,1
1739699734448,CHEM 43A,B02,845712,Ternansky; Robert J.,22,0,24,2
1739699734448,CHEM 43A,B03,845794,Ternansky; Robert J.,14,0,24,10
1739699734448,CHEM 43A,B04,845797,Ternansky; Robert J.,20,0,24,4
1739699734448,CHEM 43A,B05,845800,Ternansky; Robert J.,22,0,24,2
1739699734448,CHEM 43A,B06,845801,Ternansky; Robert J.,20,0,24,4
1739699734448,CHEM 43A,B07,845816,Ternansky; Robert J.,21,0,24,3
1739699734448,CHEM 43A,B08,845817,Ternansky; Robert J.,19,0,24,5
1739699734448,CHEM 43A,B09,845827,Ternansky; Robert J.,23,0,24,1
1739699734448,CHEM 43A,B10,845832,Ternansky; Robert J.,22,0,24,2
1739699734448,CHEM 43A,B11,845866,Ternansky; Robert J.,22,0,24,2
1739699734448,CHEM 43A,B12,845867,Ternansky; Robert J.,21,0,24,3
1739699735473,CHEM 96,A00,845868,Brydges; Stacey,18,0,20,2
1739699736505,CHEM 100A,A01,845921,Staff,0,0,0,0
1739699736505,CHEM 100A,A02,845922,Staff,0,0,0,0
1739699736505,CHEM 100A,A03,845983,Staff,0,0,0,0
1739699736505,CHEM 100A,A04,845984,Staff,0,0,0,0
1739699736505,CHEM 100A,A05,845985,Staff,0,0,0,0
1739699736505,CHEM 100A,A06,845986,Staff,0,0,0,0
1739699737539,CHEM 100B,A01,845988,Pomeroy; Robert S.,27,0,30,3
1739699738569,CHEM 105A,A01,845991,Young; Mark,33,0,40,7
1739699739595,CHEM 108,A01,845993,Mrse; Anthony Adrian,18,0,20,2
1739699739595,CHEM 108,A02,845994,Mrse; Anthony Adrian,18,0,24,6
1739699739595,CHEM 108,B01,845996,Mrse; Anthony Adrian,16,0,20,4
1739699739595,CHEM 108,B02,845997,Mrse; Anthony Adrian,23,0,24,1
1739699740625,CHEM 109,A01,845999,McHugh; Colleen A,11,0,20,9
1739699740625,CHEM 109,A02,846000,McHugh; Colleen A,24,0,24,0
1739699740625,CHEM 109,B01,846002,McHugh; Colleen A,18,0,20,2
1739699740625,CHEM 109,B02,846003,McHugh; Colleen A,23,0,24,1
1739699741650,CHEM 114B,A01,862223,Mishanina; Tatiana V,37,0,40,3
1739699741650,CHEM 114B,A02,862224,Mishanina; Tatiana V,40,0,40,0
1739699741650,CHEM 114B,A03,862225,Mishanina; Tatiana V,40,0,40,0
1739699742681,CHEM 114C,A01,859769,Joseph; Simpson,35,0,40,5
1739699742681,CHEM 114C,A02,859782,Joseph; Simpson,29,0,40,11
1739699742681,CHEM 114C,A03,859790,Joseph; Simpson,25,0,40,15
1739699742681,CHEM 114C,A04,859791,Joseph; Simpson,40,0,40,0
1739699742681,CHEM 114C,A05,859793,Joseph; Simpson,37,0,40,3
1739699742681,CHEM 114C,A06,859804,Joseph; Simpson,37,0,40,3
1739699742681,CHEM 114C,A07,859805,Joseph; Simpson,0,0,0,0
1739699742681,CHEM 114C,A08,859810,Joseph; Simpson,0,0,0,0
1739699743707,CHEM 114D,A00,846006,Ghosh; Gourisankar,19,0,25,6
1739699744733,CHEM 118,A01,862235,Donoghue; Daniel J.,28,0,40,12
1739699744733,CHEM 118,A02,862236,Donoghue; Daniel J.,38,0,40,2
1739699744733,CHEM 118,A03,862238,Donoghue; Daniel J.,28,0,40,12
1739699744733,CHEM 118,A04,862240,Donoghue; Daniel J.,39,0,40,1
1739699744733,CHEM 118,A05,862242,Donoghue; Daniel J.,39,0,40,1
1739699744733,CHEM 118,A06,862243,Donoghue; Daniel J.,39,0,40,1
1739699745761,CHEM 120B,A01,859811,Staff,32,0,40,8
1739699745761,CHEM 120B,A02,859812,Staff,39,0,40,1
1739699745761,CHEM 120B,A03,859813,Staff,0,0,0,0
1739699746791,CHEM 123,A00,846009,Schimpf; Alina M,0,0,0,2
1739699747815,CHEM 125,A00,846010,Tezcan; Faik,17,0,20,3
1739699748845,CHEM 126B,A01,859888,Tauber; Michael,27,0,40,13
1739699748845,CHEM 126B,A02,859927,Tauber; Michael,0,0,0,0
1739699749869,CHEM 132,A01,862270,Tauber; Michael,39,0,40,1
1739699749869,CHEM 132,A02,862271,Tauber; Michael,36,0,40,4
1739699750896,CHEM 135,A01,860846,Xiong; Wei,14,0,15,1
1739699751923,CHEM 143B,A01,846015,Klosterman; Jeremy K,20,0,24,4
1739699751923,CHEM 143B,A02,846016,Klosterman; Jeremy K,15,0,24,9
1739699752953,CHEM 156,A00,846017,Romero; Erik Anthony,29,0,30,1
1739699753978,CHEM 157,A00,846018,Tor; Yitzhak,74,0,80,6
1739699755004,CHEM 158,A00,846020,Molinski; Tadeusz,9,0,10,1
1739699756035,CHEM 167,A01,862285,Deshmukh; Lalit,36,0,40,4
1739699756035,CHEM 167,A02,862286,Deshmukh; Lalit,39,0,40,1
1739699756035,CHEM 167,A03,862287,Deshmukh; Lalit,37,0,40,3
1739699756035,CHEM 167,A04,862288,Deshmukh; Lalit,39,0,40,1
1739699757062,CHEM 173,A00,846023,Young; Mark,36,0,40,4
1739699758090,CHEM 174,A01,851594,Pomeroy; Robert S.,58,0,60,2
1739699759119,CHEM 185,A00,846025,Paesani; Francesco,21,0,26,5
1739699760149,CHEM 188,A00,846026,Brydges; Stacey,20,0,20,0
1739699761176,CHEM 207,A00,846088,Deshmukh; Lalit,23,0,30,7
1739699762202,CHEM 214,A00,846089,Ghosh; Gourisankar,5,0,15,10
1739699763227,CHEM 217,A00,846092,Joseph; Simpson,15,0,30,15
1739699764253,CHEM 225,A00,846095,Tezcan; Faik,6,0,10,4
1739699765279,CHEM 227,A00,846097,Schimpf; Alina M,30,0,30,0
1739699766309,CHEM 229,A00,846100,Stauber; Julia Megan,19,0,20,1
1739699767333,CHEM 235,A01,860847,Xiong; Wei,17,0,20,3
1739699768361,CHEM 236,A00,846106,Kummel; Andrew C,5,0,15,10
1739699769385,CHEM 237,A00,872555,Esko; Jeffrey D.,7,0,7,0
1739699770411,CHEM 250,A00,846107,Weizman; Haim,0,0,0,0
1739699771439,CHEM 256,A00,846108,Romero; Erik Anthony,20,0,20,0
1739699772465,CHEM 257,A00,846109,Tor; Yitzhak,28,0,30,2
1739699773490,CHEM 258,A00,846110,Molinski; Tadeusz,14,0,15,1
1739699774516,CHEM 262,A00,846111,Kubiak; Clifford Paul,26,0,30,4
1739699775546,CHEM 273,A00,846118,Young; Mark,15,0,20,5
1739699776574,CHEM 276,A00,846119,Mc Culloch; Andrew Douglas,4,0,5,1
1739699777600,CHEM 283,A00,846120,Ghassemian; Majid,10,0,10,0
1739699778680,CHEM 285,A00,846121,Paesani; Francesco,19,0,20,1
1739699779708,CHEM 291,A00,846122,Debelouchina; Galia T,20,0,20,0
1739699780735,CHEM 294,A00,846123,Pun; Andrew Brian,48,0,50,2
1739699781766,CHIN 10CD,A01,809156,Liu; Mingming,17,0,17,0
1739699781766,CHIN 10CD,A02,809192,Liu; Mingming,18,0,18,0
1739699782791,CHIN 10CM,A01,809196,Chen; Pei-Chia,15,0,15,0
1739699782791,CHIN 10CM,A02,809197,Chen; Pei-Chia,19,0,20,1
1739699783824,CHIN 10CN,A01,809203,Xu; Li,12,0,14,2
1739699783824,CHIN 10CN,A03,809218,Xu; Li,14,0,14,0
1739699783824,CHIN 10CN,B01,809296,Xu; Li,13,0,14,1
1739699783824,CHIN 10CN,B02,809307,Xu; Li,10,0,14,4
1739699783824,CHIN 10CN,B03,809361,Xu; Li,14,0,14,0
1739699784857,CHIN 20CM,A01,809437,Wang; Xiao,10,0,10,0
1739699784857,CHIN 20CM,A02,809458,Wang; Xiao,10,0,10,0
1739699785885,CHIN 20CN,A01,809462,Anderson; Qin-Hong,12,0,12,0
1739699785885,CHIN 20CN,A02,809463,Anderson; Qin-Hong,12,0,12,0
1739699785885,CHIN 20CN,A03,871383,Anderson; Qin-Hong,12,0,12,0
1739699785885,CHIN 20CN,B01,809488,Anderson; Qin-Hong,12,0,12,0
1739699786910,CHIN 100CM,A00,809489,Anderson; Qin-Hong,23,0,24,1
1739699787940,CHIN 100CN,A00,809490,Chen; Pei-Chia,24,0,24,0
1739699788965,CHIN 169B,A00,809720,Wang; Xiao,20,0,20,0
1739699789993,CHIN 182B,A00,809728,Liu; Mingming,17,0,20,3
1739699791018,CLAS 196B,A00,869154,Myerston Santana; Jacobo,1,0,1,0
1739699792048,CLIN 294C,A00,870690,Wierenga; Christina E & Banks; Sarah Jane,20,0,20,0
1739699793077,CLIN 296,001,870694,Brookman; Lauren Irene,100,0,100,0
1739699793077,CLIN 296,002,870695,Brookman; Lauren Irene,10,0,10,0
1739699793077,CLIN 296,003,870696,Wall; Tamara Lynn,100,0,100,0
1739699794102,CLRE 238R,A00,809924,Mehta; Ravindra L.,9999,0,9999,0
1739699795125,CLRE 254,A00,809952,Vaida; Florin,9999,0,9999,0
1739699796149,CLRE 255,A01,809989,Cuomo; Raphael Eduardo,9999,0,9999,0
1739699797174,CLRE 256,A01,810211,Morris; Sheldon,9999,0,9999,0
1739699798204,CLRE 257,A00,810214,Mehta; Ravindra L.,9999,0,9999,0
1739699799227,CLRE 258,A00,810216,Mehta; Ravindra L.,9999,0,9999,0
1739699800255,CLRE 260,A00,810217,Cuomo; Raphael Eduardo,9999,0,9999,0
1739699801283,CLRE 265,A00,810220,Vaida; Florin,9999,0,9999,0
1739699802309,CLRE 297,001,810222,Cuomo; Raphael Eduardo,9999,0,9999,0
1739699803333,CLX 87,A00,809115,Castro; Robert Jess,20,0,20,0
1739699804358,CMM 225,A00,872556,Esko; Jeffrey D.,7,0,7,0
1739699805385,CMM 246,A00,872560,Gordts; Philip & Lewis; Amanda Lark & Godula; Kamil & Gagneux; Pascal & Esko; Jeffrey D. & Bode; Lars,10,0,10,0
1739699806410,CMM 250,A00,884466,Willert; Karl Heinrich,60,0,60,0
1739699807438,COGR 201D,A00,808201,Serlin; David,10,0,10,0
1739699808465,COGR 219,A00,808207,Harb; Anthony Joseph,5,0,10,5
1739699809490,COGR 225B,A00,808212,Gere; Catherina M.,10,0,10,0
1739699810520,COGR 225C,A00,808214,McKenzie; Kerry V.,10,0,10,0
1739699811547,COGR 275,A00,808219,Jack; Caroline Sarah,8,0,10,2
1739699812573,COGR 296,A00,808221,Ybarra; Megan,5,0,5,0
1739699813605,COGS 1,A01,810294,Deak; Gedeon O.,58,0,60,2
1739699813605,COGS 1,A02,810296,Deak; Gedeon O.,57,0,60,3
1739699813605,COGS 1,A03,810298,Deak; Gedeon O.,56,0,60,4
1739699813605,COGS 1,A04,810299,Deak; Gedeon O.,57,0,60,3
1739699813605,COGS 1,A05,810300,Deak; Gedeon O.,60,0,60,0
1739699813605,COGS 1,A06,810301,Deak; Gedeon O.,59,0,60,1
1739699813605,COGS 1,A07,810302,Deak; Gedeon O.,57,0,57,0
1739699814632,COGS 2,A01,810304,Boyle; Mary E. T.,54,0,56,2
1739699814632,COGS 2,A02,810305,Boyle; Mary E. T.,56,0,56,0
1739699814632,COGS 2,A03,810307,Boyle; Mary E. T.,54,0,56,2
1739699814632,COGS 2,A04,810309,Boyle; Mary E. T.,57,0,60,3
1739699814632,COGS 2,A05,810310,Boyle; Mary E. T.,67,0,67,0
1739699815657,COGS 9,A01,810312,Shannon; Kyle Michael,49,0,50,1
1739699815657,COGS 9,A02,810313,Shannon; Kyle Michael,49,0,50,1
1739699815657,COGS 9,A03,810314,Shannon; Kyle Michael,49,0,50,1
1739699815657,COGS 9,A04,810316,Shannon; Kyle Michael,50,0,50,0
1739699815657,COGS 9,A05,810320,Shannon; Kyle Michael,50,0,50,0
1739699815657,COGS 9,A06,810321,Shannon; Kyle Michael,49,0,50,1
1739699816685,COGS 11,A01,810324,Boroditsky; Lera,134,0,140,6
1739699817723,COGS 13,A01,810328,Rossano; Federico,42,0,50,8
1739699817723,COGS 13,A02,810329,Rossano; Federico,48,0,49,1
1739699817723,COGS 13,A03,810330,Rossano; Federico,48,0,50,2
1739699817723,COGS 13,A04,810331,Rossano; Federico,48,0,49,1
1739699817723,COGS 13,A05,810332,Rossano; Federico,48,0,49,1
1739699817723,COGS 13,A06,810333,Rossano; Federico,49,0,49,0
1739699818755,COGS 14A,A01,810335,Barrera; Steven James,45,0,50,5
1739699818755,COGS 14A,A02,810336,Barrera; Steven James,47,0,50,3
1739699818755,COGS 14A,A03,810338,Barrera; Steven James,49,0,50,1
1739699818755,COGS 14A,A04,810339,Barrera; Steven James,56,0,60,4
1739699818755,COGS 14A,A05,810340,Barrera; Steven James,50,0,50,0
1739699818755,COGS 14A,A06,810341,Barrera; Steven James,50,0,50,0
1739699818755,COGS 14A,A07,810343,Barrera; Steven James,54,0,56,2
1739699819781,COGS 14B,A01,810346,Hoffman; Drew Ellen,54,0,57,3
1739699819781,COGS 14B,A02,810347,Hoffman; Drew Ellen,55,0,55,0
1739699819781,COGS 14B,A03,810348,Hoffman; Drew Ellen,52,0,55,3
1739699819781,COGS 14B,A04,810350,Hoffman; Drew Ellen,54,0,55,1
1739699819781,COGS 14B,A05,810351,Hoffman; Drew Ellen,53,0,55,2
1739699820807,COGS 17,A01,810353,Johnson; Christine M.,49,0,50,1
1739699820807,COGS 17,A02,810354,Johnson; Christine M.,48,0,50,2
1739699820807,COGS 17,A03,810356,Johnson; Christine M.,48,0,50,2
1739699820807,COGS 17,A04,810357,Johnson; Christine M.,47,0,50,3
1739699820807,COGS 17,A05,810359,Johnson; Christine M.,49,0,50,1
1739699820807,COGS 17,A06,810360,Johnson; Christine M.,50,0,50,0
1739699820807,COGS 17,A07,810361,Johnson; Christine M.,52,0,55,3
1739699820807,COGS 17,A08,810362,Johnson; Christine M.,54,0,55,1
1739699821836,COGS 18,A01,810366,Ellis; Shannon Elizabeth,31,0,35,4
1739699821836,COGS 18,A02,810367,Ellis; Shannon Elizabeth,31,0,35,4
1739699821836,COGS 18,A03,810371,Ellis; Shannon Elizabeth,30,0,35,5
1739699821836,COGS 18,A04,810372,Ellis; Shannon Elizabeth,34,0,35,1
1739699821836,COGS 18,A05,810373,Ellis; Shannon Elizabeth,32,0,35,3
1739699821836,COGS 18,A06,810374,Ellis; Shannon Elizabeth,35,0,35,0
1739699821836,COGS 18,A07,810375,Ellis; Shannon Elizabeth,35,0,35,0
1739699821836,COGS 18,A08,810376,Ellis; Shannon Elizabeth,34,0,35,1
1739699821836,COGS 18,A09,810377,Ellis; Shannon Elizabeth,35,0,35,0
1739699821836,COGS 18,B01,810379,Ellis; Shannon Elizabeth,33,0,35,2
1739699821836,COGS 18,B02,810384,Ellis; Shannon Elizabeth,34,0,35,1
1739699821836,COGS 18,B03,810385,Ellis; Shannon Elizabeth,34,0,35,1
1739699821836,COGS 18,B04,810388,Ellis; Shannon Elizabeth,34,0,35,1
1739699821836,COGS 18,B05,810389,Ellis; Shannon Elizabeth,31,0,35,4
1739699821836,COGS 18,B06,810390,Ellis; Shannon Elizabeth,31,0,35,4
1739699821836,COGS 18,B07,810392,Ellis; Shannon Elizabeth,34,0,35,1
1739699821836,COGS 18,B08,810393,Ellis; Shannon Elizabeth,34,0,35,1
1739699821836,COGS 18,B09,810395,Ellis; Shannon Elizabeth,32,0,35,3
1739699822869,COGS 87,A00,810426,Deak; Gedeon O.,20,0,20,0
1739699823900,COGS 100,A01,810564,Morgan; Eric,49,0,56,7
1739699823900,COGS 100,A02,810582,Morgan; Eric,54,0,56,2
1739699823900,COGS 100,A03,810589,Morgan; Eric,55,0,56,1
1739699823900,COGS 100,A04,810651,Morgan; Eric,54,0,56,2
1739699823900,COGS 100,A05,810684,Morgan; Eric,56,0,56,0
1739699823900,COGS 100,A06,810690,Morgan; Eric,54,0,56,2
1739699824926,COGS 101A,A01,810697,Morgan; Eric,49,0,50,1
1739699824926,COGS 101A,A02,810701,Morgan; Eric,49,0,50,1
1739699824926,COGS 101A,A03,810707,Morgan; Eric,49,0,50,1
1739699824926,COGS 101A,A04,810708,Morgan; Eric,50,0,50,0
1739699825952,COGS 101B,A01,810716,Barrera; Steven James,49,0,50,1
1739699825952,COGS 101B,A02,810718,Barrera; Steven James,45,0,50,5
1739699825952,COGS 101B,A03,810719,Barrera; Steven James,47,0,50,3
1739699825952,COGS 101B,A04,810730,Barrera; Steven James,38,0,50,12
1739699826982,COGS 101C,A01,810737,Cooperrider; Kensy A,50,0,50,0
1739699826982,COGS 101C,A02,810742,Cooperrider; Kensy A,43,0,50,7
1739699826982,COGS 101C,A03,810743,Cooperrider; Kensy A,48,0,50,2
1739699828007,COGS 102A,A01,810750,Allen; Michael Gordon,49,0,50,1
1739699828007,COGS 102A,A02,810751,Allen; Michael Gordon,50,0,50,0
1739699828007,COGS 102A,A03,810754,Allen; Michael Gordon,44,0,49,5
1739699829033,COGS 107A,A01,810756,Boyle; Mary E. T.,54,0,56,2
1739699829033,COGS 107A,A02,810757,Boyle; Mary E. T.,52,0,56,4
1739699829033,COGS 107A,A03,810760,Boyle; Mary E. T.,55,0,56,1
1739699829033,COGS 107A,A04,810767,Boyle; Mary E. T.,54,0,56,2
1739699829033,COGS 107A,A05,810769,Boyle; Mary E. T.,54,0,56,2
1739699829033,COGS 107A,A06,810777,Boyle; Mary E. T.,55,0,56,1
1739699830065,COGS 107B,A03,810800,Mooshagian; Eric Frederick,41,0,50,9
1739699830065,COGS 107B,A04,810810,Mooshagian; Eric Frederick,33,0,50,17
1739699830065,COGS 107B,A05,810811,Mooshagian; Eric Frederick,44,0,50,6
1739699831095,COGS 107C,A01,810815,Chiba; Andrea,41,0,47,6
1739699831095,COGS 107C,A02,810816,Chiba; Andrea,35,0,50,15
1739699831095,COGS 107C,A03,810853,Chiba; Andrea,44,0,49,5
1739699832122,COGS 108,A01,810862,Fleischer; Jason G,42,0,50,8
1739699832122,COGS 108,A02,810870,Fleischer; Jason G,42,0,50,8
1739699832122,COGS 108,A03,810871,Fleischer; Jason G,50,0,50,0
1739699832122,COGS 108,A04,810874,Fleischer; Jason G,49,0,50,1
1739699832122,COGS 108,A05,810876,Fleischer; Jason G,47,0,50,3
1739699832122,COGS 108,A06,810879,Fleischer; Jason G,48,0,50,2
1739699832122,COGS 108,A07,810896,Fleischer; Jason G,50,0,50,0
1739699832122,COGS 108,B01,810950,Fleischer; Jason G,54,0,56,2
1739699832122,COGS 108,B02,810960,Fleischer; Jason G,54,0,56,2
1739699832122,COGS 108,B03,810961,Fleischer; Jason G,52,0,56,4
1739699832122,COGS 108,B04,810962,Fleischer; Jason G,43,0,60,17
1739699832122,COGS 108,B05,810963,Fleischer; Jason G,58,0,60,2
1739699832122,COGS 108,B06,810964,Fleischer; Jason G,58,0,60,2
1739699832122,COGS 108,B07,810965,Fleischer; Jason G,62,0,62,0
1739699834180,COGS 112,A01,811001,Hoffman; Drew Ellen,33,0,50,17
1739699834180,COGS 112,A02,811020,Hoffman; Drew Ellen,42,0,50,8
1739699834180,COGS 112,A03,811045,Hoffman; Drew Ellen,44,0,50,6
1739699834180,COGS 112,A04,811047,Hoffman; Drew Ellen,49,0,50,1
1739699835206,COGS 124,A00,811065,Guo; Philip J,1,0,25,24
1739699836232,COGS 125,A00,811079,Klemmer; Scott R,43,0,50,7
1739699837258,COGS 142,A01,811081,Rossano; Federico,50,0,50,0
1739699838290,COGS 143,A01,811108,Staff,46,0,50,4
1739699839319,COGS 150,A01,811185,Trott; Sean Thomas,35,0,50,15
1739699839319,COGS 150,A02,811319,Trott; Sean Thomas,50,0,50,0
1739699839319,COGS 150,A03,811360,Trott; Sean Thomas,42,0,49,7
1739699840345,COGS 157,A00,811371,Creel; Sarah,66,0,75,9
1739699841372,COGS 160,A00,872440,Saygin; Ayse P,29,0,30,1
1739699841372,COGS 160,B00,872441,Saygin; Ayse P,30,0,30,0
1739699841372,COGS 160,C00,872442,Kirsh; David Joel,30,0,30,0
1739699842400,COGS 172,A01,811389,Greene; Deanna Jacquelyn,46,0,50,4
1739699842400,COGS 172,A02,811390,Greene; Deanna Jacquelyn,48,0,50,2
1739699842400,COGS 172,A03,811391,Greene; Deanna Jacquelyn,45,0,50,5
1739699842400,COGS 172,A04,811392,Greene; Deanna Jacquelyn,47,0,50,3
1739699844452,COGS 179,A01,811401,Staff,43,0,50,7
1739699845479,COGS 184,A01,811403,Johnson; Christine M.,46,0,50,4
1739699846504,COGS 185,A01,811514,Tu; Zhuowen,38,0,50,12
1739699846504,COGS 185,A02,811580,Tu; Zhuowen,46,0,50,4
1739699847531,COGS 187A,A01,811589,Allen; Michael Gordon,45,0,50,5
1739699847531,COGS 187A,A02,811590,Allen; Michael Gordon,46,0,50,4
1739699847531,COGS 187A,A03,811591,Allen; Michael Gordon,44,0,49,5
1739699848559,COGS 190C,001,811592,Chiba; Andrea,9999,0,9999,0
1739699848559,COGS 190C,002,811601,Fleischer; Jason G,9999,0,9999,0
1739699848559,COGS 190C,003,811602,Boyle; Mary E. T.,9999,0,9999,0
1739699848559,COGS 190C,004,811604,Nitz; Douglas A.,9999,0,9999,0
1739699848559,COGS 190C,005,811605,Rangel; Lara M,9999,0,9999,0
1739699848559,COGS 190C,006,811609,Hoffman; Drew Ellen,9999,0,9999,0
1739699848559,COGS 190C,007,811610,Deak; Gedeon O.,9999,0,9999,0
1739699848559,COGS 190C,008,811613,Kiyonaga; Anastasia,9999,0,9999,0
1739699848559,COGS 190C,009,811716,Creel; Sarah,9999,0,9999,0
1739699848559,COGS 190C,010,811733,Voytek; Bradley Thomas,9999,0,9999,0
1739699848559,COGS 190C,011,811836,Beatty-Martinez; Anne,9999,0,9999,0
1739699848559,COGS 190C,012,811838,De Sa; Virginia,9999,0,9999,0
1739699848559,COGS 190C,013,811839,Kirsh; David Joel,9999,0,9999,0
1739699848559,COGS 190C,014,811843,Jernigan; Terry Lynne,9999,0,9999,0
1739699848559,COGS 190C,015,811844,Tu; Zhuowen,9999,0,9999,0
1739699849584,COGS 190D,A00,811922,Voytek; Bradley Thomas,25,0,25,0
1739699850612,COGS 194,A00,811949,Hill; Seth J,9999,0,9999,0
1739699851639,COGS 202,A00,872444,Khosla; Meenakshi,12,0,25,13
1739699852665,COGS 205,A00,812100,Chiba; Andrea,20,0,20,0
1739699853691,COGS 209,A00,812101,Mukamel; Eran A,25,0,46,21
1739699854720,COGS 210C,A00,812186,Kirsh; David Joel,9999,0,9999,0
1739699854720,COGS 210C,B00,812192,Greene; Deanna Jacquelyn,9999,0,9999,0
1739699854720,COGS 210C,C00,812199,Xia; Haijun,9999,0,9999,0
1739699854720,COGS 210C,D00,812206,Nitz; Douglas A.,9999,0,9999,0
1739699854720,COGS 210C,E00,812207,Hollan; James D.,9999,0,9999,0
1739699854720,COGS 210C,F00,812260,De Sa; Virginia,9999,0,9999,0
1739699854720,COGS 210C,G00,812261,Rossano; Federico,9999,0,9999,0
1739699854720,COGS 210C,H00,812262,Kiyonaga; Anastasia,9999,0,9999,0
1739699854720,COGS 210C,I00,812263,Guo; Philip J,9999,0,9999,0
1739699854720,COGS 210C,J00,812264,Dow; Steven P,9999,0,9999,0
1739699854720,COGS 210C,K00,812265,Bergen; Benjamin,9998,0,9999,1
1739699854720,COGS 210C,L00,812266,Coulson; Seana M,9999,0,9999,0
1739699854720,COGS 210C,M00,812267,Rangel; Lara M,9999,0,9999,0
1739699855747,COGS 211C,A00,812268,Boroditsky; Lera,19,0,20,1
1739699856773,COGS 229,A00,812269,Irani; Lilly C & Shvartzberg Carrio; Manuel,10,0,10,0
1739699857799,COGS 231,A00,812270,Guo; Philip J,0,0,20,20
1739699858828,COGS 238,A00,812271,Bergen; Benjamin,18,0,20,2
1739699859873,COMM 10,A01,807316,Whitworth-Smith; Andrew C,22,0,23,1
1739699859873,COMM 10,A02,807320,Whitworth-Smith; Andrew C,23,0,23,0
1739699859873,COMM 10,A03,807321,Whitworth-Smith; Andrew C,23,0,23,0
1739699859873,COMM 10,A04,807324,Whitworth-Smith; Andrew C,23,0,23,0
1739699859873,COMM 10,A05,807328,Whitworth-Smith; Andrew C,17,0,23,6
1739699859873,COMM 10,A06,807329,Whitworth-Smith; Andrew C,21,0,23,2
1739699859873,COMM 10,A07,807330,Whitworth-Smith; Andrew C,21,0,23,2
1739699859873,COMM 10,A08,807333,Whitworth-Smith; Andrew C,21,0,22,1
1739699859873,COMM 10,A09,807334,Whitworth-Smith; Andrew C,23,0,23,0
1739699859873,COMM 10,A11,807363,Whitworth-Smith; Andrew C,0,0,0,0
1739699859873,COMM 10,A12,807364,Whitworth-Smith; Andrew C,0,0,0,0
1739699859873,COMM 10,A13,807366,Whitworth-Smith; Andrew C,23,0,23,0
1739699859873,COMM 10,A15,807374,Whitworth-Smith; Andrew C,0,0,0,0
1739699859873,COMM 10,A16,807427,Whitworth-Smith; Andrew C,23,0,23,0
1739699859873,COMM 10,A17,807428,Whitworth-Smith; Andrew C,23,0,23,0
1739699859873,COMM 10,A18,807429,Whitworth-Smith; Andrew C,0,0,0,0
1739699860904,COMM 20,A01,807435,Hill; Erin Truesdell,72,0,75,3
1739699861932,COMM 30,A00,807436,Metcalf; Kathryne Young,73,0,75,2
1739699862956,COMM 50,A00,807438,Armenta; John E,22,0,25,3
1739699863981,COMM 80,A01,807440,Campbell; Robert Harold,0,0,0,0
1739699865013,COMM 100B,A01,807446,Serlin; David,20,0,25,5
1739699865013,COMM 100B,A02,807447,Serlin; David,23,0,25,2
1739699865013,COMM 100B,A03,807450,Serlin; David,25,0,25,0
1739699865013,COMM 100B,A05,807453,Serlin; David,23,0,25,2
1739699865013,COMM 100B,A06,807454,Serlin; David,25,0,25,0
1739699865013,COMM 100B,A07,807455,Serlin; David,18,0,25,7
1739699865013,COMM 100B,A08,807458,Serlin; David,22,0,25,3
1739699865013,COMM 100B,A09,807459,Serlin; David,21,0,25,4
1739699865013,COMM 100B,A10,807462,Serlin; David,25,0,25,0
1739699865013,COMM 100B,A11,807464,Serlin; David,25,0,25,0
1739699866040,COMM 101,A01,807470,Davis; Zeinabu I.,15,0,15,0
1739699866040,COMM 101,A02,807513,Davis; Zeinabu I.,15,0,15,0
1739699866040,COMM 101,A03,807516,Davis; Zeinabu I.,15,0,15,0
1739699866040,COMM 101,A04,807517,Davis; Zeinabu I.,14,0,15,1
1739699867069,COMM 101D,A00,807570,Halm; Gavin Patrick,18,0,18,0
1739699868099,COMM 101K,A00,807571,Martinico; Daniel J,16,0,16,0
1739699869129,COMM 101N,A00,807572,Martinico; Daniel J,16,0,16,0
1739699870161,COMM 101T,A00,807573,Halm; Gavin Patrick,17,0,18,1
1739699870161,COMM 101T,B00,807588,Dewey; Matthew D,10,0,10,0
1739699870161,COMM 101T,C00,807592,Dewey; Matthew D,9,0,10,1
1739699871185,COMM 102C,A01,807604,Campion; Camille E,6,0,6,0
1739699871185,COMM 102C,A02,807605,Campion; Camille E,6,0,6,0
1739699871185,COMM 102C,A03,807612,Campion; Camille E,3,0,6,3
1739699872213,COMM 102M,A01,807638,Ahn; Patricia Jeehyun,9,0,9,0
1739699872213,COMM 102M,A02,807639,Ahn; Patricia Jeehyun,7,0,9,2
1739699873241,COMM 106F,A00,807672,McKenna; Denise,69,0,75,6
1739699874268,COMM 106I,A00,807926,Irani; Lilly C,71,0,75,4
1739699875297,COMM 109P,A00,807927,Jack; Caroline Sarah,39,0,40,1
1739699876327,COMM 110M,A00,807928,Abuelhiga; Soraya Jill,40,0,40,0
1739699877356,COMM 113T,A00,807929,Dominguez Rubio; Fernando,39,0,40,1
1739699878381,COMM 114A,A00,807930,Zilberg; Elana,37,0,40,3
1739699879411,COMM 114F,A00,808016,Rojo Solis; Juan Jose,38,0,40,2
1739699880440,COMM 114P,A00,808034,Abuelhiga; Soraya Jill,38,0,40,2
1739699881466,COMM 114W,A00,808035,Walkover; Lillian B,17,0,20,3
1739699882548,COMM 115,A00,808037,Alac; Morana,33,0,35,2
1739699883573,COMM 132,A00,808058,McKenna; Denise,37,0,40,3
1739699884604,COMM 139,A00,808063,Davis; Zeinabu I.,23,0,30,7
1739699885629,COMM 143,A00,808064,Rojo Solis; Juan Jose,38,0,40,2
1739699886654,COMM 146,A00,808068,Ahn; Patricia Jeehyun,34,0,35,1
1739699887682,COMM 155,A00,808072,Pavon Aramburu; Maria Laur,39,0,40,1
1739699888714,COMM 158,A00,808073,Fields; Gary,40,0,40,0
1739699889739,COMM 171,A00,808082,Zilberg; Elana,24,0,25,1
1739699890767,COMM 172,A00,808083,Staff,23,0,25,2
1739699891792,COMM 173,A00,808091,Alac; Morana,25,0,25,0
1739699892826,COMM 180,A00,808162,Leuning; Grant Maurstad,25,0,25,0
1739699893850,COMM 190,A00,808168,Dominguez Rubio; Fernando,22,0,23,1
1739699893850,COMM 190,B00,808169,Harb; Anthony Joseph,22,0,23,1
1739699893850,COMM 190,C00,808170,Rojo Solis; Juan Jose,22,0,23,1
1739699893850,COMM 190,D00,870218,Boateng; Boatema,22,0,23,1
1739699894877,COMM 194,A00,851599,Staff,0,0,0,0
1739699895906,CSE 6R,A01,842851,Moshiri; Niema,142,0,149,7
1739699895906,CSE 6R,B01,876602,Moshiri; Niema,50,0,50,0
1739699896932,CSE 8A,A50,842974,Porter; Leonard Emerson,38,0,38,0
1739699896932,CSE 8A,A51,843001,Porter; Leonard Emerson,37,0,38,1
1739699896932,CSE 8A,A52,843011,Porter; Leonard Emerson,38,0,38,0
1739699896932,CSE 8A,A53,843012,Porter; Leonard Emerson,37,0,38,1
1739699896932,CSE 8A,A54,874345,Porter; Leonard Emerson,38,0,38,0
1739699896932,CSE 8A,A55,874414,Porter; Leonard Emerson,35,0,38,3
1739699896932,CSE 8A,A56,874418,Porter; Leonard Emerson,38,0,38,0
1739699897962,CSE 11,A01,860850,Ochoa; Benjamin Lawrence,300,0,320,20
1739699898987,CSE 12,A01,860851,Cao; Yingjun,117,0,120,3
1739699898987,CSE 12,B01,865865,Cao; Yingjun,109,0,120,11
1739699900013,CSE 20,A01,865892,Jones; Miles E,97,0,100,3
1739699900013,CSE 20,A02,865908,Jones; Miles E,97,0,100,3
1739699901039,CSE 21,A01,865911,Jones; Miles E,97,0,100,3
1739699901039,CSE 21,A02,865914,Jones; Miles E,94,0,100,6
1739699902068,CSE 29,A50,843454,Solares; Edwin A,9,0,10,1
1739699902068,CSE 29,A51,843459,Solares; Edwin A,10,0,10,0
1739699902068,CSE 29,A52,843460,Solares; Edwin A,8,0,10,2
1739699902068,CSE 29,A53,843549,Solares; Edwin A,5,0,5,0
1739699902068,CSE 29,B50,843559,Soosai Raj; Adalbert Geral,5,0,10,5
1739699902068,CSE 29,B51,843750,Soosai Raj; Adalbert Geral,4,0,10,6
1739699902068,CSE 29,B52,843757,Soosai Raj; Adalbert Geral,8,0,10,2
1739699902068,CSE 29,B53,843758,Soosai Raj; Adalbert Geral,4,0,5,1
1739699903094,CSE 30,A01,864415,Chin; Bryan W.,120,0,125,5
1739699903094,CSE 30,B01,864419,Chin; Bryan W.,99,0,100,1
1739699904120,CSE 87,A00,875925,Moshiri; Niema,20,0,20,0
1739699905150,CSE 89,A00,872519,Minnes Kemp; Mor Mia,100,0,100,0
1739699905150,CSE 89,B00,872520,Minnes Kemp; Mor Mia,100,0,100,0
1739699906180,CSE 95,A00,843802,Cao; Yingjun,100,0,100,0
1739699907208,CSE 100,A01,864420,Sahoo; Debashis,100,0,120,20
1739699908242,CSE 101,A01,860868,Impagliazzo; Russell,0,0,10,10
1739699908242,CSE 101,A02,860869,Impagliazzo; Russell,0,0,10,10
1739699908242,CSE 101,A03,860870,Impagliazzo; Russell,6,0,10,4
1739699909273,CSE 105,A01,864426,Lovett; Shachar,222,0,250,28
1739699910298,CSE 107,A01,864427,Bellare; Mihir,92,0,96,4
1739699911327,CSE 110,A50,843823,Powell; Thomas Allan,111,0,116,5
1739699911327,CSE 110,A51,843827,Powell; Thomas Allan,93,0,116,23
1739699911327,CSE 110,A52,843828,Powell; Thomas Allan,106,0,116,10
1739699912360,CSE 120,A01,860871,Ousterhout; Amy,300,0,328,28
1739699913387,CSE 124,A01,864431,Porter; George M,139,0,196,57
1739699914412,CSE 125,A00,843848,Voelker; Geoffrey M.,30,0,30,0
1739699915437,CSE 127,A01,865915,Fernandes; Earlence T,173,0,192,19
1739699916463,CSE 130,A01,865928,Polikarpova; Nadezhda,176,0,192,16
1739699917488,CSE 131,A01,865936,Ding; Yufei,65,0,75,10
1739699918518,CSE 140,A01,865937,Eldon; John,184,0,196,12
1739699919544,CSE 140L,A01,843892,Eldon; John,173,0,196,23
1739699920569,CSE 141,A01,865939,Pannuto; Patrick William,165,0,192,27
1739699921599,CSE 141L,A01,843910,Eldon; John,158,0,196,38
1739699922623,CSE 145,A00,843915,Kastner; Ryan Charles,25,0,25,0
1739699923654,CSE 150A,A01,860873,Bonjour; Trevor,182,0,196,14
1739699924685,CSE 150B,A01,864429,Gao; Sicun,330,0,362,32
1739699925712,CSE 151A,A01,860874,Dasgupta; Sanjoy,297,0,325,28
1739699926739,CSE 151B,A01,864435,Yu; Qi,164,0,192,28
1739699927773,CSE 152B,A01,874283,Chandraker; Manmohan Krishna,57,0,70,13
1739699928798,CSE 153,A01,872732,McAuley; Julian John,181,0,196,15
1739699929829,CSE 153R,A01,872798,McAuley; Julian John,215,0,250,35
1739699929829,CSE 153R,B01,877492,Staff,50,0,50,0
1739699930854,CSE 165,A01,844081,Weibel; Nadir,23,0,35,12
1739699931882,CSE 168,A01,860875,Ramamoorthi; Ravi,23,0,28,5
1739699931882,CSE 168,A02,860876,Ramamoorthi; Ravi,26,0,28,2
1739699932911,CSE 175,A01,865941,Kumar; Rakesh,50,0,50,0
1739699934971,CSE 182,A01,851596,Bafna; Vineet,44,0,49,5
1739699935998,CSE 185,A01,844113,Moshiri; Niema,25,0,45,20
1739699935998,CSE 185,A02,844118,Moshiri; Niema,38,0,45,7
1739699937031,CSE 190,A00,844121,Grier; Daniel T,52,0,52,0
1739699937031,CSE 190,B00,844124,Soosai Raj; Adalbert Geral,82,0,100,18
1739699937031,CSE 190,C00,881308,Prithviraj; Ammanabrolu,45,0,50,5
1739699937031,CSE 190,D00,844127,Stefan; Deian,50,0,50,0
1739699938060,CSE 191,A00,844133,Minnes Kemp; Mor Mia,9999,0,9999,0
1739699939090,CSE 205A,A00,844166,Vianu; Victor Dan,0,0,0,0
1739699940121,CSE 209A,A00,844205,Impagliazzo; Russell,0,0,0,0
1739699941148,CSE 209B,A00,844216,Bellare; Mihir,0,0,0,0
1739699942172,CSE 217,A01,844235,Weibel; Nadir,0,0,0,0
1739699943201,CSE 219,A00,844246,Irani; Lilly C & Shvartzberg Carrio; Manuel,0,0,0,0
1739699944230,CSE 223B,A00,844249,Snoeren; Alex C.,0,0,0,0
1739699945256,CSE 224,A01,864433,Porter; George M,0,0,0,0
1739699946282,CSE 227,A00,844270,Stefan; Deian,0,0,0,0
1739699947312,CSE 229A,A00,844274,Ousterhout; Amy,0,0,0,0
1739699948338,CSE 229C,A00,844280,Fernandes; Earlence T,0,0,0,0
1739699949362,CSE 230,A00,844311,D'Antoni; Loris,0,0,0,0
1739699950386,CSE 237D,A00,844312,Kastner; Ryan Charles,0,0,0,0
1739699951415,CSE 239A,A00,844313,Vianu; Victor Dan,0,0,0,0
1739699952444,CSE 239B,A00,844314,Coblenz; Michael J,0,0,0,0
1739699953469,CSE 240A,A00,844315,Zhao; Jishen,0,0,0,0
1739699954498,CSE 241A,A00,844316,Kahng; Andrew Byun,0,0,0,0
1739699955525,CSE 250A,A00,844317,Bonjour; Trevor,0,0,0,0
1739699956552,CSE 251B,A01,864438,Yu; Qi,0,0,0,0
1739699957581,CSE 252D,A00,844320,Chandraker; Manmohan Krishna,0,0,0,0
1739699958607,CSE 253,A01,872796,McAuley; Julian John,0,0,0,0
1739699959632,CSE 253R,A01,872838,McAuley; Julian John,0,0,0,0
1739699961687,CSE 276F,A01,872476,Su; Hao,0,0,0,0
1739699962716,CSE 283,A00,844332,Bafna; Vineet & Zhong; Sheng,0,0,0,0
1739699963750,CSE 290,A00,844338,Gao; Sicun,0,0,0,0
1739699963750,CSE 290,B00,844366,Pannuto; Patrick William,0,0,0,0
1739699963750,CSE 290,C00,844379,Stefan; Deian,0,0,0,0
1739699963750,CSE 290,D00,881470,Yu; Qi,0,0,0,0
1739699963750,CSE 290,E00,844387,Chern; Albert Ren-Haur,0,0,0,0
1739699963750,CSE 290,F00,891163,Ding; Yufei,0,0,0,0
1739699964779,CSE 291,A00,844398,Bandeira; Nuno Filipe Cabrita,0,0,0,0
1739699964779,CSE 291,B00,844401,Li; Tzumao,0,0,0,0
1739699964779,CSE 291,C00,844402,Heninger; Nadia A,0,0,0,0
1739699964779,CSE 291,D00,844407,Chern; Albert Ren-Haur,0,0,0,0
1739699964779,CSE 291,E00,844409,Savage; Stefan,0,0,0,0
1739699964779,CSE 291,F00,881310,Niethammer; Marc S,0,0,0,0
1739699964779,CSE 291,H00,844419,Kahng; Andrew Byun,0,0,0,0
1739699965838,CSE 293,001,877922,Bafna; Vineet,9999,0,9999,0
1739699965838,CSE 293,002,877923,Bellare; Mihir,9999,0,9999,0
1739699965838,CSE 293,003,877942,Berg-Kirkpatrick; Taylor D,9999,0,9999,0
1739699965838,CSE 293,004,877943,Chandraker; Manmohan Krishna,9999,0,9999,0
1739699965838,CSE 293,005,877945,Cheng; Chung Kuan,9999,0,9999,0
1739699965838,CSE 293,006,877947,Christensen; Henrik I,9999,0,9999,0
1739699965838,CSE 293,007,877950,Coblenz; Michael J,9999,0,9999,0
1739699965838,CSE 293,008,877951,Cottrell; Garrison W,9999,0,9999,0
1739699965838,CSE 293,009,877952,Deutsch; Alin Bernard,9999,0,9999,0
1739699965838,CSE 293,010,877954,Esmaeilzadeh; Hadi,9999,0,9999,0
1739699965838,CSE 293,011,878049,Freund; Yoav,9999,0,9999,0
1739699965838,CSE 293,012,878145,Griswold; William G.,9999,0,9999,0
1739699965838,CSE 293,013,878152,Gymrek; Melissa Ann,9999,0,9999,0
1739699965838,CSE 293,014,878207,Heninger; Nadia A,9999,0,9999,0
1739699965838,CSE 293,015,878221,Impagliazzo; Russell,9999,0,9999,0
1739699965838,CSE 293,016,878223,Jhala; Ranjit,9999,0,9999,0
1739699965838,CSE 293,017,878262,Kahng; Andrew Byun,9999,0,9999,0
1739699965838,CSE 293,018,878267,Kane; Daniel Mertz,9999,0,9999,0
1739699965838,CSE 293,019,878270,Kriegman; David J,9999,0,9999,0
1739699965838,CSE 293,020,878273,Kumar; Arun Kumar,9999,0,9999,0
1739699965838,CSE 293,021,878275,Lerner; Sorin,9999,0,9999,0
1739699965838,CSE 293,022,878276,Lovett; Shachar,9999,0,9999,0
1739699965838,CSE 293,023,878311,McAuley; Julian John,9999,0,9999,0
1739699965838,CSE 293,024,878312,Micciancio; Daniele,9999,0,9999,0
1739699965838,CSE 293,025,878313,Orailoglu; Alex,9999,0,9999,0
1739699965838,CSE 293,026,878314,Pannuto; Patrick William,9999,0,9999,0
1739699965838,CSE 293,027,878315,Paturi; Ramamohan,9999,0,9999,0
1739699965838,CSE 293,028,878330,Polikarpova; Nadezhda,9999,0,9999,0
1739699965838,CSE 293,029,878358,Politz; Joseph Gibbs,9999,0,9999,0
1739699965838,CSE 293,030,878392,Porter; George M,9999,0,9999,0
1739699965838,CSE 293,031,878399,Porter; Leonard Emerson,9999,0,9999,0
1739699965838,CSE 293,032,878415,Ramamoorthi; Ravi,9999,0,9999,0
1739699965838,CSE 293,033,878416,Riek; Laurel D,9999,0,9999,0
1739699965838,CSE 293,034,878417,Sahoo; Debashis,9999,0,9999,0
1739699965838,CSE 293,035,878418,Saul; Lawrence,9999,0,9999,0
1739699965838,CSE 293,036,878419,Savage; Stefan,9999,0,9999,0
1739699965838,CSE 293,037,878420,Schulze; Jurgen P.,9999,0,9999,0
1739699965838,CSE 293,038,878421,Snoeren; Alex C.,9999,0,9999,0
1739699965838,CSE 293,039,878422,Shang; Jingbo,9999,0,9999,0
1739699965838,CSE 293,040,878423,Stefan; Deian,9999,0,9999,0
1739699965838,CSE 293,041,878424,Su; Hao,9999,0,9999,0
1739699965838,CSE 293,042,878425,Swanson; Steven James,9999,0,9999,0
1739699965838,CSE 293,043,878460,Tullsen; Dean Michael,9999,0,9999,0
1739699965838,CSE 293,044,878476,Vaccaro; Kristen Marie,9999,0,9999,0
1739699965838,CSE 293,045,878517,Voelker; Geoffrey M.,9999,0,9999,0
1739699965838,CSE 293,046,878541,Zhao; Jishen,9999,0,9999,0
1739699965838,CSE 293,047,878663,Zhou; Yuan-Yuan,9999,0,9999,0
1739699965838,CSE 293,048,878664,Gao; Sicun,9999,0,9999,0
1739699965838,CSE 293,049,878665,Weibel; Nadir,9999,0,9999,0
1739699965838,CSE 293,050,878666,Gupta; Rajesh K.,9999,0,9999,0
1739699965838,CSE 293,051,878667,Soosai Raj; Adalbert Geral,9999,0,9999,0
1739699965838,CSE 293,052,891170,Tu; Zhuowen,9999,0,9999,0
1739699966865,CSE 294,A00,844429,Voelker; Geoffrey M.,0,0,0,0
1739699967894,CSS 1,A01,864447,Staff,34,0,36,2
1739699967894,CSS 1,A02,864476,Staff,30,0,36,6
1739699967894,CSS 1,A03,864511,Staff,34,0,36,2
1739699967894,CSS 1,A04,864512,Staff,36,0,36,0
1739699968924,CSS 100,A01,864537,Trott; Sean Thomas,30,0,36,6
1739699968924,CSS 100,A02,864538,Trott; Sean Thomas,36,0,36,0
1739699969949,CSS 120,A01,864563,Mignozzetti; Umberto,28,0,28,0
1739699969949,CSS 120,A02,864564,Mignozzetti; Umberto,28,0,30,2
1739699970979,CSS 206,A00,812747,Mukamel; Eran A,6,0,24,18
1739699972008,CSS 209,A00,864566,Mignozzetti; Umberto,27,0,45,18
1739699973043,CSS 296,001,864568,Mignozzetti; Umberto,0,0,0,4
1739699973043,CSS 296,002,864569,Mignozzetti; Umberto,0,0,0,3
1739699973043,CSS 296,003,864571,Leas; Eric Craig,0,0,0,1
1739699973043,CSS 296,004,864577,Okonkwo; Holly,0,0,0,1
1739699973043,CSS 296,005,864605,Fleischer; Jason G,0,0,0,1
1739699973043,CSS 296,006,864634,Creel; Sarah,0,0,0,1
1739699973043,CSS 296,007,864661,Patel; Hemal,0,0,0,1
1739699973043,CSS 296,008,864688,Martin; Isaac,0,0,0,0
1739699973043,CSS 296,009,864697,Styler; William Francis,0,0,0,1
1739699973043,CSS 296,010,864751,Grigoryan; Aram,0,0,0,1
1739699973043,CSS 296,011,864752,Bonjour; Trevor,0,0,0,1
1739699973043,CSS 296,012,864753,Martin; Isaac,0,0,0,2
1739699974068,DDPM 210,A00,814899,Ma; Joseph David,29,0,32,3
1739699975097,DDPM 211,A00,814901,Ma; Joseph David,29,0,32,3
1739699976125,DDPM 214,A00,814907,Ma; Joseph David,29,0,32,3
1739699977152,DERM 296,001,866221,Eichenfield; Dawn Zhang,4,0,5,1
1739699977152,DERM 296,002,866222,Staff,5,0,5,0
1739699977152,DERM 296,003,866229,Staff,5,0,5,0
1739699978192,DOC 3,A01,813868,Staff,0,0,0,0
1739699978192,DOC 3,A02,813884,Staff,0,0,0,0
1739699978192,DOC 3,A03,813885,Staff,0,0,0,0
1739699978192,DOC 3,A04,813886,Staff,0,0,0,0
1739699978192,DOC 3,A05,813887,Staff,0,0,0,0
1739699978192,DOC 3,A06,813888,Staff,0,0,0,0
1739699978192,DOC 3,A07,813889,Staff,0,0,0,0
1739699978192,DOC 3,A08,813890,Staff,0,0,0,0
1739699978192,DOC 3,A09,813891,Staff,0,0,0,0
1739699978192,DOC 3,A10,813892,Staff,0,0,0,0
1739699978192,DOC 3,A11,813893,Staff,0,0,0,0
1739699978192,DOC 3,A12,813894,Staff,0,0,0,0
1739699978192,DOC 3,A13,813895,Staff,0,0,0,0
1739699978192,DOC 3,A14,813896,Staff,0,0,0,0
1739699978192,DOC 3,A15,813897,Staff,0,0,0,0
1739699978192,DOC 3,A16,813898,Staff,0,0,0,0
1739699978192,DOC 3,B01,813900,Staff,0,0,0,0
1739699978192,DOC 3,B02,813901,Staff,0,0,0,0
1739699978192,DOC 3,B03,813902,Staff,0,0,0,0
1739699978192,DOC 3,B04,813903,Staff,0,0,0,0
1739699978192,DOC 3,B05,813904,Staff,0,0,0,0
1739699978192,DOC 3,B06,813905,Staff,0,0,0,0
1739699978192,DOC 3,B07,813906,Staff,0,0,0,0
1739699978192,DOC 3,B08,813907,Staff,0,0,0,0
1739699978192,DOC 3,B09,813908,Staff,0,0,0,0
1739699978192,DOC 3,B10,813910,Staff,0,0,0,0
1739699978192,DOC 3,B11,813911,Staff,0,0,0,0
1739699978192,DOC 3,B12,813913,Staff,0,0,0,0
1739699978192,DOC 3,B13,813914,Staff,0,0,0,0
1739699978192,DOC 3,B14,813915,Staff,0,0,0,0
1739699978192,DOC 3,B15,813916,Staff,0,0,0,0
1739699978192,DOC 3,B16,813917,Staff,0,0,0,0
1739699978192,DOC 3,C01,813919,Staff,0,0,0,0
1739699978192,DOC 3,C02,813920,Staff,0,0,0,0
1739699978192,DOC 3,C03,813921,Staff,0,0,0,0
1739699978192,DOC 3,C04,813922,Staff,0,0,0,0
1739699978192,DOC 3,C05,813923,Staff,0,0,0,0
1739699978192,DOC 3,C06,813926,Staff,0,0,0,0
1739699978192,DOC 3,C07,813927,Staff,0,0,0,0
1739699978192,DOC 3,C08,813928,Staff,0,0,0,0
1739699978192,DOC 3,C09,813929,Staff,0,0,0,0
1739699978192,DOC 3,C10,813931,Staff,0,0,0,0
1739699978192,DOC 3,C11,813932,Staff,0,0,0,0
1739699978192,DOC 3,C12,813933,Staff,0,0,0,0
1739699978192,DOC 3,C13,813936,Staff,0,0,0,0
1739699978192,DOC 3,C14,813937,Staff,0,0,0,0
1739699978192,DOC 3,C15,813938,Staff,0,0,0,0
1739699978192,DOC 3,C16,813939,Staff,0,0,0,0
1739699978192,DOC 3,D01,813942,Staff,0,0,0,0
1739699978192,DOC 3,D02,813943,Staff,0,0,0,0
1739699978192,DOC 3,D03,813944,Staff,0,0,0,0
1739699978192,DOC 3,D04,813945,Staff,0,0,0,0
1739699978192,DOC 3,D05,813979,Staff,0,0,0,0
1739699978192,DOC 3,D06,813981,Staff,0,0,0,0
1739699978192,DOC 3,D07,813985,Staff,0,0,0,0
1739699978192,DOC 3,D08,813986,Staff,0,0,0,0
1739699978192,DOC 3,D09,813988,Staff,0,0,0,0
1739699978192,DOC 3,D10,813991,Staff,0,0,0,0
1739699978192,DOC 3,D11,813993,Staff,0,0,0,0
1739699978192,DOC 3,D12,813994,Staff,0,0,0,0
1739699978192,DOC 3,D13,814000,Staff,0,0,0,0
1739699978192,DOC 3,D14,814002,Staff,0,0,0,0
1739699978192,DOC 3,D15,814003,Staff,0,0,0,0
1739699978192,DOC 3,D16,814012,Staff,0,0,0,0
1739699978192,DOC 3,D17,814014,Staff,0,0,0,0
1739699979221,DOC 100D,A00,814015,Pass; Natalye,24,0,25,1
1739699979221,DOC 100D,B00,814017,Pass; Natalye,24,0,25,1
1739699980257,DSC 10,A01,841644,Tiefenbruck; Janine LoBue,146,0,146,0
1739699980257,DSC 10,B01,870243,Tiefenbruck; Janine LoBue,143,0,146,3
1739699981289,DSC 20,A01,841647,Langlois; Marina,60,0,60,0
1739699981289,DSC 20,B01,841649,Langlois; Marina,60,0,60,0
1739699982323,DSC 30,A01,841651,Liao; Soohyun Nam,189,0,190,1
1739699982323,DSC 30,B01,841653,Liao; Soohyun Nam,188,0,190,2
1739699983353,DSC 40A,A01,841659,Shannon; Kyle Michael,143,0,146,3
1739699984380,DSC 40B,A01,841663,Eldridge; Justin Matthew,175,0,180,5
1739699985410,DSC 80,A01,841667,Rahman; Tauhidur,116,0,120,4
1739699986494,DSC 95,A01,841669,Tiefenbruck; Janine LoBue,40,0,40,0
1739699987521,DSC 100,A01,841671,Salimi; Babak,146,0,146,0
1739699988552,DSC 102,A01,841674,Staff,293,0,300,7
1739699989579,DSC 106,B01,841679,Lau; Samuel Ethan,98,0,100,2
1739699989579,DSC 106,C01,841681,Lau; Samuel Ethan,100,0,100,0
1739699990604,DSC 140A,A01,841683,Ustun; Tevfik Berk,150,0,150,0
1739699991630,DSC 140B,A01,841687,Weng; Tsui-Wei (lily),122,0,125,3
1739699992656,DSC 161,A00,841688,Roberts; Margaret Earling,40,0,40,0
1739699993684,DSC 190,A01,841690,Silberman; Jack,30,0,30,0
1739699993684,DSC 190,B01,841692,Langlois; Marina,99,0,100,1
1739699993684,DSC 190,C01,841694,Weng; Tsui-Wei (lily),28,0,30,2
1739699993684,DSC 190,D01,841696,Ustun; Tevfik Berk,30,0,30,0
1739699994710,DSC 197,001,841699,Eldridge; Justin Matthew,9999,0,9999,0
1739699995738,DSC 204A,A00,841700,Bellur; Umesh,0,0,0,0
1739699996765,DSC 208R,A01,841703,Jin; Haojian,34,0,40,6
1739699997791,DSC 212,A00,841705,Staff,78,0,90,12
1739699998819,DSC 214,A00,841706,Wang; Yusu,0,0,60,60
1739699999846,DSC 232R,A01,841708,Solares; Edwin A,49,0,80,31
1739700000875,DSC 240,A00,841710,Belkin; Mikhail,114,0,120,6
1739700001901,DSC 241,A00,841712,Schwartzman; Armin,20,0,90,70
1739700002926,DSC 255R,A01,841714,Staff,32,0,40,8
1739700003956,DSC 258R,A01,841716,Shang; Jingbo,35,0,60,25
1739700004987,DSC 267R,A01,841718,Danks; David J,53,0,60,7
1739700006018,DSC 291,A00,841719,Ustun; Tevfik Berk,0,0,30,30
1739700006018,DSC 291,B00,841723,Huang; Biwei,3,0,60,57
1739700006018,DSC 291,C00,841724,Weng; Tsui-Wei (lily),0,0,30,30
1739700006018,DSC 291,D00,841725,Hu; Zhiting,54,0,90,36
1739700006018,DSC 291,E00,841726,Warstadt; Alexander Scott,7,0,60,53
1739700007045,DSC 293,A00,841727,Ustun; Tevfik Berk,9995,0,9999,4
1739700008074,DSC 297,001,872917,Rahman; Tauhidur,9999,0,9999,0
1739700009099,DSE 210,A00,869159,Staff,20,0,20,0
1739700010126,DSE 230,A00,813774,Staff,25,0,25,0
1739700011153,DSE 260B,A00,813775,Staff,25,0,25,0
1739700012181,DSGN 1,A01,810429,Klemmer; Scott R,49,0,50,1
1739700012181,DSGN 1,A02,810431,Klemmer; Scott R,49,0,50,1
1739700012181,DSGN 1,A03,810434,Klemmer; Scott R,50,0,50,0
1739700012181,DSGN 1,A04,810436,Klemmer; Scott R,48,0,50,2
1739700012181,DSGN 1,A05,810438,Klemmer; Scott R,39,0,40,1
1739700013208,DSGN 2,A01,810443,Hollan; James D.,49,0,50,1
1739700014239,DSGN 100,A01,811981,Rill; Bryan,18,0,18,0
1739700014239,DSGN 100,A02,811982,Rill; Bryan,10,0,18,8
1739700014239,DSGN 100,A03,811983,Rill; Bryan,15,0,18,3
1739700014239,DSGN 100,A04,812053,Rill; Bryan,6,0,16,10
1739700015265,DSGN 119,A00,812054,Irani; Lilly C & Shvartzberg Carrio; Manuel,63,0,80,17
1739700017321,DSGN 219,A00,812273,Irani; Lilly C & Shvartzberg Carrio; Manuel,12,0,15,3
1739700018350,ECE 5,A01,816583,Morris; Karcher William,0,0,0,0
1739700018350,ECE 5,A02,816584,Morris; Karcher William,0,0,0,0
1739700018350,ECE 5,A03,816586,Morris; Karcher William,22,0,22,0
1739700018350,ECE 5,A04,816589,Morris; Karcher William,22,0,22,0
1739700019376,ECE 15,A01,816591,Sahay; Rajeev,114,0,120,6
1739700020404,ECE 16,A01,816594,Wang; Edward Jay,26,0,30,4
1739700021429,ECE 17,A01,816599,Sahay; Rajeev,67,0,75,8
1739700022461,ECE 25,A50,816722,Dey; Sujit,30,0,30,0
1739700022461,ECE 25,A51,816734,Dey; Sujit,29,0,30,1
1739700023494,ECE 30,A50,816809,Mir Arabbaygi; Siavash,25,0,30,5
1739700023494,ECE 30,A51,816811,Mir Arabbaygi; Siavash,25,0,30,5
1739700023494,ECE 30,A52,816812,Mir Arabbaygi; Siavash,30,0,30,0
1739700023494,ECE 30,A53,816814,Mir Arabbaygi; Siavash,30,0,30,0
1739700023494,ECE 30,A54,816817,Mir Arabbaygi; Siavash,27,0,27,0
1739700024525,ECE 35,A50,816821,Ndao; Abdoulaye,25,0,26,1
1739700024525,ECE 35,A51,816822,Ndao; Abdoulaye,24,0,26,2
1739700024525,ECE 35,A52,816825,Ndao; Abdoulaye,26,0,26,0
1739700024525,ECE 35,A53,816826,Ndao; Abdoulaye,26,0,26,0
1739700025553,ECE 45,A01,816828,Zeger; Kenneth A.,187,0,192,5
1739700026599,ECE 65,A50,816873,Baghdadchi; Saharnaz,28,0,30,2
1739700026599,ECE 65,A51,816874,Baghdadchi; Saharnaz,28,0,30,2
1739700026599,ECE 65,A52,816877,Baghdadchi; Saharnaz,30,0,30,0
1739700026599,ECE 65,A53,816880,Baghdadchi; Saharnaz,30,0,30,0
1739700026599,ECE 65,A54,816882,Baghdadchi; Saharnaz,30,0,30,0
1739700026599,ECE 65,A55,816883,Baghdadchi; Saharnaz,29,0,30,1
1739700026599,ECE 65,A56,816884,Baghdadchi; Saharnaz,30,0,30,0
1739700027632,ECE 100,A01,816926,Hsueh; Tzu-Chien,29,0,30,1
1739700027632,ECE 100,A02,816939,Hsueh; Tzu-Chien,26,0,30,4
1739700027632,ECE 100,A03,816945,Hsueh; Tzu-Chien,29,0,30,1
1739700027632,ECE 100,A04,816950,Hsueh; Tzu-Chien,29,0,30,1
1739700027632,ECE 100,A05,816962,Hsueh; Tzu-Chien,29,0,30,1
1739700028659,ECE 101,A01,816993,Siegel; Paul H.,57,0,60,3
1739700028659,ECE 101,A02,817165,Siegel; Paul H.,57,0,60,3
1739700029687,ECE 103,A01,817352,Nomura; Kenji,43,0,50,7
1739700030719,ECE 108,A01,817373,Kang; Mingu,99,0,120,21
1739700031744,ECE 109,A01,817418,Orlitsky; Alon,72,0,73,1
1739700031744,ECE 109,A02,817420,Orlitsky; Alon,73,0,73,0
1739700032770,ECE 111,A01,817426,Eldon; John,167,0,180,13
1739700033801,ECE 115,A01,817432,Yip; Michael,20,0,26,6
1739700034829,ECE 123,A01,817448,Sievenpiper; Daniel F.,28,0,37,9
1739700035862,ECE 125B,A50,817453,Esmaili; Gholamreza,18,0,24,6
1739700035862,ECE 125B,A51,817455,Esmaili; Gholamreza,23,0,24,1
1739700036888,ECE 134,A00,817457,Ng; Tse Nga,47,0,50,3
1739700037919,ECE 136L,A01,817459,Dayeh; Shadi Ahmad,5,0,5,0
1739700037919,ECE 136L,A02,817461,Dayeh; Shadi Ahmad,2,0,5,3
1739700037919,ECE 136L,A03,817462,Dayeh; Shadi Ahmad,3,0,5,2
1739700037919,ECE 136L,A04,817463,Dayeh; Shadi Ahmad,4,0,5,1
1739700038948,ECE 139,A00,817537,Nomura; Kenji,29,0,30,1
1739700039984,ECE 140B,A50,817654,Khoshabeh; Ramsin & Gessner; Richard K.,23,0,24,1
1739700039984,ECE 140B,A51,817662,Khoshabeh; Ramsin & Gessner; Richard K.,22,0,24,2
1739700039984,ECE 140B,A52,817663,Khoshabeh; Ramsin & Gessner; Richard K.,22,0,22,0
1739700041014,ECE 141B,A01,872372,Gessner; Richard K.,26,0,30,4
1739700042043,ECE 148,A01,817698,Silberman; Jack,22,0,26,4
1739700043073,ECE 153,A01,817703,Naghizadeh Ardabili; Parinaz,74,0,90,16
1739700044102,ECE 157A,A01,817708,Bharadia; Dinesh,21,0,25,4
1739700045129,ECE 161C,A00,817865,Harris; Frederick Joel,48,0,50,2
1739700046161,ECE 165,A51,817880,Mercier; Patrick Philip,26,0,30,4
1739700046161,ECE 165,A52,817882,Mercier; Patrick Philip,23,0,30,7
1739700046161,ECE 165,A53,817885,Mercier; Patrick Philip,27,0,30,3
1739700046161,ECE 165,A54,817888,Mercier; Patrick Philip,29,0,30,1
1739700047191,ECE 171A,A01,817892,Zheng; Yang,93,0,100,7
1739700048221,ECE 175B,A01,817899,Xie; Pengtao,47,0,50,3
1739700049247,ECE 183,A01,817903,Mookherjea; Shayan,26,0,30,4
1739700050274,ECE 185,A01,817907,Liu; Zhaowei,20,0,20,0
1739700051298,ECE 196,A00,817908,Morris; Karcher William,15,0,24,9
1739700051298,ECE 196,B00,817913,Morris; Karcher William,26,0,28,2
1739700052330,ECE 197,001,816579,Mercier; Patrick Philip,9999,0,9999,0
1739700053359,ECE 198,001,816580,Nguyen; Truong Quang,9999,0,9999,0
1739700054383,ECE 204,A00,817918,Alexandrov; Ludmil B,0,0,0,0
1739700055413,ECE 208,A00,817920,Mir Arabbaygi; Siavash,0,0,0,0
1739700056442,ECE 212CN,A00,817921,Liu; Zhaowei,0,0,0,0
1739700057470,ECE 222D,A00,817922,Sievenpiper; Daniel F.,0,0,0,0
1739700058496,ECE 227,A00,817926,Franceschetti; Massimo,0,0,0,0
1739700059525,ECE 228,A00,817928,Shi; Yuanyuan,0,0,0,0
1739700060555,ECE 236B,A00,817929,Lo; Yu-Hwa,0,0,0,0
1739700061586,ECE 238B,A00,817934,Garay; Javier,0,0,0,0
1739700062623,ECE 240C,A00,818013,Mookherjea; Shayan,0,0,0,0
1739700063652,ECE 241A,A00,818014,Rubin; Noah,0,0,0,0
1739700064678,ECE 251B,A00,818015,Vasconcelos; Manuela,0,0,0,0
1739700065704,ECE 258B,A00,818016,Milstein; Laurence B.,0,0,0,0
1739700066733,ECE 260C,A00,818017,Kahng; Andrew Byun,0,0,0,0
1739700067763,ECE 264B,A00,818018,Galton; Ian A,0,0,0,0
1739700068794,ECE 265B,A00,818019,Gudem; Prasad S.S.,0,0,0,0
1739700069819,ECE 266,A01,818021,Hall; Drew A.,0,0,0,0
1739700070845,ECE 268,A00,818022,Koushanfar; Farinaz,0,0,0,0
1739700071874,ECE 272A,A01,818064,Poveda Fonseca; Jorge,0,0,0,0
1739700072900,ECE 273,A00,818065,Wang; Jun-Kun,0,0,0,0
1739700073926,ECE 275A,A00,818066,Meyer; Florian,0,0,0,0
1739700074967,ECE 276B,A00,818067,Atanasov; Nikolay A.,0,0,0,0
1739700075997,ECE 284,A00,818068,Wang; Edward,0,0,0,0
1739700077023,ECE 285,A00,818069,Wang; Xiaolong,0,0,0,0
1739700077023,ECE 285,B00,818070,Antipa; Nicholas A,0,0,0,0
1739700077023,ECE 285,C00,818071,Xie; Pengtao,0,0,0,0
1739700078048,ECE 287,A00,872497,Gonzalez Prelcic; Nuria,0,0,0,0
1739700079078,ECON 1,A01,814026,Famulari; Melissa,118,0,120,2
1739700079078,ECON 1,A02,814028,Famulari; Melissa,114,0,115,1
1739700079078,ECON 1,A03,814029,Famulari; Melissa,115,0,115,0
1739700079078,ECON 1,B01,814039,Famulari; Melissa,46,0,50,4
1739700080104,ECON 2,A01,814045,Crane; Meredith Helen,95,0,96,1
1739700081129,ECON 3,A01,814154,Crane; Meredith Helen,91,0,95,4
1739700081129,ECON 3,A02,814155,Crane; Meredith Helen,93,0,95,2
1739700081129,ECON 3,B01,814188,Crane; Meredith Helen,95,0,95,0
1739700081129,ECON 3,B02,814195,Crane; Meredith Helen,91,0,95,4
1739700082161,ECON 4,A01,814197,Levkoff; Steven B.,50,0,54,4
1739700082161,ECON 4,A02,814210,Levkoff; Steven B.,54,0,54,0
1739700082161,ECON 4,A03,814224,Levkoff; Steven B.,54,0,54,0
1739700082161,ECON 4,B01,814273,Brooks; Marcus Raymond,3,0,3,0
1739700083193,ECON 5,A01,814495,Arnold; David Hall,66,0,72,6
1739700083193,ECON 5,A02,814507,Arnold; David Hall,72,0,72,0
1739700083193,ECON 5,A03,814508,Arnold; David Hall,71,0,72,1
1739700083193,ECON 5,A04,814509,Arnold; David Hall,71,0,72,1
1739700083193,ECON 5,A05,814510,Arnold; David Hall,72,0,72,0
1739700083193,ECON 5,B01,814513,Dai; Yinlin,44,0,45,1
1739700083193,ECON 5,B02,814514,Dai; Yinlin,39,0,45,6
1739700084224,ECON 100A,A01,814516,Newhouse; Herbert S,76,0,79,3
1739700084224,ECON 100A,A02,814517,Newhouse; Herbert S,79,0,79,0
1739700084224,ECON 100A,B01,814519,Newhouse; Herbert S,82,0,83,1
1739700084224,ECON 100A,B02,814520,Newhouse; Herbert S,73,0,75,2
1739700085248,ECON 100AH,A00,814521,Famulari; Melissa,20,0,20,0
1739700086276,ECON 100B,A01,814523,Boomhower; Judson P,74,0,85,11
1739700086276,ECON 100B,A02,814524,Boomhower; Judson P,82,0,85,3
1739700086276,ECON 100B,A03,814525,Boomhower; Judson P,78,0,80,2
1739700086276,ECON 100B,B01,814527,Boomhower; Judson P,0,0,0,0
1739700087300,ECON 100BH,A00,814528,Boomhower; Judson P,20,0,20,0
1739700088329,ECON 100C,A01,814530,Newhouse; Herbert S,95,0,98,3
1739700088329,ECON 100C,A02,814531,Newhouse; Herbert S,98,0,98,0
1739700089357,ECON 101,A00,814532,Esfahani; Sara,112,0,120,8
1739700090440,ECON 109T,A00,814533,Trevino; Isabel,20,0,20,0
1739700091466,ECON 110A,A01,814535,Candido; Maria Teresa,97,0,100,3
1739700092496,ECON 110B,A01,814537,Herreno Lopera; Juan,91,0,100,9
1739700092496,ECON 110B,A02,814538,Herreno Lopera; Juan,100,0,100,0
1739700092496,ECON 110B,A03,814539,Herreno Lopera; Juan,99,0,100,1
1739700092496,ECON 110B,A04,814540,Herreno Lopera; Juan,98,0,100,2
1739700093526,ECON 120A,A01,814542,Dai; Yinlin,90,0,95,5
1739700093526,ECON 120A,A02,814543,Dai; Yinlin,95,0,95,0
1739700093526,ECON 120A,B01,814545,Dai; Yinlin,93,0,95,2
1739700093526,ECON 120A,B02,814546,Dai; Yinlin,94,0,95,1
1739700094553,ECON 120B,A01,814548,Candido; Maria Teresa,91,0,95,4
1739700094553,ECON 120B,A02,814549,Candido; Maria Teresa,89,0,95,6
1739700094553,ECON 120B,B01,814551,Candido; Maria Teresa,91,0,95,4
1739700094553,ECON 120B,B02,814552,Candido; Maria Teresa,95,0,95,0
1739700095585,ECON 120C,A01,814554,Sun; Yixiao,38,0,40,2
1739700095585,ECON 120C,B01,814556,Sun; Yixiao,33,0,40,7
1739700095585,ECON 120C,C01,814585,Sun; Yixiao,39,0,40,1
1739700096611,ECON 125,A00,814588,Vogl; Tom Saul,96,0,100,4
1739700097639,ECON 129,A00,814589,Eckert; Fabian Paul,99,0,100,1
1739700098665,ECON 132,A00,814595,Carson; Richard T,72,0,75,3
1739700098665,ECON 132,B00,814599,Carson; Richard T,73,0,75,2
1739700099695,ECON 132T,A00,814600,Carson; Richard T,20,0,20,0
1739700100721,ECON 134,A00,814601,Gelber; Alexander Michael,47,0,50,3
1739700101750,ECON 137,A00,814602,Niehaus; Paul,20,0,20,0
1739700102775,ECON 140,A00,814630,Clemens; Jeffrey,44,0,49,5
1739700103802,ECON 142,A00,814647,Trevino; Isabel,50,0,50,0
1739700103802,ECON 142,B00,814656,Trevino; Isabel,46,0,50,4
1739700104829,ECON 147,A00,814683,Betts; Julian,100,0,100,0
1739700105859,ECON 164,A00,814684,Muralidharan; Karthik,219,0,220,1
1739700106889,ECON 168,A00,814691,Maron; Asa,74,0,80,6
1739700107918,ECON 173B,A01,814700,Levkoff; Steven B.,39,0,40,1
1739700107918,ECON 173B,B01,814734,Levkoff; Steven B.,40,0,40,0
1739700108947,ECON 191A,A00,814768,Cullen; Julie,20,0,20,0
1739700109979,ECON 200C,A00,814811,Grigoryan; Aram & Trevino; Isabel & Sobel; Joel,24,0,25,1
1739700111006,ECON 210C,A00,814815,Herreno Lopera; Juan,25,0,25,0
1739700112036,ECON 220C,A00,814816,Sun; Yixiao,23,0,25,2
1739700113064,ECON 220F,A00,814817,Carson; Richard T,28,0,30,2
1739700114088,ECON 221,A00,814818,Zhu; Ying,15,0,15,0
1739700115117,ECON 241,A00,814819,Muralidharan; Karthik,14,0,15,1
1739700116147,ECON 243,A00,814820,Niehaus; Paul & Adhvaryu; Achyuta Rasendra,15,0,15,0
1739700117173,ECON 248,A00,814821,Eckert; Fabian Paul & Trottner; Fabian Gunter We,13,0,15,2
1739700118202,ECON 250C,A00,814840,Arnold; David Hall & Betts; Julian,24,0,25,1
1739700119231,ECON 281,A00,814850,Wu; Pak Yeung & Herreno Lopera; Juan,14,0,15,1
1739700120259,ECON 285,A00,814851,Eckert; Fabian Paul,25,0,25,0
1739700121288,ECON 286,A00,814852,Hamilton; James D.,20,0,20,0
1739700121288,ECON 286,B00,814853,Shishkin; Denis,19,0,20,1
1739700122323,ECON 296,A00,814854,Eckert; Fabian Paul,24,0,25,1
1739700123350,EDS 31,A00,815023,Brydges; Stacey,17,0,20,3
1739700124374,EDS 39,A01,815025,Heinzman; Erica M.,25,0,25,0
1739700125402,EDS 102,A01,815042,Hopkins; Megan Beth,40,0,45,5
1739700127458,EDS 115,A00,815058,Jones; Gabrielle Anastasia,48,0,50,2
1739700128486,EDS 117,A01,851605,Jones; Makeba,33,0,37,4
1739700128486,EDS 117,A02,851607,Jones; Makeba,35,0,37,2
1739700128486,EDS 117,A03,851608,Jones; Makeba,38,0,38,0
1739700128486,EDS 117,A04,851610,Jones; Makeba,36,0,38,2
1739700128486,EDS 117,B01,870849,Staff,24,0,25,1
1739700128486,EDS 117,B02,870920,Staff,25,0,25,0
1739700128486,EDS 117,B03,870978,Staff,25,0,25,0
1739700128486,EDS 117,B04,870979,Staff,25,0,25,0
1739700129516,EDS 118,A00,815184,Staff,57,0,60,3
1739700130541,EDS 123,A00,815186,Brydges; Stacey,20,0,20,0
1739700131571,EDS 124AR,A00,815196,Simon; Elizabeth A,189,0,200,11
1739700131571,EDS 124AR,B00,815197,Simon; Elizabeth A,99,0,100,1
1739700131571,EDS 124AR,C00,872649,Simon; Elizabeth A,40,0,40,0
1739700132600,EDS 124BR,A00,815259,Eguchi; Emi,57,0,75,18
1739700132600,EDS 124BR,B00,872641,Eguchi; Emi,25,0,25,0
1739700133628,EDS 125,A00,815260,Aragon; Maria Jose,55,0,60,5
1739700134661,EDS 126,A01,851619,Jones; Makeba,25,0,33,8
1739700134661,EDS 126,A02,815283,Jones; Makeba,31,0,33,2
1739700134661,EDS 126,A03,815284,Jones; Makeba,33,0,34,1
1739700135690,EDS 128B,A01,815311,Pappas; Elizabeth,24,0,25,1
1739700135690,EDS 128B,A02,815312,Pappas; Elizabeth,25,0,25,0
1739700135690,EDS 128B,A03,870748,Pappas; Elizabeth,20,0,20,0
1739700136716,EDS 129C,A01,815314,Millstone; Rachel Diana,60,0,60,0
1739700137744,EDS 130,A01,815383,Mendez; Kathrina Mendoza,18,0,20,2
1739700137744,EDS 130,A02,815384,Mendez; Kathrina Mendoza,20,0,20,0
1739700137744,EDS 130,A03,815390,Mendez; Kathrina Mendoza,20,0,20,0
1739700138774,EDS 133,A01,815456,Bintliff; Amy S.V.,12,0,15,3
1739700138774,EDS 133,A02,815457,Bintliff; Amy S.V.,15,0,15,0
1739700138774,EDS 133,A03,815458,Bintliff; Amy S.V.,14,0,15,1
1739700138774,EDS 133,A04,815459,Bintliff; Amy S.V.,10,0,10,0
1739700139803,EDS 136,A01,815462,Hemans; Patricia Ann Benitez,17,0,20,3
1739700139803,EDS 136,A02,815463,Hemans; Patricia Ann Benitez,20,0,20,0
1739700139803,EDS 136,A03,815467,Hemans; Patricia Ann Benitez,20,0,20,0
1739700140834,EDS 139,A00,815469,Pappas; Elizabeth,47,0,50,3
1739700140834,EDS 139,B00,815470,Millstone; Rachel Diana,60,0,60,0
1739700140834,EDS 139,C00,815471,Mendez; Kathrina Mendoza,58,0,60,2
1739700140834,EDS 139,D00,815472,Bintliff; Amy S.V.,57,0,60,3
1739700140834,EDS 139,E00,815473,Hemans; Patricia Ann Benitez,57,0,60,3
1739700140834,EDS 139,F00,815474,Mamas; Christoforos,32,0,35,3
1739700140834,EDS 139,G00,815583,Choi; Bailey Miyeon,30,0,30,0
1739700140834,EDS 139,H00,815588,Bintliff; Amy S.V.,20,0,20,0
1739700141860,EDS 141,A00,815592,Mamas; Christoforos,34,0,35,1
1739700142889,EDS 145,A01,815629,Choi; Bailey Miyeon,13,0,15,2
1739700142889,EDS 145,A02,815630,Choi; Bailey Miyeon,15,0,15,0
1739700143919,EDS 164R,A01,815632,Staff,37,0,40,3
1739700143919,EDS 164R,B01,872639,Staff,20,0,20,0
1739700144947,EDS 165,A00,815635,Jones; Gabrielle Anastasia,29,0,30,1
1739700145975,EDS 180,A00,815642,Chapman; Thandeka K,24,0,25,1
1739700145975,EDS 180,B00,886111,Eguchi; Emi,30,0,30,0
1739700146999,EDS 190,A00,889678,Bintliff; Amy S.V.,4,0,5,1
1739700148028,EDS 205B,A00,815645,Halter; Christopher P.,48,0,50,2
1739700149053,EDS 253,A00,815646,Staff,14,0,15,1
1739700150081,EDS 266,A00,815647,Phuong; Andrew,11,0,12,1
1739700151107,EDS 282,A00,815649,Daly; Alan J.,15,0,15,0
1739700152135,EDS 287B,A00,815650,Daly; Alan J.,15,0,15,0
1739700153160,EDS 288A,A00,815651,Bjorklund; Peter,15,0,15,0
1739700154184,EDS 288B,A00,815694,Chapman; Thandeka K,19,0,20,1
1739700155211,EDS 288C,A00,815695,Staff,15,0,15,0
1739700156239,EDS 289B,A01,815710,Daly; Alan J.,15,0,15,0
1739700157265,EDS 290,A00,815711,Millstone; Rachel Diana,20,0,20,0
1739700157265,EDS 290,B00,815712,Heinzman; Erica M.,20,0,20,0
1739700157265,EDS 290,C00,815717,Choi; Bailey Miyeon,21,0,21,0
1739700157265,EDS 290,D00,815727,Black; Alison Michelle,20,0,20,0
1739700158291,EDS 293B,A01,815735,Burrell; Sade Renee,15,0,15,0
1739700159317,EDS 294B,A00,815745,Meyerott; Theresa Ann,15,0,15,0
1739700160353,EDS 296,001,814911,Ambo; Theresa Jean,10,0,10,0
1739700160353,EDS 296,002,814917,Aragon; Maria Jose,9,0,10,1
1739700160353,EDS 296,003,814918,Bintliff; Amy S.V.,10,0,10,0
1739700160353,EDS 296,004,814922,Chapman; Thandeka K,10,0,10,0
1739700160353,EDS 296,005,814927,Cohen; Shana R,10,0,10,0
1739700160353,EDS 296,006,814929,Daly; Alan J.,10,0,10,0
1739700160353,EDS 296,007,814930,Eguchi; Emi,10,0,10,0
1739700160353,EDS 296,008,814947,Datnow; Amanda Lee,10,0,10,0
1739700160353,EDS 296,009,814948,Halter; Christopher P.,10,0,10,0
1739700160353,EDS 296,010,814953,Hofstetter; Carolyn,10,0,10,0
1739700160353,EDS 296,011,814954,Hopkins; Megan Beth,10,0,10,0
1739700160353,EDS 296,012,814955,Jones; Gabrielle Anastasia,10,0,10,0
1739700160353,EDS 296,013,814958,Jones; Makeba,10,0,10,0
1739700160353,EDS 296,014,814961,Mamas; Christoforos,10,0,10,0
1739700160353,EDS 296,015,814962,Museus; Samuel David,10,0,10,0
1739700160353,EDS 296,016,814966,Pollock; Mica,10,0,10,0
1739700160353,EDS 296,017,814967,Wishard Guerra; Alison G.,10,0,10,0
1739700160353,EDS 296,018,886234,Clarke; Sherice Nicole,10,0,10,0
1739700160353,EDS 296,019,886235,Cohen; Shana R,10,0,10,0
1739700160353,EDS 296,020,886236,Fine; Sarah,10,0,10,0
1739700161379,EMED 296,001,866359,Daniel; Michelle Marie,4,0,5,1
1739700161379,EMED 296,002,866361,Staff,5,0,5,0
1739700161379,EMED 296,003,866363,Staff,5,0,5,0
1739700162405,ENG 10,A00,813776,Evdokimenko; Ekaterina,60,0,60,0
1739700163433,ENG 30,A01,869879,Schurgers; Curt,30,0,30,0
1739700164464,ENG 100D,A00,813777,Ngo; Anh-Thu T.,43,0,50,7
1739700164464,ENG 100D,B00,887051,Ngo; Anh-Thu T.,48,0,50,2
1739700165494,ENG 100L,A00,813778,Kleissl; Jan,6,0,6,0
1739700165494,ENG 100L,B00,813780,Bratton; Maryann,8,0,8,0
1739700165494,ENG 100L,C00,813781,Yu; Paul K L,8,0,8,0
1739700165494,ENG 100L,D00,813782,Goldberg; Charles G.,6,0,6,0
1739700165494,ENG 100L,E00,813783,de Oliveira; Mauricio,8,0,8,0
1739700165494,ENG 100L,F00,813852,Bratton; Maryann,6,0,6,0
1739700165494,ENG 100L,G00,813856,Boyle; Mary E. T.,15,0,15,0
1739700165494,ENG 100L,H00,813860,Boyle; Mary E. T.,15,0,15,0
1739700166525,ENVR 102,A00,818253,Lin; Cindy Jih-Shing,23,0,25,2
1739700166525,ENVR 102,B00,818254,Montejo; Carolina,25,0,25,0
1739700166525,ENVR 102,C00,818255,Staff,24,0,25,1
1739700166525,ENVR 102,E00,818257,Daly; Heather Marie,18,0,20,2
1739700167559,ENVR 140,A01,818259,Siapno; Jacqueline A,13,0,15,2
1739700167559,ENVR 140,A02,818260,Siapno; Jacqueline A,13,0,15,2
1739700167559,ENVR 140,A03,818261,Siapno; Jacqueline A,13,0,15,2
1739700167559,ENVR 140,A04,818290,Siapno; Jacqueline A,14,0,15,1
1739700168590,ESYS 103,A01,818299,Lerner; Amy M,30,0,34,4
1739700168590,ESYS 103,A02,818300,Lerner; Amy M,33,0,34,1
1739700168590,ESYS 103,A03,818301,Lerner; Amy M,24,0,34,10
1739700168590,ESYS 103,A04,818302,Lerner; Amy M,32,0,34,2
1739700168590,ESYS 103,A05,818322,Lerner; Amy M,31,0,34,3
1739700168590,ESYS 103,A06,818385,Lerner; Amy M,30,0,30,0
1739700169619,ESYS 187C,A01,818387,Hetherington; Elizabeth Dorsey,32,0,40,8
1739700169619,ESYS 187C,A02,818388,Hetherington; Elizabeth Dorsey,39,0,40,1
1739700170653,ETHN 3R,A01,818390,Okonkwo; Holly,20,0,25,5
1739700170653,ETHN 3R,A02,818391,Okonkwo; Holly,24,0,25,1
1739700170653,ETHN 3R,A03,818392,Okonkwo; Holly,23,0,25,2
1739700170653,ETHN 3R,A04,818393,Okonkwo; Holly,23,0,25,2
1739700170653,ETHN 3R,A05,818394,Okonkwo; Holly,22,0,25,3
1739700170653,ETHN 3R,A06,818395,Okonkwo; Holly,22,0,25,3
1739700170653,ETHN 3R,A07,818396,Okonkwo; Holly,23,0,25,2
1739700170653,ETHN 3R,A08,818397,Okonkwo; Holly,25,0,25,0
1739700170653,ETHN 3R,A09,818398,Okonkwo; Holly,25,0,25,0
1739700170653,ETHN 3R,A10,818399,Okonkwo; Holly,23,0,25,2
1739700170653,ETHN 3R,A11,818400,Okonkwo; Holly,24,0,25,1
1739700170653,ETHN 3R,A12,818401,Okonkwo; Holly,24,0,25,1
1739700170653,ETHN 3R,A13,818402,Okonkwo; Holly,24,0,25,1
1739700170653,ETHN 3R,A14,818403,Okonkwo; Holly,23,0,25,2
1739700171684,ETHN 30,A01,818405,Fuste; Jose Ignacio,24,0,25,1
1739700171684,ETHN 30,A02,818406,Fuste; Jose Ignacio,22,0,25,3
1739700171684,ETHN 30,A03,818407,Fuste; Jose Ignacio,25,0,25,0
1739700171684,ETHN 30,A04,818408,Fuste; Jose Ignacio,25,0,25,0
1739700171684,ETHN 30,A05,818409,Fuste; Jose Ignacio,25,0,25,0
1739700171684,ETHN 30,A06,818410,Fuste; Jose Ignacio,25,0,25,0
1739700172708,ETHN 100C,A00,818411,Fuste; Jose Ignacio,32,0,36,4
1739700173748,ETHN 101,A01,818413,Marez; Curtis F.,23,0,25,2
1739700173748,ETHN 101,A02,818414,Marez; Curtis F.,24,0,25,1
1739700173748,ETHN 101,A03,818415,Marez; Curtis F.,25,0,25,0
1739700173748,ETHN 101,A04,818416,Marez; Curtis F.,23,0,25,2
1739700174775,ETHN 108,A00,818418,Hankins; Sarah E.,15,0,20,5
1739700175803,ETHN 110,A00,818419,Klann; Mary Cameron,23,0,30,7
1739700176830,ETHN 112C,A00,818420,Frank; Ross H.,28,0,30,2
1739700177858,ETHN 121R,A00,818422,Choi; Esther Min,35,0,45,10
1739700178887,ETHN 122B,A00,891172,Museus; Samuel David,50,0,50,0
1739700180940,ETHN 127,A00,818424,Cuong; Marisol,27,0,30,3
1739700181965,ETHN 140,A00,818426,Tran; Ly Thi Hai,30,0,30,0
1739700182991,ETHN 142,A00,818429,Wilson; Brenda K,27,0,30,3
1739700184016,ETHN 147,A00,872912,Staff,20,0,20,0
1739700185044,ETHN 171,A00,869845,Gallagher-Geurtsen; Tricia Meghan,29,0,30,1
1739700186072,ETHN 172,A00,818477,Childs; Dennis R.,20,0,20,0
1739700187097,ETHN 174,A00,818481,Childs; Dennis R.,20,0,20,0
1739700188124,ETHN 182,A00,818487,Streeby; Shelley,58,0,60,2
1739700189148,ETHN 183,A00,818489,Cuong; Marisol,21,0,22,1
1739700190178,ETHN 189,A00,818496,Museus; Samuel David,20,0,20,0
1739700191208,ETHN 196H,A00,885505,Fuste; Jose Ignacio,0,0,0,0
1739700191208,ETHN 196H,B00,885506,Klann; Mary Cameron,0,0,0,0
1739700191208,ETHN 196H,C00,885507,Museus; Samuel David,0,0,0,0
1739700191208,ETHN 196H,D00,885524,Taylor-Garcia; Daphne,0,0,0,0
1739700191208,ETHN 196H,E00,885706,Wilson; Brenda K,0,0,0,1
1739700192232,ETHN 200C,A00,818498,Frank; Ross H.,11,0,15,4
1739700193260,ETHN 230,A00,818501,Perreira; Christopher Michael,11,0,15,4
1739700194341,ETHN 291,A00,818504,Streeby; Shelley,15,0,15,0
1739700195369,ETIM 289,A00,818674,Marez; Curtis F.,11,0,15,4
1739700196395,EXPR 100,A00,871385,Staff,9999,0,9999,0
1739700197421,EXPR 105,A00,871455,Staff,9999,0,9999,0
1739700198448,EXPR 201,A00,871548,Staff,9999,0,9999,0
1739700199473,EXPR 205,A00,871602,Staff,9999,0,9999,0
1739700200499,FILM 71,A01,809813,Staff,9,0,10,1
1739700201525,FILM 72,A01,871143,Staff,9,0,10,1
1739700202551,FILM 73,A01,871145,Staff,8,0,10,2
1739700203584,FILM 87,A00,809816,Rahimi; Babak,20,0,20,0
1739700203584,FILM 87,B00,809859,Rahimi; Babak,20,0,20,0
1739700203584,FILM 87,C00,869076,Havis; Allan,19,0,20,1
1739700204621,FMPH 291,A00,818678,Boutelle; Kerri & Eichen; Dawn,13,0,15,2
1739700204621,FMPH 291,B00,818689,Lacroix; Andrea Zauderer,12,0,15,3
1739700204621,FMPH 291,C00,818694,Shadyab; Aladdin Hassan,15,0,15,0
1739700204621,FMPH 291,D00,818695,Salem; Rany Mansour,12,0,15,3
1739700204621,FMPH 291,E00,818704,Shadyab; Aladdin Hassan,14,0,15,1
1739700204621,FMPH 291,F00,872513,Araneta; Maria Rosario Gorrez,12,0,15,3
1739700204621,FMPH 291,G00,876306,Ross; Camille,13,0,15,2
1739700205648,FPM 276,A00,886086,Zhu; Shu-Hong,14,0,15,1
1739700206676,FPM 286,A00,866428,Johnson; Michelle Lee,0,0,0,0
1739700207703,FPM 296,001,866429,Johnson; Michelle Lee,4,0,5,1
1739700207703,FPM 296,002,866430,Araneta; Maria Rosario Gorrez,5,0,5,0
1739700207703,FPM 296,003,866433,Staff,5,0,5,0
1739700208731,FPM 297,001,881032,Strong; David R,9998,0,9999,1
1739700209758,GLBH 20,A00,818752,Elwardani; Nile Regina,143,0,146,3
1739700210782,GLBH 101,A00,818757,Sloane; Julia Kathryn,39,0,40,1
1739700211810,GLBH 107,A00,818758,Wilson; Brenda K,65,0,70,5
1739700212838,GLBH 108,A00,818759,Olivas Hernandez; Olga Lid,68,0,70,2
1739700213866,GLBH 111,A01,818761,Burgos; Jose L.,0,0,0,0
1739700213866,GLBH 111,B01,818763,Burgos; Jose L.,0,0,0,0
1739700214894,GLBH 114W,A00,818764,Walkover; Lillian B,16,0,17,1
1739700216947,GLBH 121,A00,870699,Villarino; Margarita,42,0,44,2
1739700217973,GLBH 130,A00,870701,Schonberg; Jeffrey,38,0,40,2
1739700218998,GLBH 131,A00,870812,Staff,43,0,44,1
1739700220024,GLBH 147,A00,818766,Stewart; Alexander B,38,0,40,2
1739700221050,GLBH 148,A00,818828,Schonberg; Jeffrey,95,0,100,5
1739700222075,GLBH 150B,A00,818838,Kaiser; Bronwyn Nicole,14,0,15,1
1739700223100,GLBH 181,A00,818842,Burgos; Jose L.,207,0,216,9
1739700224129,GLBH 190,A00,870700,Bhavsar; Radhika,44,0,44,0
1739700225157,GLBH 215,A00,818849,Walkover; Lillian B,8,0,16,8
1739700226183,GLBH 260,A00,818858,Elwardani; Nile Regina,16,0,16,0
1739700227209,GSS 20,A00,818859,Siapno; Jacqueline A,27,0,30,3
1739700228236,GSS 21,A00,818860,Gyamfi; Bright,29,0,30,1
1739700229262,HDS 1,A01,819050,Staff,29,0,30,1
1739700229262,HDS 1,A02,819053,Staff,28,0,30,2
1739700229262,HDS 1,A03,819074,Staff,29,0,30,1
1739700229262,HDS 1,A04,819075,Staff,30,0,30,0
1739700229262,HDS 1,A05,819076,Staff,29,0,30,1
1739700229262,HDS 1,A06,819077,Staff,30,0,30,0
1739700229262,HDS 1,A07,819078,Staff,29,0,30,1
1739700230288,HDS 60,A01,819095,Staff,32,0,35,3
1739700230288,HDS 60,A02,819096,Staff,35,0,35,0
1739700231311,HDS 95,A00,819097,Staff,36,0,40,4
1739700232337,HDS 120,A00,819098,Staff,91,0,100,9
1739700233362,HDS 122,A00,819099,Staff,96,0,100,4
1739700234391,HDS 150,A00,819100,Staff,12,0,12,0
1739700234391,HDS 150,B00,819122,Staff,12,0,12,0
1739700234391,HDS 150,C00,819123,Staff,12,0,12,0
1739700235415,HDS 175,A00,819142,Staff,32,0,35,3
1739700236442,HDS 181,A01,819144,Staff,35,0,35,0
1739700237469,HDS 191,A01,819146,Staff,20,0,20,0
1739700237469,HDS 191,B01,819223,Staff,20,0,20,0
1739700238495,HIAF 112,A00,841742,Gyamfi; Bright,45,0,46,1
1739700239521,HIEA 114,A00,841743,Matsumura; Wendy Y,36,0,50,14
1739700240548,HIEA 131,A00,841744,Muscolino; Micah S,41,0,44,3
1739700241577,HIEA 138,A00,841747,Lu; Weijing,30,0,30,0
1739700242601,HIEA 144,A00,870811,Henry; Todd A.,24,0,25,1
1739700243627,HIEU 128,A00,841749,Hansen; Jan Eric,66,0,70,4
1739700244653,HIEU 138,A00,841750,Devereux; Andrew W,53,0,56,3
1739700245679,HIEU 146,A00,841751,Radcliff; Pamela B.,44,0,50,6
1739700246707,HIEU 148,A00,841753,Biess; Frank Peter,116,0,120,4
1739700247732,HIEU 160,A00,841754,Demetriou; Denise,11,0,15,4
1739700248760,HIEU 183,A00,870697,Gallant; Thomas W.,10,0,10,0
1739700249786,HIEU 184,A00,841757,Patterson; Patrick H.,15,0,15,0
1739700250814,HIEU 283,A00,870698,Gallant; Thomas W.,10,0,10,0
1739700251841,HIGL 126,A00,841758,Gerth; Karl G.,34,0,34,0
1739700252872,HIGR 209,A00,841771,Hanna; Mark G.,10,0,10,0
1739700253901,HIGR 210,A00,841772,Gerth; Karl G.,9,0,10,1
1739700254925,HIGR 220,A00,872411,Strasser; Ulrike,9,0,10,1
1739700255954,HIGR 239,A00,841774,Gere; Catherina M.,9,0,10,1
1739700256982,HIGR 240,A00,841777,McKenzie; Kerry V.,9,0,10,1
1739700258008,HIGR 248B,A00,841778,Vitz; Matthew,10,0,10,0
1739700259033,HIGR 280,A00,841779,Devereux; Andrew W,10,0,10,0
1739700260059,HIGR 282,A00,871856,Henry; Todd A.,10,0,10,0
1739700261086,HILA 132,A00,841759,Vitz; Matthew,141,0,146,5
1739700262116,HILA 144P,A00,869962,Murillo; Dana V.,49,0,50,1
1739700263144,HILD 2C,A01,862763,Hendrickson; Gerald M.,30,0,32,2
1739700263144,HILD 2C,A02,862769,Hendrickson; Gerald M.,30,0,32,2
1739700263144,HILD 2C,A03,862772,Hendrickson; Gerald M.,32,0,32,0
1739700263144,HILD 2C,A04,862774,Hendrickson; Gerald M.,32,0,32,0
1739700263144,HILD 2C,A05,862777,Hendrickson; Gerald M.,31,0,32,1
1739700263144,HILD 2C,A06,862778,Hendrickson; Gerald M.,32,0,32,0
1739700264172,HILD 7B,A01,862780,Martinez-Matsuda; Veronica,32,0,32,0
1739700264172,HILD 7B,A02,862781,Martinez-Matsuda; Veronica,32,0,32,0
1739700264172,HILD 7B,A03,862782,Martinez-Matsuda; Veronica,29,0,32,3
1739700264172,HILD 7B,A04,862783,Martinez-Matsuda; Veronica,31,0,32,1
1739700264172,HILD 7B,A05,862784,Martinez-Matsuda; Veronica,28,0,32,4
1739700264172,HILD 7B,A06,862788,Martinez-Matsuda; Veronica,31,0,32,1
1739700264172,HILD 7B,A07,862789,Martinez-Matsuda; Veronica,32,0,32,0
1739700264172,HILD 7B,A08,862797,Martinez-Matsuda; Veronica,32,0,32,0
1739700264172,HILD 7B,A09,862798,Martinez-Matsuda; Veronica,32,0,32,0
1739700264172,HILD 7B,A10,862799,Martinez-Matsuda; Veronica,30,0,32,2
1739700264172,HILD 7B,A11,862801,Martinez-Matsuda; Veronica,32,0,32,0
1739700264172,HILD 7B,A12,862802,Martinez-Matsuda; Veronica,32,0,32,0
1739700265199,HILD 12,A01,862804,Matsumura; Wendy Y,31,0,32,1
1739700265199,HILD 12,A02,862987,Matsumura; Wendy Y,31,0,32,1
1739700265199,HILD 12,A03,862989,Matsumura; Wendy Y,0,0,0,0
1739700265199,HILD 12,A04,862991,Matsumura; Wendy Y,0,0,0,0
1739700265199,HILD 12,A05,863014,Matsumura; Wendy Y,31,0,32,1
1739700265199,HILD 12,A06,863015,Matsumura; Wendy Y,32,0,32,0
1739700266226,HILD 42,A01,863016,Gere; Catherina M.,31,0,32,1
1739700266226,HILD 42,A02,863017,Gere; Catherina M.,32,0,32,0
1739700267252,HINE 115,A00,841762,Balberg; Mira,44,0,56,12
1739700268283,HINE 116,A00,869964,Gokatalay; Semih,35,0,35,0
1739700269312,HINE 120,A00,869963,Gokatalay; Semih,35,0,35,0
1739700270340,HISA 101,A00,871799,De; Aniket,35,0,35,0
1739700271366,HISA 120,A00,871840,De; Aniket,34,0,35,1
1739700272394,HITO 87,A00,841738,Patterson; Patrick H.,15,0,15,0
1739700272394,HITO 87,B00,841740,Patterson; Patrick H.,14,0,15,1
1739700273419,HITO 100,B00,841764,Kwak; Nancy,23,0,25,2
1739700274447,HITO 170,A00,841765,Watts; Edward J.,9,0,10,1
1739700275472,HITO 193,A00,851603,Staff,0,0,0,0
1739700276499,HIUS 104,A00,841766,Hanna; Mark G.,142,0,146,4
1739700277527,HIUS 114A,A00,841767,Lewandoski; Julia Mavis,48,0,50,2
1739700278557,HIUS 144,B00,841769,Daly; Heather Marie,39,0,40,1
1739700279609,HUM 2,A01,832551,Crum; Matthew Stephen,15,0,15,0
1739700279609,HUM 2,A02,832552,Crum; Matthew Stephen,14,0,15,1
1739700279609,HUM 2,A03,832553,Crum; Matthew Stephen,15,0,15,0
1739700279609,HUM 2,A04,832554,Crum; Matthew Stephen,14,0,15,1
1739700279609,HUM 2,A05,832555,Crum; Matthew Stephen,15,0,15,0
1739700279609,HUM 2,A06,832557,Crum; Matthew Stephen,14,0,15,1
1739700279609,HUM 2,A07,832600,Crum; Matthew Stephen,14,0,15,1
1739700279609,HUM 2,A08,832662,Crum; Matthew Stephen,15,0,15,0
1739700279609,HUM 2,A09,832667,Crum; Matthew Stephen,13,0,15,2
1739700279609,HUM 2,A10,832671,Crum; Matthew Stephen,15,0,15,0
1739700279609,HUM 2,A11,832673,Crum; Matthew Stephen,15,0,15,0
1739700279609,HUM 2,A12,832675,Crum; Matthew Stephen,15,0,15,0
1739700279609,HUM 2,A13,832680,Crum; Matthew Stephen,15,0,15,0
1739700279609,HUM 2,A14,832682,Crum; Matthew Stephen,15,0,15,0
1739700279609,HUM 2,B01,832686,Watts; Edward J.,7,0,15,8
1739700279609,HUM 2,B02,832688,Watts; Edward J.,14,0,15,1
1739700279609,HUM 2,B03,832693,Watts; Edward J.,15,0,15,0
1739700279609,HUM 2,B04,832694,Watts; Edward J.,15,0,15,0
1739700279609,HUM 2,B05,832739,Watts; Edward J.,15,0,15,0
1739700279609,HUM 2,B06,832742,Watts; Edward J.,14,0,15,1
1739700279609,HUM 2,B07,832756,Watts; Edward J.,15,0,15,0
1739700279609,HUM 2,B08,832760,Watts; Edward J.,13,0,15,2
1739700279609,HUM 2,B09,832762,Watts; Edward J.,15,0,15,0
1739700279609,HUM 2,B10,832764,Watts; Edward J.,13,0,15,2
1739700279609,HUM 2,B11,832767,Watts; Edward J.,15,0,15,0
1739700279609,HUM 2,B12,832770,Watts; Edward J.,14,0,15,1
1739700279609,HUM 2,B13,832775,Watts; Edward J.,13,0,15,2
1739700279609,HUM 2,B14,832776,Watts; Edward J.,12,0,15,3
1739700279609,HUM 2,C01,832784,Markman; Kristina,15,0,15,0
1739700279609,HUM 2,C02,832785,Markman; Kristina,15,0,15,0
1739700279609,HUM 2,C03,832787,Markman; Kristina,14,0,15,1
1739700279609,HUM 2,C04,832789,Markman; Kristina,6,0,15,9
1739700279609,HUM 2,C05,832790,Markman; Kristina,15,0,15,0
1739700279609,HUM 2,C06,832793,Markman; Kristina,15,0,15,0
1739700279609,HUM 2,C07,832794,Markman; Kristina,15,0,15,0
1739700279609,HUM 2,C08,832804,Markman; Kristina,15,0,15,0
1739700279609,HUM 2,C09,832805,Markman; Kristina,15,0,15,0
1739700279609,HUM 2,C10,832946,Markman; Kristina,14,0,15,1
1739700279609,HUM 2,C11,833014,Markman; Kristina,15,0,15,0
1739700279609,HUM 2,C12,833037,Markman; Kristina,15,0,15,0
1739700279609,HUM 2,C13,833075,Markman; Kristina,15,0,15,0
1739700279609,HUM 2,C14,833078,Markman; Kristina,13,0,15,2
1739700280638,HUM 5,A01,833083,Lyon; Antony J.,21,0,28,7
1739700280638,HUM 5,A02,833086,Lyon; Antony J.,28,0,28,0
1739700280638,HUM 5,A03,833090,Lyon; Antony J.,27,0,28,1
1739700280638,HUM 5,A04,833095,Lyon; Antony J.,26,0,28,2
1739700280638,HUM 5,A05,833096,Lyon; Antony J.,27,0,28,1
1739700280638,HUM 5,A06,833099,Lyon; Antony J.,26,0,28,2
1739700280638,HUM 5,A07,833110,Lyon; Antony J.,26,0,28,2
1739700280638,HUM 5,A08,833112,Lyon; Antony J.,27,0,28,1
1739700280638,HUM 5,B01,833118,Rodriguez; Bretton Sigfred,24,0,28,4
1739700280638,HUM 5,B02,833122,Rodriguez; Bretton Sigfred,25,0,28,3
1739700280638,HUM 5,B03,833128,Rodriguez; Bretton Sigfred,19,0,28,9
1739700280638,HUM 5,B04,833129,Rodriguez; Bretton Sigfred,24,0,28,4
1739700280638,HUM 5,B05,833133,Rodriguez; Bretton Sigfred,27,0,28,1
1739700280638,HUM 5,B06,833138,Rodriguez; Bretton Sigfred,27,0,28,1
1739700280638,HUM 5,B07,833140,Rodriguez; Bretton Sigfred,27,0,28,1
1739700280638,HUM 5,B08,833141,Rodriguez; Bretton Sigfred,28,0,28,0
1739700280638,HUM 5,C01,833158,West; Geoffrey Scott,20,0,28,8
1739700280638,HUM 5,C02,833159,West; Geoffrey Scott,23,0,28,5
1739700280638,HUM 5,C03,833163,West; Geoffrey Scott,28,0,28,0
1739700280638,HUM 5,C04,833165,West; Geoffrey Scott,27,0,28,1
1739700280638,HUM 5,C05,833168,West; Geoffrey Scott,26,0,28,2
1739700280638,HUM 5,C06,833171,West; Geoffrey Scott,23,0,28,5
1739700280638,HUM 5,C07,833172,West; Geoffrey Scott,26,0,28,2
1739700280638,HUM 5,C08,833176,West; Geoffrey Scott,24,0,28,4
1739700281670,HUM 100,A00,833179,Shenoy; Niyati,16,0,16,0
1739700281670,HUM 100,B00,833180,Shenoy; Niyati,16,0,16,0
1739700281670,HUM 100,C00,833187,Zavodny; Tatiana Sophia,15,0,16,1
1739700281670,HUM 100,D00,833190,Zavodny; Tatiana Sophia,15,0,16,1
1739700281670,HUM 100,E00,833196,West; Geoffrey Scott,15,0,16,1
1739700281670,HUM 100,F00,833199,West; Geoffrey Scott,15,0,16,1
1739700282699,INTL 100,A01,819235,Feuer; Anna Stagg,24,0,25,1
1739700282699,INTL 100,A02,819246,Feuer; Anna Stagg,24,0,25,1
1739700282699,INTL 100,A03,819251,Feuer; Anna Stagg,25,0,25,0
1739700282699,INTL 100,A04,819252,Feuer; Anna Stagg,21,0,25,4
1739700282699,INTL 100,A05,819256,Feuer; Anna Stagg,25,0,25,0
1739700282699,INTL 100,A06,819260,Feuer; Anna Stagg,25,0,25,0
1739700283725,INTL 101,A01,819264,McCord; Gordon Carlos,27,0,35,8
1739700283725,INTL 101,A02,819266,McCord; Gordon Carlos,32,0,35,3
1739700284756,INTL 102,A01,819271,Fisk; David Lee,29,0,35,6
1739700284756,INTL 102,A02,819279,Fisk; David Lee,27,0,35,8
1739700285784,INTL 190,A00,819281,Lettieri; Michael Joseph,0,0,0,2
1739700285784,INTL 190,B00,819301,Vos; Stacie N.,0,0,0,0
1739700285784,INTL 190,C00,819303,McIntosh; Justin,0,0,0,2
1739700285784,INTL 190,D00,819389,Segui; Alan S,0,0,0,2
1739700285784,INTL 190,E00,819393,Segui; Alan S,0,0,0,1
1739700285784,INTL 190,F00,819394,Auerbach; Bradford C,0,0,0,0
1739700285784,INTL 190,G00,819395,Samphantharak; Krislert,0,0,0,2
1739700286829,JAPN 10C,A01,819403,Maruyama; Rie,14,0,15,1
1739700286829,JAPN 10C,B01,819406,McKee; Mayumi Mochizuki,13,0,15,2
1739700286829,JAPN 10C,C01,819448,Ross; Kayoko F,14,0,15,1
1739700286829,JAPN 10C,D01,819450,Sato; Kyoko,15,0,15,0
1739700286829,JAPN 10C,E01,819454,Kamioka; Sachiko,13,0,15,2
1739700286829,JAPN 10C,F01,819457,McKee; Mayumi Mochizuki,10,0,15,5
1739700286829,JAPN 10C,G01,819459,Tipton; Yuko,12,0,15,3
1739700286829,JAPN 10C,H01,819466,Sato; Kyoko,15,0,15,0
1739700286829,JAPN 10C,I01,819486,Homma; Kunihiko,14,0,15,1
1739700286829,JAPN 10C,J01,819536,Tipton; Yuko,15,0,15,0
1739700286829,JAPN 10C,K01,819584,Kamioka; Sachiko,14,0,15,1
1739700287859,JAPN 10CR,A01,819684,Inada; Minori,12,0,12,0
1739700287859,JAPN 10CR,B01,819741,McKee; Mayumi Mochizuki,12,0,12,0
1739700288886,JAPN 20C,A01,819791,Iwamoto; Naoki,13,0,13,0
1739700288886,JAPN 20C,B01,819874,Homma; Kunihiko,12,0,13,1
1739700288886,JAPN 20C,C01,819904,Iwamoto; Naoki,12,0,13,1
1739700288886,JAPN 20C,D01,819934,Takeda; Izumi,12,0,13,1
1739700288886,JAPN 20C,E01,819936,Simpson; Junko Tokuda,13,0,13,0
1739700289913,JAPN 130C,A01,819938,Maruyama; Rie,12,0,12,0
1739700289913,JAPN 130C,B01,820148,Kamioka; Sachiko,9,0,12,3
1739700290936,JAPN 135C,A00,820169,Ross; Kayoko F,11,0,12,1
1739700290936,JAPN 135C,B00,820192,Iwamoto; Naoki,10,0,12,2
1739700291960,JAPN 137C,A00,820201,Simpson; Junko Tokuda,17,0,20,3
1739700292987,JAPN 140C,A00,820210,Takeda; Izumi,19,0,20,1
1739700294012,JWSP 3,A01,820218,Shuster; Alana,15,0,15,0
1739700295049,LATI 10,A01,820230,Kennemore; Amy Michelle,28,0,30,2
1739700295049,LATI 10,A02,820286,Kennemore; Amy Michelle,29,0,30,1
1739700295049,LATI 10,A03,820289,Kennemore; Amy Michelle,29,0,30,1
1739700295049,LATI 10,A04,820293,Kennemore; Amy Michelle,29,0,30,1
1739700295049,LATI 10,A05,820380,Kennemore; Amy Michelle,30,0,30,0
1739700295049,LATI 10,A06,820381,Kennemore; Amy Michelle,29,0,30,1
1739700296082,LATI 50,A01,820465,Kokinis; Troy Andreas,29,0,30,1
1739700296082,LATI 50,A02,820466,Kokinis; Troy Andreas,30,0,30,0
1739700296082,LATI 50,A03,820470,Kokinis; Troy Andreas,0,0,0,0
1739700296082,LATI 50,A04,820490,Kokinis; Troy Andreas,0,0,0,0
1739700296082,LATI 50,A05,872455,Kokinis; Troy Andreas,0,0,0,0
1739700297108,LATI 130,A00,820527,Alvarez; Camila Huerta,46,0,46,0
1739700298193,LATI 131,A00,869142,Villafuerte Vazquez; Nadia,30,0,30,0
1739700300248,LATI 166,A00,886084,Kokinis; Troy Andreas,42,0,42,0
1739700301274,LATI 180,A00,820555,Kennemore; Amy Michelle,40,0,44,4
1739700302301,LIAB 1C,B00,820742,Saab; Dima,12,0,14,2
1739700302301,LIAB 1C,C00,820744,Saab; Dima,12,0,14,2
1739700303334,LIAB 1CX,A00,820745,El Cheddadi; Youniss,25,0,28,3
1739700304365,LIAB 1F,A00,872423,El Cheddadi; Youniss,15,0,15,0
1739700305400,LIDS 19,001,886201,Goodall; Grant Todd,9999,0,9999,0
1739700305400,LIDS 19,002,886202,Goodall; Grant Todd,9999,0,9999,0
1739700305400,LIDS 19,003,886204,Goodall; Grant Todd,9999,0,9999,0
1739700305400,LIDS 19,004,886207,Goodall; Grant Todd,9999,0,9999,0
1739700305400,LIDS 19,005,886208,Goodall; Grant Todd,9999,0,9999,0
1739700305400,LIDS 19,006,886209,Goodall; Grant Todd,9999,0,9999,0
1739700305400,LIDS 19,007,886210,Goodall; Grant Todd,9999,0,9999,0
1739700305400,LIDS 19,008,886211,Goodall; Grant Todd,9999,0,9999,0
1739700305400,LIDS 19,009,886213,Goodall; Grant Todd,9999,0,9999,0
1739700305400,LIDS 19,010,886214,Goodall; Grant Todd,9999,0,9999,0
1739700305400,LIDS 19,011,886215,Goodall; Grant Todd,9999,0,9999,0
1739700305400,LIDS 19,012,886216,Goodall; Grant Todd,9999,0,9999,0
1739700306427,LIFR 1A,C00,820857,Van Moer; Vinciane G,12,0,14,2
1739700306427,LIFR 1A,D00,820858,Van Moer; Vinciane G,14,0,14,0
1739700307452,LIFR 1AX,B00,820861,Van Moer; Vinciane G,27,0,28,1
1739700308483,LIFR 1C,A00,820862,Van Moer; Vinciane G,12,0,14,2
1739700308483,LIFR 1C,B00,820916,Van Moer; Vinciane G,12,0,14,2
1739700308483,LIFR 1C,C00,820970,Van Moer; Vinciane G,14,0,14,0
1739700308483,LIFR 1C,D00,820971,Van Moer; Vinciane G,13,0,14,1
1739700309512,LIFR 1CX,A00,820972,Van Moer; Vinciane G,26,0,28,2
1739700309512,LIFR 1CX,B00,820973,Van Moer; Vinciane G,26,0,28,2
1739700310543,LIFR 1D,A00,820974,Van Moer; Vinciane G,13,0,14,1
1739700310543,LIFR 1D,B00,820975,Van Moer; Vinciane G,11,0,14,3
1739700310543,LIFR 1D,C00,820976,Van Moer; Vinciane G,14,0,14,0
1739700310543,LIFR 1D,D00,820977,Van Moer; Vinciane G,14,0,14,0
1739700311572,LIFR 1DX,A00,820978,Van Moer; Vinciane G,25,0,28,3
1739700311572,LIFR 1DX,B00,820979,Van Moer; Vinciane G,28,0,28,0
1739700312602,LIFR 11,001,820980,Goodall; Grant Todd,9999,0,9999,0
1739700313628,LIGM 1C,A00,820981,Fischer-Grunski; Eva K,14,0,14,0
1739700313628,LIGM 1C,B00,820982,Fischer-Grunski; Eva K,11,0,14,3
1739700314653,LIGM 1CX,A00,820985,Fischer-Grunski; Eva K,13,0,14,1
1739700314653,LIGM 1CX,B00,820986,Fischer-Grunski; Eva K,13,0,14,1
1739700315683,LIGM 11,001,820987,Goodall; Grant Todd,9999,0,9999,0
1739700316711,LIGN 8,A00,821976,McIntosh; Justin,238,0,250,12
1739700317739,LIGN 17,A00,821977,Kehler; Andrew Scott,247,0,250,3
1739700318769,LIGN 101,A01,821980,Staff,35,0,35,0
1739700318769,LIGN 101,A02,821982,Staff,35,0,35,0
1739700318769,LIGN 101,A03,821983,Staff,35,0,35,0
1739700318769,LIGN 101,A04,821984,Staff,35,0,35,0
1739700319795,LIGN 113,A00,821985,Styler; William Francis,88,0,90,2
1739700320820,LIGN 117,A00,869927,Kehler; Andrew Scott,42,0,50,8
1739700321846,LIGN 120,A01,821987,Caballero; Gabriela Hernandez,23,0,25,2
1739700321846,LIGN 120,A02,821988,Caballero; Gabriela Hernandez,22,0,25,3
1739700321846,LIGN 120,A03,821990,Caballero; Gabriela Hernandez,20,0,25,5
1739700322883,LIGN 146,A00,821992,Lott; Margaret S.,27,0,30,3
1739700323908,LIGN 165,A00,821993,Bergen; Leon,51,0,70,19
1739700324945,LIGN 180,A00,821994,Kluender; Robert,63,0,70,7
1739700325971,LIGN 188R,A00,821996,Clem; Emily,40,0,40,0
1739700326996,LIGN 200,A00,821997,Warstadt; Alexander Scott,35,0,35,0
1739700328025,LIGN 211,A00,821999,Bakovic; Eric John,20,0,20,0
1739700329051,LIGN 220,A00,822003,Caballero; Gabriela Hernandez,18,0,20,2
1739700330075,LIGN 225,A00,822004,Goodall; Grant Todd,20,0,20,0
1739700331102,LIGN 238,A00,822005,Bergen; Benjamin,20,0,20,0
1739700332125,LIGN 252,A00,822006,Bergen; Leon,14,0,15,1
1739700333153,LIGN 279,A00,822007,Dudley; Rachel,17,0,20,3
1739700334186,LIGN 296,001,821907,Ackerman; Farrell,5,0,5,0
1739700334186,LIGN 296,002,821908,Bakovic; Eric John,5,0,5,0
1739700334186,LIGN 296,003,821909,Bergen; Leon,5,0,5,0
1739700334186,LIGN 296,004,821910,Caballero; Gabriela Hernandez,5,0,5,0
1739700334186,LIGN 296,005,821912,Caponigro; Ivano,5,0,5,0
1739700334186,LIGN 296,006,821913,Clem; Emily,5,0,5,0
1739700334186,LIGN 296,007,821914,Dudley; Rachel,5,0,5,0
1739700334186,LIGN 296,008,821916,Garellek; Marc,5,0,5,0
1739700334186,LIGN 296,009,821917,Goodall; Grant Todd,5,0,5,0
1739700334186,LIGN 296,010,821918,Kehler; Andrew Scott,5,0,5,0
1739700334186,LIGN 296,011,821919,Kluender; Robert,5,0,5,0
1739700334186,LIGN 296,012,821920,Mayberry; Rachel,5,0,5,0
1739700334186,LIGN 296,013,821921,Rose; Sharon,5,0,5,0
1739700334186,LIGN 296,014,821924,Styler; William Francis,5,0,5,0
1739700334186,LIGN 296,015,821925,Warstadt; Alexander Scott,5,0,5,0
1739700335216,LIHL 112P,A00,820733,Pagkalinawan; Leticia Cant,29,0,30,1
1739700336243,LIHL 114P,A00,820734,Nguyen; Hoan Thi,29,0,30,1
1739700337269,LIHL 117P,A00,820735,Sadegholvad; Elham,28,0,28,0
1739700338300,LIHL 118,A00,820736,Chen; Areana Yen,30,0,30,0
1739700339334,LIHL 124P,A00,820737,Nguyen; Hoan Thi,26,0,28,2
1739700340359,LIHL 132P,A00,820738,Pagkalinawan; Leticia Cant,28,0,28,0
1739700341385,LIHL 134P,A00,820739,Nguyen; Hoan Thi,28,0,28,0
1739700342416,LIHL 138,A00,820740,Chen; Areana Yen,15,0,16,1
1739700343441,LIIT 1C,A00,820988,Carnelos; Chiara,13,0,14,1
1739700343441,LIIT 1C,B00,820989,Carnelos; Chiara,9,0,14,5
1739700344469,LIIT 1CX,A00,820990,Carnelos; Chiara,23,0,28,5
1739700345494,LIPO 1C,A00,820991,Paladini; Denise,14,0,14,0
1739700345494,LIPO 1C,B00,820992,Paladini; Denise,14,0,14,0
1739700346521,LIPO 1CX,A00,820993,De Abreu; Cassia,28,0,28,0
1739700347548,LISL 1A,A00,820994,Lott; Margaret S.,13,0,14,1
1739700347548,LISL 1A,B00,820995,Lott; Margaret S.,14,0,14,0
1739700347548,LISL 1A,C00,820996,Lott; Margaret S.,13,0,14,1
1739700347548,LISL 1A,D00,820997,Lott; Margaret S.,14,0,14,0
1739700347548,LISL 1A,E00,820998,Lott; Margaret S.,14,0,14,0
1739700347548,LISL 1A,F00,820999,Lott; Margaret S.,14,0,14,0
1739700348576,LISL 1AR,A00,821000,Lott; Margaret S.,12,0,15,3
1739700348576,LISL 1AR,B00,821001,Lott; Margaret S.,12,0,15,3
1739700348576,LISL 1AR,C00,885716,Lott; Margaret S.,3,0,3,0
1739700348576,LISL 1AR,D00,885778,Lott; Margaret S.,3,0,3,0
1739700349605,LISL 1AX,A00,821002,Lott; Margaret S.,27,0,28,1
1739700349605,LISL 1AX,B00,821003,Lott; Margaret S.,28,0,28,0
1739700349605,LISL 1AX,C00,821004,Lott; Margaret S.,27,0,28,1
1739700350646,LISL 1C,A00,821009,Lott; Margaret S.,12,0,14,2
1739700350646,LISL 1C,B00,821010,Lott; Margaret S.,14,0,14,0
1739700350646,LISL 1C,C00,821011,Lott; Margaret S.,13,0,14,1
1739700350646,LISL 1C,D00,821012,Lott; Margaret S.,14,0,14,0
1739700350646,LISL 1C,E00,821022,Lott; Margaret S.,12,0,14,2
1739700350646,LISL 1C,F00,821023,Lott; Margaret S.,14,0,14,0
1739700351677,LISL 1CX,A00,821024,Lott; Margaret S.,26,0,28,2
1739700351677,LISL 1CX,B00,821027,Lott; Margaret S.,23,0,28,5
1739700351677,LISL 1CX,C00,821029,Lott; Margaret S.,28,0,28,0
1739700352749,LISL 1D,A00,821030,Lott; Margaret S.,13,0,14,1
1739700352749,LISL 1D,B00,821083,Lott; Margaret S.,14,0,14,0
1739700352749,LISL 1D,C00,821084,Lott; Margaret S.,14,0,14,0
1739700352749,LISL 1D,D00,821148,Lott; Margaret S.,8,0,14,6
1739700353775,LISL 1DX,A00,821160,Lott; Margaret S.,23,0,28,5
1739700353775,LISL 1DX,B00,821165,Lott; Margaret S.,27,0,28,1
1739700354803,LISP 1A,001,821174,Munoz Sanchez; Alicia,12,0,14,2
1739700354803,LISP 1A,002,821175,Munoz Sanchez; Alicia,12,0,14,2
1739700354803,LISP 1A,003,821179,Munoz Sanchez; Alicia,12,0,14,2
1739700354803,LISP 1A,004,821180,Munoz Sanchez; Alicia,13,0,14,1
1739700355830,LISP 1AX,001,821196,Munoz Sanchez; Alicia,26,0,28,2
1739700355830,LISP 1AX,002,821204,Munoz Sanchez; Alicia,26,0,28,2
1739700356860,LISP 1C,001,821226,Munoz Sanchez; Alicia,14,0,14,0
1739700356860,LISP 1C,002,821250,Munoz Sanchez; Alicia,13,0,14,1
1739700356860,LISP 1C,003,821251,Munoz Sanchez; Alicia,12,0,14,2
1739700356860,LISP 1C,004,821259,Munoz Sanchez; Alicia,14,0,14,0
1739700356860,LISP 1C,005,821274,Munoz Sanchez; Alicia,12,0,14,2
1739700356860,LISP 1C,006,821280,Munoz Sanchez; Alicia,13,0,14,1
1739700356860,LISP 1C,007,821281,Munoz Sanchez; Alicia,13,0,14,1
1739700356860,LISP 1C,009,821299,Munoz Sanchez; Alicia,13,0,14,1
1739700356860,LISP 1C,010,821300,Munoz Sanchez; Alicia,14,0,14,0
1739700357887,LISP 1CX,001,821305,Munoz Sanchez; Alicia,30,0,32,2
1739700357887,LISP 1CX,002,821312,Munoz Sanchez; Alicia,31,0,32,1
1739700357887,LISP 1CX,004,821314,Munoz Sanchez; Alicia,28,0,32,4
1739700357887,LISP 1CX,005,821343,Munoz Sanchez; Alicia,28,0,32,4
1739700358919,LISP 1D,002,821390,Munoz Sanchez; Alicia,13,0,14,1
1739700358919,LISP 1D,003,821391,Munoz Sanchez; Alicia,14,0,14,0
1739700358919,LISP 1D,004,821392,Munoz Sanchez; Alicia,14,0,14,0
1739700358919,LISP 1D,005,821393,Munoz Sanchez; Alicia,13,0,14,1
1739700358919,LISP 1D,006,821395,Munoz Sanchez; Alicia,13,0,14,1
1739700358919,LISP 1D,007,821396,Munoz Sanchez; Alicia,14,0,14,0
1739700358919,LISP 1D,008,821397,Munoz Sanchez; Alicia,14,0,14,0
1739700358919,LISP 1D,009,821398,Munoz Sanchez; Alicia,14,0,14,0
1739700358919,LISP 1D,011,821400,Munoz Sanchez; Alicia,13,0,14,1
1739700358919,LISP 1D,012,821401,Munoz Sanchez; Alicia,12,0,14,2
1739700358919,LISP 1D,013,821402,Munoz Sanchez; Alicia,14,0,14,0
1739700358919,LISP 1D,014,821403,Munoz Sanchez; Alicia,14,0,14,0
1739700358919,LISP 1D,015,821404,Munoz Sanchez; Alicia,12,0,14,2
1739700358919,LISP 1D,016,821405,Munoz Sanchez; Alicia,11,0,14,3
1739700358919,LISP 1D,017,821406,Munoz Sanchez; Alicia,14,0,14,0
1739700358919,LISP 1D,018,821407,Munoz Sanchez; Alicia,14,0,14,0
1739700358919,LISP 1D,019,821408,Munoz Sanchez; Alicia,14,0,14,0
1739700358919,LISP 1D,020,821409,Munoz Sanchez; Alicia,14,0,14,0
1739700358919,LISP 1D,021,821410,Munoz Sanchez; Alicia,13,0,14,1
1739700358919,LISP 1D,022,821411,Munoz Sanchez; Alicia,14,0,14,0
1739700358919,LISP 1D,023,821412,Munoz Sanchez; Alicia,14,0,14,0
1739700358919,LISP 1D,024,821413,Munoz Sanchez; Alicia,14,0,14,0
1739700359975,LISP 1DX,001,821414,Munoz Sanchez; Alicia,27,0,28,1
1739700359975,LISP 1DX,002,821415,Munoz Sanchez; Alicia,28,0,28,0
1739700359975,LISP 1DX,003,821416,Munoz Sanchez; Alicia,27,0,28,1
1739700359975,LISP 1DX,004,821417,Munoz Sanchez; Alicia,24,0,28,4
1739700359975,LISP 1DX,005,821418,Munoz Sanchez; Alicia,28,0,28,0
1739700359975,LISP 1DX,006,821419,Munoz Sanchez; Alicia,24,0,28,4
1739700359975,LISP 1DX,007,821420,Munoz Sanchez; Alicia,28,0,28,0
1739700359975,LISP 1DX,008,821430,Munoz Sanchez; Alicia,26,0,28,2
1739700359975,LISP 1DX,009,821434,Munoz Sanchez; Alicia,28,0,28,0
1739700359975,LISP 1DX,010,821478,Munoz Sanchez; Alicia,27,0,28,1
1739700359975,LISP 1DX,011,821489,Munoz Sanchez; Alicia,28,0,28,0
1739700361001,LISP 17,001,821599,Munoz Sanchez; Alicia,17,0,20,3
1739700362028,LISP 18,001,821606,Munoz Sanchez; Alicia,18,0,20,2
1739700363069,LTAM 111,A00,822939,Johnson; Sara E.,39,0,40,1
1739700364100,LTCH 101,A00,822940,Liao; Ping H,119,0,120,1
1739700365129,LTCO 287,A00,823141,Vitkus; Daniel J.,14,0,15,1
1739700366152,LTCS 12,A00,822033,Staff,40,0,40,0
1739700367182,LTCS 87,A00,822034,Nguyen; Hoang Tan,19,0,20,1
1739700367182,LTCS 87,B00,822035,Nguyen; Hoang Tan,20,0,20,0
1739700368208,LTCS 111,A00,822941,Bessett; Ryan Matthew,39,0,40,1
1739700369234,LTCS 222,A00,823145,Nguyen; Hoang Tan,12,0,15,3
1739700370261,LTCS 250,A00,823151,Myerston Santana; Jacobo,13,0,15,2
1739700371286,LTEA 100B,A00,822944,Fiss; Geraldine Anna,37,0,40,3
1739700372323,LTEA 110C,A00,822945,Zhu; Ping,39,0,40,1
1739700373348,LTEA 120A,A00,822946,Zhu; Ping,297,0,300,3
1739700374379,LTEN 22,A01,822037,Lu; Lillian,28,0,28,0
1739700374379,LTEN 22,A02,822039,Lu; Lillian,28,0,28,0
1739700374379,LTEN 22,A03,822040,Lu; Lillian,26,0,28,2
1739700374379,LTEN 22,A04,822042,Lu; Lillian,27,0,28,1
1739700375431,LTEN 28,A01,822044,Suzuki; Erin M.,27,0,28,1
1739700375431,LTEN 28,A02,822045,Suzuki; Erin M.,28,0,28,0
1739700375431,LTEN 28,A03,822046,Suzuki; Erin M.,27,0,28,1
1739700375431,LTEN 28,A04,822047,Suzuki; Erin M.,28,0,28,0
1739700375431,LTEN 28,A05,822049,Suzuki; Erin M.,28,0,28,0
1739700375431,LTEN 28,A06,822054,Suzuki; Erin M.,27,0,28,1
1739700375431,LTEN 28,A07,822056,Suzuki; Erin M.,26,0,28,2
1739700375431,LTEN 28,A08,822057,Suzuki; Erin M.,28,0,28,0
1739700376458,LTEN 110,A00,822947,Dhar; Amrita,36,0,40,4
1739700377491,LTEN 127,A00,822948,Garofalo; Devin,36,0,40,4
1739700378515,LTEN 148,A00,822949,Suzuki; Erin M.,35,0,40,5
1739700379547,LTEN 149,A00,872375,Wesling; Megan E.,34,0,40,6
1739700380575,LTEN 181,A00,822950,Mukherjee; Silpa,56,0,60,4
1739700381608,LTEN 183,A00,822951,Childs; Dennis R.,18,0,20,2
1739700382634,LTEN 185,A00,822952,Childs; Dennis R.,19,0,20,1
1739700383660,LTEN 231,A00,823152,Lu; Lillian,13,0,15,2
1739700384687,LTEN 254,A00,823160,Ruiz; Ariana,15,0,15,0
1739700385718,LTEU 110,A00,822953,Kontje; Todd Curtis,38,0,40,2
1739700386744,LTEU 140,A00,872377,De Marchi Gherini; Adriana,38,0,40,2
1739700387779,LTEU 154,A00,872369,Morse; Ainsley,34,0,35,1
1739700388807,LTFR 2A,A01,822059,Ploye; Catherine,28,0,28,0
1739700389833,LTFR 2C,A00,822060,Ploye; Catherine,25,0,25,0
1739700390865,LTFR 141,A00,822955,Zhiri; Oumelbanine,25,0,25,0
1739700391899,LTGK 3,A00,822062,Murray; Kourtney Kristine,31,0,31,0
1739700392927,LTGM 2C,A00,822067,Fischer-Grunski; Eva K,23,0,25,2
1739700393953,LTIT 50,A00,822068,De Marchi Gherini; Adriana,25,0,25,0
1739700394985,LTKO 1C,A01,822071,Jung; Ji Yun,26,0,28,2
1739700394985,LTKO 1C,B01,822075,Jung; Ji Yun,27,0,28,1
1739700394985,LTKO 1C,C01,822078,Lim; Meeyoung,28,0,28,0
1739700394985,LTKO 1C,D01,822098,Yim; Nancy,27,0,28,1
1739700394985,LTKO 1C,E01,822104,Yim; Nancy,28,0,28,0
1739700396016,LTKO 2C,A01,822289,Yim; Nancy,26,0,28,2
1739700397042,LTKO 130P,A00,822956,Lee; Jeyseon,25,0,25,0
1739700398067,LTKO 135,A00,822992,Lee; Jeyseon,25,0,25,0
1739700399095,LTLA 3,A00,822472,Murray; Kourtney Kristine,45,0,45,0
1739700400121,LTRU 1C,A01,822476,Wells; Patricia Rebecca,27,0,28,1
1739700401146,LTRU 104A,A01,823009,Wells; Patricia Rebecca,27,0,28,1
1739700402223,LTRU 150,A00,872370,Morse; Ainsley,5,0,5,0
1739700403256,LTSP 2A,A01,822483,Lampell; Toni,27,0,28,1
1739700404293,LTSP 2B,A01,822508,Mastromartino; Alexandra L,27,0,28,1
1739700405318,LTSP 2C,A01,822534,Lampell; Toni,27,0,28,1
1739700405318,LTSP 2C,B01,822616,Lampell; Toni,28,0,28,0
1739700406345,LTSP 2F,A00,822619,Mastromartino; Alexandra L,25,0,25,0
1739700407379,LTSP 3F,A00,822629,Dominguez; Noelia,25,0,25,0
1739700407379,LTSP 3F,B00,822669,Dominguez; Noelia,25,0,25,0
1739700408412,LTSP 100A,A00,823023,Dominguez; Noelia,24,0,25,1
1739700409447,LTSP 100F,A00,823027,Bessett; Ryan Matthew,25,0,25,0
1739700409447,LTSP 100F,B00,823028,Martin-Cabrera; Luis,24,0,25,1
1739700410479,LTSP 134,A00,823035,Arcos Herrera; Carol,40,0,40,0
1739700411514,LTSP 155,A00,823036,Mendoza; Andrea,39,0,40,1
1739700412538,LTSP 169,A00,823037,Martin-Cabrera; Luis,38,0,40,2
1739700413563,LTSP 175,A00,823038,Arcos Herrera; Carol,39,0,40,1
1739700414589,LTSP 272,A00,823162,Chacon; Gloria Elizabeth,15,0,15,0
1739700415619,LTTH 210C,A00,823163,Glaser; Amelia,15,0,15,0
1739700416650,LTTH 250,A00,823180,Carroll; Amy Sara,12,0,15,3
1739700417680,LTTH 260,A00,823181,Mendoza; Andrea,29,0,30,1
1739700418707,LTWL 12,A00,822679,Villafuerte Vazquez; Nadia,40,0,40,0
1739700419736,LTWL 19C,A00,822710,Kelting; Edward William,37,0,40,3
1739700420761,LTWL 101,A00,823039,Kelting; Edward William,35,0,40,5
1739700421787,LTWL 114,A00,823040,Morse; Ainsley,40,0,40,0
1739700422815,LTWL 128,A00,823041,Cohen; Alain J. J.,39,0,40,1
1739700423843,LTWL 138,A00,823042,Fiss; Geraldine Anna,40,0,40,0
1739700424867,LTWL 180,A00,823045,Mukherjee; Silpa,39,0,40,1
1739700425892,LTWL 184,A00,823046,Cohen; Alain J. J.,40,0,40,0
1739700426916,LTWL 192,A00,823047,Blanco; John D,20,0,20,0
1739700427941,LTWL 194A,A00,823048,Suzuki; Erin M.,27,0,30,3
1739700428971,LTWR 8A,A01,822713,Jemc; Jaclyn,28,0,28,0
1739700428971,LTWR 8A,A02,822863,Jemc; Jaclyn,27,0,28,1
1739700428971,LTWR 8A,A03,822923,Jemc; Jaclyn,28,0,28,0
1739700428971,LTWR 8A,A04,822932,Jemc; Jaclyn,26,0,28,2
1739700429998,LTWR 8C,A01,822935,Wilkinson; Marco,26,0,28,2
1739700429998,LTWR 8C,A02,822936,Wilkinson; Marco,27,0,28,1
1739700429998,LTWR 8C,A03,822937,Wilkinson; Marco,27,0,28,1
1739700429998,LTWR 8C,A04,822938,Wilkinson; Marco,25,0,28,3
1739700431023,LTWR 100W,A00,854460,Terry; Christopher,7,0,15,8
1739700432049,LTWR 102W,A00,823049,Doller; Ben,12,0,15,3
1739700433075,LTWR 106C,A00,823050,Terry; Christopher,27,0,30,3
1739700434105,LTWR 109C,A00,823080,Doller; Ben,28,0,30,2
1739700435130,LTWR 113C,A00,823093,Som; Brandon D,29,0,30,1
1739700436163,LTWR 115W,A00,823096,Springer; Anna Joy,13,0,15,2
1739700437192,LTWR 119C,A00,823099,Copp; Corina,28,0,30,2
1739700438222,LTWR 124W,A00,823102,Copp; Corina,15,0,15,0
1739700439247,LTWR 126C,A00,823108,Terry; Christopher,29,0,30,1
1739700440273,LTWR 140,A00,823133,Carroll; Amy Sara,30,0,30,0
1739700441299,LTWR 148,A00,823136,Wilkinson; Marco,39,0,40,1
1739700442326,LTWR 215,A00,823218,Jemc; Jaclyn,18,0,20,2
1739700443360,MAE 3,A01,825269,Delson; Nathan Joseph,13,0,16,3
1739700443360,MAE 3,A02,825273,Delson; Nathan Joseph,13,0,16,3
1739700443360,MAE 3,A03,825278,Delson; Nathan Joseph,11,0,16,5
1739700443360,MAE 3,A04,825280,Delson; Nathan Joseph,14,0,16,2
1739700443360,MAE 3,B01,825301,Morimoto; Tania,12,0,16,4
1739700443360,MAE 3,B02,825303,Morimoto; Tania,6,0,16,10
1739700443360,MAE 3,B03,825312,Morimoto; Tania,16,0,16,0
1739700443360,MAE 3,B04,825343,Morimoto; Tania,16,0,16,0
1739700444385,MAE 8,A01,825350,Qian; Kai,93,0,100,7
1739700445411,MAE 30B,A00,825352,Lubarda; Marko,96,0,100,4
1739700445411,MAE 30B,B00,825362,Ghazinejad; Maziar,85,0,100,15
1739700446440,MAE 87,A00,872412,Mullin; Jennifer S & Twomey; Robert Daniel,10,0,10,0
1739700447471,MAE 101B,A00,825363,Nomura; Keiko K.,143,0,146,3
1739700448496,MAE 101C,A00,825364,Staff,0,0,0,0
1739700449522,MAE 101D,A00,825378,Coimbra; Carlos F.,16,0,25,9
1739700450548,MAE 104,A00,825379,Pham; Hieu Tan,91,0,100,9
1739700451574,MAE 105,A00,825380,Bandaru; Prabhakar,95,0,100,5
1739700452599,MAE 107,A00,825381,Lindsey; Stephanie,94,0,100,6
1739700453624,MAE 119,A00,825382,Hidalgo-Gonzalez; Patricia,123,0,146,23
1739700454655,MAE 131A,A00,825385,Qi; Huihui,84,0,100,16
1739700454655,MAE 131A,B00,825435,Luan; Haiwen,99,0,100,1
1739700455681,MAE 143B,A00,825498,Diagne; Mamadou Lamine,62,0,80,18
1739700455681,MAE 143B,B00,825499,Kramer; Boris,92,0,96,4
1739700456708,MAE 148,A01,825502,Silberman; Jack,17,0,26,9
1739700457739,MAE 150,A00,825505,Friend; James Robert,115,0,120,5
1739700458766,MAE 152,A00,886080,Llewellyn Smith; Stefan G.,16,0,16,0
1739700458766,MAE 152,B00,886081,Llewellyn Smith; Stefan G.,16,0,16,0
1739700458766,MAE 152,C00,886082,Llewellyn Smith; Stefan G.,14,0,16,2
1739700458766,MAE 152,D00,886083,Llewellyn Smith; Stefan G.,16,0,16,0
1739700459793,MAE 155B,A01,825508,Anderson; Mark Ronald,17,0,50,33
1739700459793,MAE 155B,B01,825515,Hwang; John T,36,0,50,14
1739700460823,MAE 156B,D01,825618,Tustaniwskyj; Jerry I,30,0,35,5
1739700460823,MAE 156B,A01,825549,Delson; Nathan Joseph,34,0,35,1
1739700460823,MAE 156B,B01,825595,Ghazinejad; Maziar,30,0,35,5
1739700460823,MAE 156B,C01,825604,Pawlak; Geno Ronald,32,0,35,3
1739700460823,MAE 156B,F01,825626,Saha; Abhishek,34,0,35,1
1739700460823,MAE 156B,G01,825631,Qi; Huihui,32,0,35,3
1739700461855,MAE 170,A01,825636,Lubarda; Marko,27,0,32,5
1739700461855,MAE 170,A02,825638,Lubarda; Marko,31,0,32,1
1739700461855,MAE 170,A03,825639,Lubarda; Marko,31,0,32,1
1739700461855,MAE 170,B04,825643,Evdokimenko; Ekaterina,28,0,32,4
1739700461855,MAE 170,B05,825645,Evdokimenko; Ekaterina,21,0,32,11
1739700461855,MAE 170,B06,825648,Evdokimenko; Ekaterina,26,0,32,6
1739700462888,MAE 171A,A01,825655,Tynan; George Robert,22,0,30,8
1739700462888,MAE 171A,A02,825657,Tynan; George Robert,29,0,30,1
1739700463919,MAE 175A,A01,825661,de Callafon; Raymond A,20,0,20,0
1739700463919,MAE 175A,A02,825662,de Callafon; Raymond A,14,0,20,6
1739700464952,MAE 184,A00,825714,Anderson; Mark Ronald,23,0,60,37
1739700465983,MAE 185,A00,825715,Schmidt; Oliver,28,0,60,32
1739700467009,MAE 190,A00,825719,Beg; Farhat N.,34,0,40,6
1739700467009,MAE 190,B00,825720,Tynan; George Robert & Mullin; Jennifer S,57,0,60,3
1739700467009,MAE 190,C00,869044,Gerardo; Hortense Flotilde,13,0,14,1
1739700468037,MAE 205,A00,825721,Herbert; Sylvia Lee & Pawlak; Geno Ronald & Mullin; Jennifer S & Lindsey; Stephanie & Cai; Shengqiang & Beg; Farhat N.,9995,0,9999,4
1739700469062,MAE 207,A00,825722,Beg; Farhat N.,7,0,10,3
1739700469062,MAE 207,B00,869156,Gerardo; Hortense Flotilde,24,0,30,6
1739700470095,MAE 209,A00,825723,Scholtes Acevedo; Claire,18,0,30,12
1739700471122,MAE 210C,A00,869158,Sanchez; Antonio Luis,9,0,15,6
1739700472155,MAE 214A,A00,825724,Sarkar; Sutanu,0,0,20,20
1739700473181,MAE 217C,A00,825725,Marinoni; Alessandro,12,0,15,3
1739700474206,MAE 221D,A00,825726,Poulikakos; Lisa Voula,0,0,15,15
1739700475239,MAE 223,A01,825729,Lucas; Andrew J.,0,0,32,32
1739700476271,MAE 224A,A00,825731,Pawlak; Geno Ronald,0,0,10,10
1739700477295,MAE 227,A00,825732,Hidalgo-Gonzalez; Patricia,0,0,15,15
1739700478326,MAE 231B,A00,825733,Boechler; Nicholas Sebastia,28,0,30,2
1739700479351,MAE 240,A00,825734,Rosengren; Aaron,22,0,40,18
1739700480381,MAE 242,A00,825735,Martinez; Sonia,0,0,40,40
1739700481406,MAE 243,A00,869161,Davidson; Michael R,11,0,20,9
1739700482430,MAE 254,A00,825736,Chen; Renkun,0,0,15,15
1739700483454,MAE 256,A00,825740,Coimbra; Carlos F.,7,0,15,8
1739700484481,MAE 266,A00,825741,Evdokimenko; Ekaterina,0,0,20,20
1739700485507,MAE 269,A00,825837,Gravish; Nicholas G,0,0,35,35
1739700486532,MAE 271B,A00,825838,Garay; Javier,5,0,5,0
1739700487562,MAE 272,A00,825839,Meyers; Marc,4,0,15,11
1739700488588,MAE 280B,A00,825840,de Callafon; Raymond A,11,0,40,29
1739700489615,MAE 281B,A00,825842,Cortes; Jorge,7,0,20,13
1739700490639,MAE 289C,A00,825843,McEneaney; William Michael,8,0,10,2
1739700491666,MAE 290C,A00,825846,Schmidt; Oliver,27,0,30,3
1739700492690,MAE 294C,A01,825850,Young; William Roy,10,0,10,0
1739700493721,MATH 2,A01,848213,Cheng; Hsiao-Bing,187,0,190,3
1739700494750,MATH 3B,A01,848358,Ohm; Ko Woon,28,0,30,2
1739700494750,MATH 3B,A02,848359,Ohm; Ko Woon,30,0,30,0
1739700494750,MATH 3B,A03,848368,Ohm; Ko Woon,18,0,30,12
1739700494750,MATH 3B,A04,848369,Ohm; Ko Woon,30,0,30,0
1739700495778,MATH 3C,A01,848397,Anzaldo; Leesa B,20,0,28,8
1739700495778,MATH 3C,A02,848398,Anzaldo; Leesa B,28,0,28,0
1739700495778,MATH 3C,A03,848399,Anzaldo; Leesa B,28,0,28,0
1739700495778,MATH 3C,A04,848400,Anzaldo; Leesa B,28,0,28,0
1739700495778,MATH 3C,B01,848423,Nandi; Achinta Kumar,24,0,30,6
1739700495778,MATH 3C,B02,848439,Nandi; Achinta Kumar,30,0,30,0
1739700495778,MATH 3C,B03,848458,Nandi; Achinta Kumar,29,0,30,1
1739700495778,MATH 3C,B04,848459,Nandi; Achinta Kumar,30,0,30,0
1739700496803,MATH 4C,A01,848474,Briones; Jor-el Thomas Caparas,31,0,35,4
1739700496803,MATH 4C,A02,848476,Briones; Jor-el Thomas Caparas,35,0,36,1
1739700496803,MATH 4C,A03,848479,Briones; Jor-el Thomas Caparas,36,0,36,0
1739700496803,MATH 4C,A04,848481,Briones; Jor-el Thomas Caparas,36,0,36,0
1739700497831,MATH 10A,A01,848484,Briones; Jor-el Thomas Caparas,31,0,33,2
1739700497831,MATH 10A,A02,848490,Briones; Jor-el Thomas Caparas,32,0,33,1
1739700497831,MATH 10A,A03,848495,Briones; Jor-el Thomas Caparas,21,0,33,12
1739700497831,MATH 10A,A04,848508,Briones; Jor-el Thomas Caparas,19,0,33,14
1739700497831,MATH 10A,A05,848517,Briones; Jor-el Thomas Caparas,30,0,33,3
1739700497831,MATH 10A,A06,848518,Briones; Jor-el Thomas Caparas,33,0,33,0
1739700497831,MATH 10A,B01,848521,Bach; Quang Tran,30,0,31,1
1739700497831,MATH 10A,B02,848523,Bach; Quang Tran,31,0,32,1
1739700497831,MATH 10A,B03,848542,Bach; Quang Tran,33,0,33,0
1739700497831,MATH 10A,B04,848543,Bach; Quang Tran,33,0,33,0
1739700497831,MATH 10A,B05,848544,Bach; Quang Tran,28,0,33,5
1739700497831,MATH 10A,B06,848545,Bach; Quang Tran,33,0,33,0
1739700498859,MATH 10B,A01,848547,Zhao; Yizhen,33,0,33,0
1739700498859,MATH 10B,A02,848548,Zhao; Yizhen,33,0,33,0
1739700498859,MATH 10B,A03,848557,Zhao; Yizhen,32,0,33,1
1739700498859,MATH 10B,A04,848558,Zhao; Yizhen,32,0,33,1
1739700498859,MATH 10B,B01,848583,Zhao; Yizhen,55,0,60,5
1739700498859,MATH 10B,B02,848585,Zhao; Yizhen,59,0,60,1
1739700498859,MATH 10B,B03,848586,Zhao; Yizhen,31,0,33,2
1739700498859,MATH 10B,B04,848588,Zhao; Yizhen,32,0,33,1
1739700498859,MATH 10B,C01,848591,Ophir; Amit,30,0,30,0
1739700498859,MATH 10B,C02,848592,Ophir; Amit,29,0,30,1
1739700498859,MATH 10B,C03,848593,Ophir; Amit,30,0,30,0
1739700498859,MATH 10B,C04,848595,Ophir; Amit,30,0,30,0
1739700498859,MATH 10B,D01,848651,Buzaglo; Lucas,8,0,30,22
1739700498859,MATH 10B,D02,848653,Buzaglo; Lucas,26,0,32,6
1739700498859,MATH 10B,D03,848672,Buzaglo; Lucas,31,0,33,2
1739700498859,MATH 10B,D04,848691,Buzaglo; Lucas,33,0,33,0
1739700498859,MATH 10B,D05,848700,Buzaglo; Lucas,28,0,33,5
1739700498859,MATH 10B,D06,848702,Buzaglo; Lucas,27,0,33,6
1739700499885,MATH 10C,A01,848704,Ho; Ching Wei,12,0,27,15
1739700499885,MATH 10C,A02,848706,Ho; Ching Wei,28,0,33,5
1739700499885,MATH 10C,A03,848708,Ho; Ching Wei,29,0,33,4
1739700499885,MATH 10C,A04,848709,Ho; Ching Wei,33,0,33,0
1739700499885,MATH 10C,A05,848711,Ho; Ching Wei,32,0,33,1
1739700499885,MATH 10C,A06,848712,Ho; Ching Wei,32,0,33,1
1739700499885,MATH 10C,B01,848716,Staff,28,0,35,7
1739700499885,MATH 10C,B02,848766,Staff,33,0,35,2
1739700499885,MATH 10C,B03,848767,Staff,33,0,35,2
1739700499885,MATH 10C,B04,848772,Staff,35,0,35,0
1739700499885,MATH 10C,C01,848775,Cheng; Hsiao-Bing,28,0,35,7
1739700499885,MATH 10C,C02,848779,Cheng; Hsiao-Bing,35,0,35,0
1739700499885,MATH 10C,C03,848780,Cheng; Hsiao-Bing,35,0,35,0
1739700499885,MATH 10C,C04,848781,Cheng; Hsiao-Bing,35,0,35,0
1739700500912,MATH 11,A01,848784,Peca-Medlin; John Michael,18,0,28,10
1739700500912,MATH 11,A02,848786,Peca-Medlin; John Michael,28,0,33,5
1739700500912,MATH 11,A03,848788,Peca-Medlin; John Michael,33,0,33,0
1739700500912,MATH 11,A04,848791,Peca-Medlin; John Michael,33,0,33,0
1739700500912,MATH 11,A05,848793,Peca-Medlin; John Michael,55,0,55,0
1739700500912,MATH 11,A06,848794,Peca-Medlin; John Michael,55,0,55,0
1739700500912,MATH 11,B01,848798,Peca-Medlin; John Michael,54,0,55,1
1739700500912,MATH 11,B02,848799,Peca-Medlin; John Michael,55,0,55,0
1739700500912,MATH 11,B03,848800,Peca-Medlin; John Michael,26,0,33,7
1739700500912,MATH 11,B04,848801,Peca-Medlin; John Michael,31,0,33,2
1739700500912,MATH 11,B05,848843,Peca-Medlin; John Michael,33,0,33,0
1739700500912,MATH 11,B06,848844,Peca-Medlin; John Michael,33,0,33,0
1739700501945,MATH 18,A01,848854,Hiatt; Patrick John,32,0,35,3
1739700501945,MATH 18,A02,848859,Hiatt; Patrick John,35,0,35,0
1739700501945,MATH 18,A03,848860,Hiatt; Patrick John,34,0,35,1
1739700501945,MATH 18,A04,848861,Hiatt; Patrick John,35,0,35,0
1739700501945,MATH 18,A05,872522,Hiatt; Patrick John,33,0,35,2
1739700501945,MATH 18,A06,872523,Hiatt; Patrick John,35,0,35,0
1739700501945,MATH 18,B01,848869,Anzaldo; Leesa B,35,0,40,5
1739700501945,MATH 18,B02,848873,Anzaldo; Leesa B,20,0,35,15
1739700501945,MATH 18,B03,848877,Anzaldo; Leesa B,37,0,40,3
1739700501945,MATH 18,B04,848880,Anzaldo; Leesa B,38,0,40,2
1739700501945,MATH 18,B05,848882,Anzaldo; Leesa B,40,0,40,0
1739700501945,MATH 18,B06,848883,Anzaldo; Leesa B,35,0,40,5
1739700501945,MATH 18,B07,848884,Anzaldo; Leesa B,38,0,40,2
1739700501945,MATH 18,B08,848924,Anzaldo; Leesa B,38,0,40,2
1739700501945,MATH 18,C01,849043,Hiatt; Patrick John,34,0,35,1
1739700501945,MATH 18,C02,849044,Hiatt; Patrick John,35,0,35,0
1739700501945,MATH 18,C03,849045,Hiatt; Patrick John,35,0,35,0
1739700501945,MATH 18,C04,849047,Hiatt; Patrick John,33,0,35,2
1739700501945,MATH 18,C05,872524,Hiatt; Patrick John,34,0,35,1
1739700501945,MATH 18,C06,872525,Hiatt; Patrick John,35,0,35,0
1739700501945,MATH 18,D01,849050,Staff,35,0,35,0
1739700501945,MATH 18,D02,849053,Staff,35,0,35,0
1739700501945,MATH 18,D03,849054,Staff,35,0,35,0
1739700501945,MATH 18,D04,849055,Staff,35,0,35,0
1739700501945,MATH 18,D05,872526,Staff,34,0,35,1
1739700501945,MATH 18,D06,872528,Staff,35,0,35,0
1739700502972,MATH 20A,A01,849061,Ho; Ching Wei,28,0,32,4
1739700502972,MATH 20A,A02,849062,Ho; Ching Wei,34,0,35,1
1739700502972,MATH 20A,A03,849064,Ho; Ching Wei,35,0,35,0
1739700502972,MATH 20A,A04,849065,Ho; Ching Wei,35,0,35,0
1739700502972,MATH 20A,B01,849087,Bowers; Adam R.,28,0,35,7
1739700502972,MATH 20A,B02,849100,Bowers; Adam R.,35,0,35,0
1739700502972,MATH 20A,B03,849110,Bowers; Adam R.,34,0,35,1
1739700502972,MATH 20A,B04,849111,Bowers; Adam R.,34,0,35,1
1739700504010,MATH 20B,A01,849131,Staff,58,0,60,2
1739700504010,MATH 20B,A02,849242,Staff,60,0,60,0
1739700504010,MATH 20B,A03,849315,Staff,58,0,60,2
1739700504010,MATH 20B,A04,849319,Staff,60,0,60,0
1739700504010,MATH 20B,B01,849438,Xu; Fengmin,60,0,60,0
1739700504010,MATH 20B,B02,849447,Xu; Fengmin,57,0,60,3
1739700504010,MATH 20B,B03,849463,Xu; Fengmin,14,0,34,20
1739700504010,MATH 20B,B04,849465,Xu; Fengmin,36,0,37,1
1739700505045,MATH 20C,A01,849482,Shakeel; Asif,27,0,32,5
1739700505045,MATH 20C,A02,849484,Shakeel; Asif,31,0,32,1
1739700505045,MATH 20C,A03,849485,Shakeel; Asif,32,0,32,0
1739700505045,MATH 20C,A04,849511,Shakeel; Asif,32,0,32,0
1739700505045,MATH 20C,A05,849512,Shakeel; Asif,32,0,32,0
1739700505045,MATH 20C,A06,849513,Shakeel; Asif,32,0,32,0
1739700505045,MATH 20C,B01,849515,Yin; Wei,28,0,40,12
1739700505045,MATH 20C,B02,849516,Yin; Wei,41,0,45,4
1739700505045,MATH 20C,B03,849628,Yin; Wei,45,0,45,0
1739700505045,MATH 20C,B04,849636,Yin; Wei,43,0,45,2
1739700505045,MATH 20C,C01,849642,Ohm; Ko Woon,51,0,60,9
1739700505045,MATH 20C,C02,849654,Ohm; Ko Woon,60,0,60,0
1739700505045,MATH 20C,C03,849655,Ohm; Ko Woon,59,0,60,1
1739700505045,MATH 20C,C04,849663,Ohm; Ko Woon,60,0,60,0
1739700505045,MATH 20C,D01,849673,Yin; Wei,43,0,45,2
1739700505045,MATH 20C,D02,849677,Yin; Wei,43,0,45,2
1739700505045,MATH 20C,D03,849683,Yin; Wei,45,0,45,0
1739700505045,MATH 20C,D04,849686,Yin; Wei,45,0,45,0
1739700506127,MATH 20D,A01,849688,Hammock; Frances H,22,0,27,5
1739700506127,MATH 20D,A02,849695,Hammock; Frances H,32,0,32,0
1739700506127,MATH 20D,A03,849697,Hammock; Frances H,32,0,32,0
1739700506127,MATH 20D,A04,849734,Hammock; Frances H,31,0,32,1
1739700506127,MATH 20D,A05,849735,Hammock; Frances H,30,0,32,2
1739700506127,MATH 20D,A06,849736,Hammock; Frances H,32,0,32,0
1739700506127,MATH 20D,B01,849829,Hammock; Frances H,34,0,45,11
1739700506127,MATH 20D,B02,849852,Hammock; Frances H,45,0,45,0
1739700506127,MATH 20D,B03,849853,Hammock; Frances H,44,0,45,1
1739700506127,MATH 20D,B04,849857,Hammock; Frances H,45,0,45,0
1739700506127,MATH 20D,C01,849867,Staff,57,0,60,3
1739700506127,MATH 20D,C02,849888,Staff,59,0,60,1
1739700507169,MATH 20E,A01,850038,Sanchez; Anthony,20,0,31,11
1739700507169,MATH 20E,A02,850039,Sanchez; Anthony,33,0,35,2
1739700507169,MATH 20E,A03,850040,Sanchez; Anthony,34,0,35,1
1739700507169,MATH 20E,A04,850041,Sanchez; Anthony,35,0,35,0
1739700507169,MATH 20E,B01,850054,Sheng; Hongyi,27,0,35,8
1739700507169,MATH 20E,B02,850058,Sheng; Hongyi,34,0,35,1
1739700507169,MATH 20E,B03,850060,Sheng; Hongyi,35,0,35,0
1739700507169,MATH 20E,B04,850063,Sheng; Hongyi,35,0,35,0
1739700507169,MATH 20E,B05,872529,Sheng; Hongyi,35,0,35,0
1739700507169,MATH 20E,B06,872530,Sheng; Hongyi,35,0,35,0
1739700507169,MATH 20E,C01,850068,Sheng; Hongyi,29,0,30,1
1739700507169,MATH 20E,C02,850069,Sheng; Hongyi,30,0,30,0
1739700507169,MATH 20E,C03,850072,Sheng; Hongyi,29,0,30,1
1739700507169,MATH 20E,C04,850075,Sheng; Hongyi,29,0,30,1
1739700507169,MATH 20E,C05,850080,Sheng; Hongyi,30,0,30,0
1739700507169,MATH 20E,C06,850083,Sheng; Hongyi,30,0,30,0
1739700508193,MATH 31CH,A01,850090,De Vleming; Kristin Elizab,40,0,40,0
1739700509223,MATH 87,A00,872926,Bowers; Adam R.,20,0,20,0
1739700509223,MATH 87,B00,872927,Bowers; Adam R.,20,0,20,0
1739700510249,MATH 95,A00,850094,Stevens; Laura Jeanne,34,0,35,1
1739700511478,MATH 100B,A01,847038,Aycock; Jon Merrill,33,0,34,1
1739700511478,MATH 100B,A02,847048,Aycock; Jon Merrill,33,0,34,1
1739700512508,MATH 100C,A01,847050,Sorensen; Claus M,30,0,34,4
1739700512508,MATH 100C,A02,847051,Sorensen; Claus M,32,0,34,2
1739700513536,MATH 102,A01,847053,Aliabadi Sr.; Mohsen,25,0,30,5
1739700513536,MATH 102,A02,847101,Aliabadi Sr.; Mohsen,30,0,30,0
1739700513536,MATH 102,A03,847103,Aliabadi Sr.; Mohsen,28,0,30,2
1739700513536,MATH 102,A04,847106,Aliabadi Sr.; Mohsen,30,0,30,0
1739700513536,MATH 102,B01,847119,Aliabadi Sr.; Mohsen,27,0,30,3
1739700513536,MATH 102,B02,847120,Aliabadi Sr.; Mohsen,29,0,30,1
1739700513536,MATH 102,B03,847121,Aliabadi Sr.; Mohsen,29,0,30,1
1739700513536,MATH 102,B04,847123,Aliabadi Sr.; Mohsen,30,0,30,0
1739700514563,MATH 103B,A01,847125,Mohammadi; Amir,34,0,35,1
1739700514563,MATH 103B,A02,847126,Mohammadi; Amir,35,0,35,0
1739700514563,MATH 103B,B01,847128,Wenzl; Hans G,33,0,35,2
1739700514563,MATH 103B,B02,847129,Wenzl; Hans G,35,0,35,0
1739700514563,MATH 103B,C01,847131,Wenzl; Hans G,31,0,35,4
1739700514563,MATH 103B,C02,847132,Wenzl; Hans G,33,0,35,2
1739700515595,MATH 109,A01,847134,Ganesan; Priyanga,10,0,10,0
1739700515595,MATH 109,A02,847135,Ganesan; Priyanga,9,0,10,1
1739700515595,MATH 109,B01,847137,Ganesan; Priyanga,7,0,10,3
1739700515595,MATH 109,B02,847138,Ganesan; Priyanga,9,0,10,1
1739700515595,MATH 109,C01,847140,Upadrashta; Pranav Kumar,7,0,10,3
1739700515595,MATH 109,C02,847141,Upadrashta; Pranav Kumar,10,0,10,0
1739700515595,MATH 109,D01,847143,Sarkar; Pratyush,9,0,10,1
1739700515595,MATH 109,D02,847144,Sarkar; Pratyush,10,0,10,0
1739700515595,MATH 109,E01,847146,Sarkar; Pratyush,10,0,10,0
1739700515595,MATH 109,E02,847148,Sarkar; Pratyush,10,0,10,0
1739700516625,MATH 110,A01,847150,Pillai; Mohandas K,30,0,35,5
1739700516625,MATH 110,A02,847151,Pillai; Mohandas K,34,0,35,1
1739700516625,MATH 110,A03,847152,Pillai; Mohandas K,34,0,35,1
1739700517656,MATH 111A,A01,847154,Shakeel; Asif,23,0,30,7
1739700518685,MATH 112B,A01,847156,Komarova; Natalia,25,0,25,0
1739700519713,MATH 114,A01,847158,Li; Bo,21,0,30,9
1739700519713,MATH 114,A02,847159,Li; Bo,29,0,30,1
1739700520738,MATH 120B,A01,847161,Treuer; John N,32,0,35,3
1739700520738,MATH 120B,A02,847162,Treuer; John N,34,0,35,1
1739700521769,MATH 121B,A01,847164,Stevens; Laura Jeanne,33,0,35,2
1739700522805,MATH 140B,A01,847166,Lu; Yunze,35,0,35,0
1739700522805,MATH 140B,A02,847167,Lu; Yunze,34,0,35,1
1739700523837,MATH 140C,A01,847203,Zlatos; Andrej,33,0,35,2
1739700523837,MATH 140C,A02,847204,Zlatos; Andrej,34,0,35,1
1739700524871,MATH 142B,A01,847207,Parise; Davide,25,0,35,10
1739700524871,MATH 142B,A02,847208,Parise; Davide,31,0,35,4
1739700524871,MATH 142B,B01,847219,Mohammadi; Amir,33,0,35,2
1739700524871,MATH 142B,B02,847222,Mohammadi; Amir,35,0,35,0
1739700524871,MATH 142B,C01,847224,Kunnawalkam Elayavalli; Sr,34,0,35,1
1739700524871,MATH 142B,C02,847331,Kunnawalkam Elayavalli; Sr,34,0,35,1
1739700525905,MATH 146,A01,847333,Pillai; Mohandas K,35,0,35,0
1739700526931,MATH 150B,A01,847335,Chow; Bennett,33,0,35,2
1739700527971,MATH 152,A01,847337,Grier; Daniel T,32,0,50,18
1739700529003,MATH 154,A01,847340,Manners; Frederick,33,0,35,2
1739700529003,MATH 154,A02,847341,Manners; Frederick,35,0,35,0
1739700529003,MATH 154,A03,847342,Manners; Frederick,35,0,35,0
1739700529003,MATH 154,A04,847343,Manners; Frederick,35,0,35,0
1739700529003,MATH 154,B01,847345,Verstraete; Jacques Allan,30,0,35,5
1739700529003,MATH 154,B02,847346,Verstraete; Jacques Allan,35,0,35,0
1739700529003,MATH 154,B03,847347,Verstraete; Jacques Allan,34,0,35,1
1739700529003,MATH 154,B04,847348,Verstraete; Jacques Allan,33,0,35,2
1739700530037,MATH 160B,A01,847460,Manners; Frederick,34,0,35,1
1739700531063,MATH 163,A01,847462,Kunnawalkam Elayavalli; Sr,1,0,25,24
1739700532097,MATH 170A,A01,847464,Nag; Panchali,33,0,35,2
1739700532097,MATH 170A,A02,847465,Nag; Panchali,34,0,35,1
1739700532097,MATH 170A,A03,847466,Nag; Panchali,33,0,35,2
1739700532097,MATH 170A,A04,847467,Nag; Panchali,31,0,35,4
1739700533122,MATH 170B,A01,847530,Dixit; Rishabh,33,0,35,2
1739700533122,MATH 170B,A02,847531,Dixit; Rishabh,35,0,35,0
1739700533122,MATH 170B,A03,847532,Dixit; Rishabh,34,0,35,1
1739700533122,MATH 170B,A04,847533,Dixit; Rishabh,29,0,35,6
1739700534149,MATH 170C,A01,847535,Dixit; Rishabh,35,0,35,0
1739700534149,MATH 170C,A02,847536,Dixit; Rishabh,35,0,35,0
1739700534149,MATH 170C,A03,847537,Dixit; Rishabh,34,0,35,1
1739700534149,MATH 170C,A04,847538,Dixit; Rishabh,35,0,35,0
1739700535179,MATH 171B,A01,847557,Huang; Lei,32,0,35,3
1739700535179,MATH 171B,A02,847560,Huang; Lei,34,0,35,1
1739700535179,MATH 171B,A03,847596,Huang; Lei,32,0,35,3
1739700535179,MATH 171B,A04,847597,Huang; Lei,32,0,35,3
1739700536205,MATH 179,A01,847599,Cheng; Li-Tien,25,0,25,0
1739700537231,MATH 180A,A01,847601,Webber; Robert Jacobs,31,0,35,4
1739700537231,MATH 180A,A02,847602,Webber; Robert Jacobs,35,0,35,0
1739700537231,MATH 180A,A03,847603,Webber; Robert Jacobs,34,0,35,1
1739700537231,MATH 180A,A04,847604,Webber; Robert Jacobs,32,0,35,3
1739700537231,MATH 180A,B01,847606,Hardiman; Liam,35,0,35,0
1739700537231,MATH 180A,B02,847680,Hardiman; Liam,31,0,35,4
1739700537231,MATH 180A,B03,847682,Hardiman; Liam,35,0,35,0
1739700537231,MATH 180A,B04,847683,Hardiman; Liam,35,0,35,0
1739700538257,MATH 180B,A01,847686,Warnke; Lutz Peter,32,0,32,0
1739700538257,MATH 180B,A02,847688,Warnke; Lutz Peter,31,0,32,1
1739700538257,MATH 180B,A03,847689,Warnke; Lutz Peter,31,0,32,1
1739700538257,MATH 180B,A04,847691,Warnke; Lutz Peter,31,0,32,1
1739700538257,MATH 180B,A05,847693,Warnke; Lutz Peter,32,0,32,0
1739700538257,MATH 180B,A06,847694,Warnke; Lutz Peter,30,0,32,2
1739700539292,MATH 180C,A01,847701,Ang; Jie Jun,34,0,35,1
1739700539292,MATH 180C,A02,847707,Ang; Jie Jun,35,0,35,0
1739700539292,MATH 180C,A03,847708,Ang; Jie Jun,32,0,35,3
1739700539292,MATH 180C,A04,847711,Ang; Jie Jun,31,0,35,4
1739700540319,MATH 181A,A01,847753,Zhang; Danna,15,0,35,20
1739700540319,MATH 181A,A02,847756,Zhang; Danna,32,0,35,3
1739700540319,MATH 181A,A03,847757,Zhang; Danna,32,0,35,3
1739700540319,MATH 181A,A04,847758,Zhang; Danna,33,0,35,2
1739700541361,MATH 181B,A01,847760,Rava; Denise,30,0,35,5
1739700541361,MATH 181B,A02,847761,Rava; Denise,34,0,35,1
1739700541361,MATH 181B,A03,847764,Rava; Denise,34,0,35,1
1739700541361,MATH 181B,A04,847765,Rava; Denise,35,0,35,0
1739700542394,MATH 183,A01,847768,Vishwanath; Siddharth,21,0,32,11
1739700542394,MATH 183,A02,847769,Vishwanath; Siddharth,30,0,32,2
1739700542394,MATH 183,A03,847770,Vishwanath; Siddharth,31,0,32,1
1739700542394,MATH 183,A04,847772,Vishwanath; Siddharth,29,0,32,3
1739700542394,MATH 183,A05,847774,Vishwanath; Siddharth,32,0,32,0
1739700542394,MATH 183,A06,847864,Vishwanath; Siddharth,31,0,32,1
1739700543420,MATH 184,A01,847866,Wesley; William J,35,0,35,0
1739700543420,MATH 184,A02,847874,Wesley; William J,33,0,35,2
1739700543420,MATH 184,A03,847875,Wesley; William J,35,0,35,0
1739700543420,MATH 184,A04,847876,Wesley; William J,33,0,35,2
1739700544446,MATH 185,A01,847880,Rava; Denise,32,0,35,3
1739700544446,MATH 185,A02,847881,Rava; Denise,35,0,35,0
1739700545474,MATH 187A,A01,847883,Klevdal; Christian Sleek,14,0,32,18
1739700545474,MATH 187A,A02,847886,Klevdal; Christian Sleek,29,0,32,3
1739700545474,MATH 187A,A03,847892,Klevdal; Christian Sleek,27,0,32,5
1739700545474,MATH 187A,A04,847893,Klevdal; Christian Sleek,32,0,32,0
1739700545474,MATH 187A,A05,847894,Klevdal; Christian Sleek,31,0,32,1
1739700545474,MATH 187A,A06,847903,Klevdal; Christian Sleek,31,0,32,1
1739700546502,MATH 187B,A01,847905,Bucur; Alina Ioana,28,0,35,7
1739700546502,MATH 187B,A02,847906,Bucur; Alina Ioana,34,0,35,1
1739700547529,MATH 189,A01,847908,Lou; Zhipeng,0,0,10,10
1739700547529,MATH 189,A02,847909,Lou; Zhipeng,0,0,10,10
1739700547529,MATH 189,A03,847910,Lou; Zhipeng,0,0,10,10
1739700547529,MATH 189,A04,847911,Lou; Zhipeng,0,0,10,10
1739700547529,MATH 189,A05,847912,Lou; Zhipeng,0,0,10,10
1739700547529,MATH 189,A06,847917,Lou; Zhipeng,0,0,10,10
1739700548552,MATH 190B,A01,848005,McKernan; James,31,0,35,4
1739700549580,MATH 194,A01,848012,Fitzsimmons; Patrick J,12,0,32,20
1739700549580,MATH 194,A02,848080,Fitzsimmons; Patrick J,31,0,32,1
1739700549580,MATH 194,A03,848081,Fitzsimmons; Patrick J,26,0,32,6
1739700549580,MATH 194,A04,848107,Fitzsimmons; Patrick J,32,0,32,0
1739700549580,MATH 194,A05,848108,Fitzsimmons; Patrick J,31,0,32,1
1739700549580,MATH 194,A06,848147,Fitzsimmons; Patrick J,30,0,32,2
1739700550608,MATH 197,001,872928,Kedlaya; Kiran S.,9999,0,9999,0
1739700551633,MATH 200C,A00,846124,Salehi Golsefidy; Alireza,18,0,20,2
1739700552663,MATH 202C,A00,846125,Rhoades; Brendon Patrick,18,0,20,2
1739700553690,MATH 203C,A00,846128,Izadi; Elham,20,0,20,0
1739700554721,MATH 204C,A00,846131,Pollack; Aaron,20,0,20,0
1739700555748,MATH 205,A00,846132,Popescu; Cristian D.,18,0,20,2
1739700556772,MATH 208,A00,846133,Oprea; Dragos N.,10,0,10,0
1739700557797,MATH 209,A00,846173,Bucur; Alina Ioana,10,0,10,0
1739700558824,MATH 211A,A00,846174,Salehi Golsefidy; Alireza,10,0,10,0
1739700559855,MATH 211B,A00,846175,Sanchez; Anthony,9,0,10,1
1739700560878,MATH 212B,A01,846177,Komarova; Natalia,10,0,10,0
1739700561905,MATH 214,A01,846179,Li; Bo,2,0,5,3
1739700561905,MATH 214,A02,846181,Li; Bo,5,0,5,0
1739700562934,MATH 216C,A00,846182,Cloninger; Alexander,17,0,20,3
1739700563959,MATH 218,A00,846183,Komarova; Natalia,9,0,10,1
1739700564988,MATH 220C,A00,846184,Oprea; Dragos N.,20,0,20,0
1739700566017,MATH 231C,A00,846185,Li; Bo,20,0,20,0
1739700567048,MATH 240C,A00,846187,Ioana; Adrian,18,0,20,2
1739700568076,MATH 243,A00,846188,Kunnawalkam Elayavalli; Sr,9,0,10,1
1739700569103,MATH 248,A00,846189,Bejenaru; Ioan,9,0,10,1
1739700570130,MATH 250C,A00,846190,Chow; Bennett,18,0,20,2
1739700571156,MATH 258,A00,846191,Ni; Lei,10,0,10,0
1739700572184,MATH 262A,A00,846192,Suk; Andrew Hoon,17,0,20,3
1739700573210,MATH 264C,A00,846193,Rhoades; Brendon Patrick,18,0,20,2
1739700574238,MATH 269,A00,846194,Warnke; Lutz Peter,9,0,10,1
1739700575267,MATH 270C,A00,846195,Leok; Melvin,14,0,20,6
1739700576291,MATH 271C,A00,846197,Nie; Jiawang,16,0,20,4
1739700577315,MATH 272C,A00,846198,Miller; Pearson,20,0,20,0
1739700578340,MATH 276,A00,846199,Mc Culloch; Andrew Douglas,0,0,0,0
1739700579365,MATH 278A,A00,846283,Cheng; Li-Tien,10,0,10,0
1739700580391,MATH 278B,A00,846322,Cloninger; Alexander,10,0,10,0
1739700581417,MATH 278C,A00,846333,Nie; Jiawang,10,0,10,0
1739700582445,MATH 279,A01,846359,Cheng; Li-Tien,10,0,10,0
1739700583470,MATH 280C,A00,846360,Kemp; Todd Aahron,18,0,20,2
1739700584497,MATH 281C,A00,846363,Zhang; Danna,8,0,20,12
1739700585526,MATH 285,A00,846378,Schweinsberg; Jason,7,0,20,13
1739700586553,MATH 288,A00,846382,Ang; Jie Jun,9,0,10,1
1739700587580,MATH 289A,A00,846386,Novak; Jonathan I,15,0,20,5
1739700587580,MATH 289A,B00,846413,Lou; Zhipeng,13,0,20,7
1739700587580,MATH 289A,C00,876133,Xu; Ronghui,2,0,10,8
1739700588605,MATH 290C,A00,846451,Roberts; Justin Deritter,18,0,20,2
1739700589631,MATH 292,A00,846481,Lu; Yunze,9,0,10,1
1739700590659,MATH 295,A00,846486,Bejenaru; Ioan,50,0,50,0
1739700591684,MATH 296,A00,846492,Warnke; Lutz Peter,20,0,20,0
1739700592707,MATH 297,001,889670,Gamst; Anthony Collins,0,0,0,0
1739700593732,MATS 200,A00,825196,Graeve; Olivia A,9988,0,9999,11
1739700594756,MATS 201B,A00,825197,Garay; Javier,44,0,55,11
1739700595784,MATS 205A,A00,825200,Meyers; Marc,15,0,20,5
1739700596811,MATS 252,A00,825203,Evdokimenko; Ekaterina,16,0,30,14
1739700597837,MATS 256,A00,825204,Chen; Renkun,24,0,30,6
1739700598861,MATS 261B,A00,825205,Qiao; Yu,20,0,25,5
1739700599886,MBC 296,001,887235,Staff,9999,0,9999,0
1739700600913,MCWP 40,001,858225,Wastal; Carrie King,14,0,15,1
1739700600913,MCWP 40,003,858230,Wastal; Carrie King,12,0,15,3
1739700600913,MCWP 40,004,858231,Wastal; Carrie King,13,0,15,2
1739700600913,MCWP 40,006,858235,Montejo; Carolina,20,0,20,0
1739700600913,MCWP 40,007,858240,Wastal; Carrie King,15,0,15,0
1739700600913,MCWP 40,008,858241,Wastal; Carrie King,11,0,15,4
1739700601953,MCWP 50,001,826425,Bartulis; Jason Michael,19,0,20,1
1739700601953,MCWP 50,002,826426,Bartulis; Jason Michael,19,0,20,1
1739700601953,MCWP 50,003,826427,Bartulis; Jason Michael,20,0,20,0
1739700601953,MCWP 50,004,826429,Compas; Sean Matthew,17,0,20,3
1739700601953,MCWP 50,005,826431,Compas; Sean Matthew,20,0,20,0
1739700601953,MCWP 50,006,826432,Krone; Jarret,19,0,20,1
1739700601953,MCWP 50,007,826433,Krone; Jarret,19,0,20,1
1739700601953,MCWP 50,008,826434,Redela; Pamela Morgan,20,0,20,0
1739700601953,MCWP 50,009,826435,Redela; Pamela Morgan,20,0,20,0
1739700601953,MCWP 50,010,826436,Carter; Andrea L,17,0,20,3
1739700601953,MCWP 50,011,826437,Carter; Andrea L,20,0,20,0
1739700601953,MCWP 50,012,826439,Nies; Laurie Elizabeth,20,0,20,0
1739700601953,MCWP 50,013,826474,Nies; Laurie Elizabeth,19,0,20,1
1739700601953,MCWP 50,014,826483,Duru; Nur,17,0,20,3
1739700601953,MCWP 50,015,826484,Duru; Nur,20,0,20,0
1739700601953,MCWP 50,016,826486,Silva; Kelly B,20,0,20,0
1739700601953,MCWP 50,017,826488,Silva; Kelly B,20,0,20,0
1739700601953,MCWP 50,018,826489,Silva; Kelly B,20,0,20,0
1739700601953,MCWP 50,019,826490,Carter; Jennifer A,20,0,20,0
1739700601953,MCWP 50,020,826491,Carter; Jennifer A,20,0,20,0
1739700601953,MCWP 50,021,826492,Smith; Haydee Marie,20,0,20,0
1739700601953,MCWP 50,022,826493,Smith; Haydee Marie,19,0,20,1
1739700601953,MCWP 50,023,826543,Morshed; Michael James,16,0,20,4
1739700601953,MCWP 50,024,826579,Morshed; Michael James,16,0,20,4
1739700601953,MCWP 50,025,826582,Pham; Vincent Minhduc,20,0,20,0
1739700601953,MCWP 50,026,826609,Pham; Vincent Minhduc,20,0,20,0
1739700602978,MCWP 50R,A00,826669,Miller; Elizabeth Deen,17,0,20,3
1739700602978,MCWP 50R,B00,826714,Miller; Elizabeth Deen,19,0,20,1
1739700604003,MCWP 125,A00,826719,Guillen; Melinda,20,0,20,0
1739700604003,MCWP 125,B00,826720,Guillen; Melinda,18,0,20,2
1739700604003,MCWP 125,C00,826721,Guillen; Melinda,15,0,20,5
1739700605031,MED 225,A00,872558,Esko; Jeffrey D.,6,0,6,0
1739700606058,MED 246,A00,872562,Gordts; Philip & Lewis; Amanda Lark & Godula; Kamil & Gagneux; Pascal & Esko; Jeffrey D. & Bode; Lars,10,0,10,0
1739700607084,MED 262,A00,883267,Singh; Karandeep,31,0,35,4
1739700608111,MED 265,A00,884437,El-Kareh; Robert E & Sitapati; Amy,27,0,30,3
1739700609136,MED 267,A01,883697,Hogarth; Michael Andrew,23,0,30,7
1739700610219,MED 275,A00,872551,Liu; George Yenhsi,7,0,10,3
1739700611246,MED 278,A00,884420,Carter; Hannah Kathryn & Mesirov; Jill P. & Curtius; Kathleen Mary,14,0,16,2
1739700612273,MED 296,001,866575,Chi; Neil C.,4,0,5,1
1739700612273,MED 296,002,866576,Castellanos; Luis R.,4,0,5,1
1739700612273,MED 296,003,866585,Jeong; Ah-Reum,4,0,5,1
1739700612273,MED 296,004,866590,Staff,5,0,5,0
1739700612273,MED 296,005,866627,Staff,5,0,5,0
1739700613301,MGT 3,A00,839898,Wagner; Timothy Ryan,96,0,98,2
1739700614328,MGT 4,A01,839906,Levkoff; Steven B.,5,0,6,1
1739700614328,MGT 4,A02,839911,Levkoff; Steven B.,5,0,6,1
1739700614328,MGT 4,A03,839913,Levkoff; Steven B.,5,0,6,1
1739700614328,MGT 4,B01,839919,Brooks; Marcus Raymond,30,0,32,2
1739700615355,MGT 5,A00,839921,Molloie Jr.; William H,184,0,186,2
1739700616383,MGT 12,A00,839922,Lindenberger; Wade Douglas,88,0,98,10
1739700616383,MGT 12,B00,839926,Lindenberger; Wade Douglas,75,0,100,25
1739700616383,MGT 12,C00,840027,Pecore; Joseph P.,87,0,100,13
1739700617415,MGT 16,A00,840029,Buchanan; Harold G,95,0,100,5
1739700617415,MGT 16,B00,840031,Buchanan; Harold G,95,0,100,5
1739700617415,MGT 16,C00,840033,Campbell; Robert Harold,119,0,120,1
1739700617415,MGT 16,D00,840034,Campbell; Robert Harold,118,0,120,2
1739700617415,MGT 16,E00,840049,Demill; Burritt,98,0,98,0
1739700617415,MGT 16,F00,840056,Demill; Burritt,97,0,98,1
1739700618443,MGT 18,A00,840060,McKay; Michael J,97,0,98,1
1739700618443,MGT 18,B00,840063,McKay; Michael J,96,0,98,2
1739700618443,MGT 18,C00,840074,McKay; Michael J,94,0,98,4
1739700618443,MGT 18,D00,840076,Chamberlain; Travis Dean,98,0,98,0
1739700619468,MGT 45,A00,840097,Pecore; Joseph P.,128,0,150,22
1739700619468,MGT 45,B00,840098,Pecore; Joseph P.,141,0,150,9
1739700620493,MGT 71,A00,840099,Park; Kun Soo,94,0,98,4
1739700621518,MGT 71R,A00,840101,Phiroz; Zal Navroze,117,0,150,33
1739700622548,MGT 100,A00,840102,Wilbur; Kenneth C,79,0,98,19
1739700622548,MGT 100,B00,840103,Wilbur; Kenneth C,87,0,98,11
1739700622548,MGT 100,C00,840104,Wilbur; Kenneth C,95,0,98,3
1739700623580,MGT 103,A00,840105,Bates; Kenneth Walter,93,0,98,5
1739700623580,MGT 103,B00,840106,Demill; Burritt,97,0,98,1
1739700623580,MGT 103,C00,840107,Eberhard; Craig A,98,0,98,0
1739700623580,MGT 103,D00,840225,Eberhard; Craig A,97,0,98,1
1739700623580,MGT 103,E00,840226,Ehrich; Kristine R,93,0,98,5
1739700623580,MGT 103,F00,840227,Ehrich; Kristine R,95,0,98,3
1739700623580,MGT 103,G00,840228,Ehrich; Kristine R,96,0,98,2
1739700624607,MGT 105,A00,840229,Bates; Kenneth Walter,87,0,98,11
1739700625631,MGT 106,A00,840230,Eberhard; Craig A,96,0,98,2
1739700626654,MGT 107,A00,881472,Yorkston; Eric A,94,0,98,4
1739700627685,MGT 109,A00,840231,Jasko; Katarzyna Beata,85,0,98,13
1739700627685,MGT 109,B00,840232,Liu; Wei,87,0,98,11
1739700628711,MGT 112,A00,840233,Somasundaram; Tyagarajan,91,0,98,7
1739700628711,MGT 112,B00,840234,Somasundaram; Tyagarajan,76,0,98,22
1739700629743,MGT 119,A00,840235,Anderson; Jon Marcus,140,0,140,0
1739700629743,MGT 119,B00,840236,Davis; Kathleen Ann,98,0,98,0
1739700629743,MGT 119,C00,840237,Mc Kenzie; Craig R.M.,97,0,98,1
1739700629743,MGT 119,D00,840238,Etingue Kum; Menes,40,0,40,0
1739700630769,MGT 121B,A00,840239,Klaas; Jeffrey David,91,0,98,7
1739700631794,MGT 128R,A00,840240,Krishnan; Viswanathan,83,0,98,15
1739700632823,MGT 131A,A00,840242,Houskeeper; Robert,147,0,150,3
1739700633850,MGT 131B,A00,840243,Houskeeper; Robert,98,0,98,0
1739700634878,MGT 132,A00,840244,Blakley; Bruce,95,0,98,3
1739700635903,MGT 137,A00,840245,Lindenberger; Wade Douglas,84,0,98,14
1739700636933,MGT 146,A00,881478,Brooks; Marcus Raymond,97,0,98,1
1739700637958,MGT 147,A00,840246,Anderson; John Charles,74,0,75,1
1739700638983,MGT 151R,A00,840253,Phiroz; Zal Navroze,84,0,98,14
1739700640008,MGT 153,A00,840254,Perols; Johan Lars,67,0,90,23
1739700641035,MGT 155,A00,881481,Shin; Hyo Duk,95,0,98,3
1739700642060,MGT 160,A00,840265,Johnson; Erik Barry,90,0,90,0
1739700642060,MGT 160,B00,840266,Staff,87,0,90,3
1739700642060,MGT 160,C00,840267,Staff,82,0,90,8
1739700643089,MGT 162,A00,840269,Levin; Joel,93,0,98,5
1739700643089,MGT 162,B00,840270,Levin; Joel,98,0,98,0
1739700644116,MGT 162R,A00,840271,Gneezy; Uri,173,0,199,26
1739700645143,MGT 164,A00,840272,McKay; Mary A,98,0,98,0
1739700645143,MGT 164,B00,840273,McKay; Mary A,97,0,98,1
1739700645143,MGT 164,C00,840274,McKay; Mary A,97,0,98,1
1739700645143,MGT 164,D00,840275,Meyer; Alison Bloomfield,92,0,98,6
1739700646172,MGT 166,A00,840365,Moran; Cathleen L.,98,0,98,0
1739700646172,MGT 166,B00,840429,Moran; Cathleen L.,96,0,98,2
1739700646172,MGT 166,C00,840430,Moran; Cathleen L.,97,0,98,1
1739700647197,MGT 167,A00,840431,Klaas; Jeffrey David,96,0,98,2
1739700648221,MGT 171R,A00,840478,Phiroz; Zal Navroze,73,0,98,25
1739700649250,MGT 172,A00,840536,Hedges; Kathleen & Royal; Rebecca,114,0,120,6
1739700649250,MGT 172,B00,840580,Hedges; Kathleen,92,0,98,6
1739700649250,MGT 172,C00,840581,Zimmermann; Carsten,96,0,98,2
1739700649250,MGT 172,D00,881483,Zimmermann; Carsten,97,0,98,1
1739700650277,MGT 173,A00,840604,Hayes; Sherry Lorine,91,0,98,7
1739700651301,MGT 175,A00,840636,Gopal; Christopher S.,94,0,98,4
1739700652326,MGT 180,A00,840641,Bliss; Barbara Ann,145,0,150,5
1739700652326,MGT 180,B00,840642,Bliss; Barbara Ann,143,0,150,7
1739700653353,MGT 181,A00,840643,Buchanan; Harold G,117,0,120,3
1739700654378,MGT 184,A00,886143,Parashar; Sat P,89,0,98,9
1739700655404,MGT 185,A00,840648,Dunn; Louis Jean,88,0,98,10
1739700656429,MGT 187,A00,840649,Dunn; Louis Jean,68,0,75,7
1739700657457,MGT 189,A00,840650,Avenancio-Leon; Carlos,89,0,98,9
1739700658486,MGT 255,A00,840651,Rottenstreich; Yuval S,15,0,20,5
1739700659510,MGT 259,A00,872537,Staff,16,0,20,4
1739700660535,MGT 285,A00,840652,Liu; Jun,20,0,20,0
1739700661568,MGT 296,001,870424,Gneezy; Ayelet,3,0,3,0
1739700661568,MGT 296,002,870453,Amir; On,3,0,3,0
1739700661568,MGT 296,003,870454,Amir; On & Karmarkar; Uma R,3,0,3,0
1739700661568,MGT 296,004,870455,Liu; Jun,2,0,3,1
1739700661568,MGT 296,005,870456,Hansen; Karsten T.,3,0,3,0
1739700661568,MGT 296,006,870471,Erat; Sanjiv,3,0,3,0
1739700661568,MGT 296,007,870472,Timmermann; Allan,3,0,3,0
1739700661568,MGT 296,008,870501,Smith; Pamela Karen,3,0,3,0
1739700661568,MGT 296,009,870502,Zhang; Zhe,3,0,3,0
1739700661568,MGT 296,010,870508,Oveis; Christopher S,3,0,3,0
1739700661568,MGT 296,011,870523,Amir; On & Gneezy; Ayelet,2,0,3,1
1739700661568,MGT 296,012,870537,Luo; Danqi,3,0,3,0
1739700662618,MMW 13,A01,823232,Chang; Edmond Yi-Teh,16,0,16,0
1739700662618,MMW 13,A02,823239,Chang; Edmond Yi-Teh,16,0,16,0
1739700662618,MMW 13,A03,823242,Chang; Edmond Yi-Teh,16,0,16,0
1739700662618,MMW 13,A04,823251,Chang; Edmond Yi-Teh,16,0,16,0
1739700662618,MMW 13,A05,823252,Chang; Edmond Yi-Teh,16,0,16,0
1739700662618,MMW 13,A06,823253,Chang; Edmond Yi-Teh,15,0,16,1
1739700662618,MMW 13,A07,823255,Chang; Edmond Yi-Teh,16,0,16,0
1739700662618,MMW 13,A08,823257,Chang; Edmond Yi-Teh,16,0,16,0
1739700662618,MMW 13,A09,823263,Chang; Edmond Yi-Teh,16,0,16,0
1739700662618,MMW 13,A10,823291,Chang; Edmond Yi-Teh,16,0,16,0
1739700662618,MMW 13,A11,823292,Chang; Edmond Yi-Teh,16,0,16,0
1739700662618,MMW 13,A12,823293,Chang; Edmond Yi-Teh,16,0,16,0
1739700662618,MMW 13,A13,823370,Chang; Edmond Yi-Teh,0,0,0,0
1739700662618,MMW 13,A14,823480,Chang; Edmond Yi-Teh,0,0,0,0
1739700662618,MMW 13,A15,823481,Chang; Edmond Yi-Teh,16,0,16,0
1739700662618,MMW 13,A16,823482,Chang; Edmond Yi-Teh,15,0,16,1
1739700662618,MMW 13,A17,823483,Chang; Edmond Yi-Teh,16,0,16,0
1739700662618,MMW 13,A18,823484,Chang; Edmond Yi-Teh,16,0,16,0
1739700662618,MMW 13,A19,823485,Chang; Edmond Yi-Teh,0,0,0,0
1739700662618,MMW 13,A20,823486,Chang; Edmond Yi-Teh,0,0,0,0
1739700662618,MMW 13,B01,823488,Zhiri; Oumelbanine,15,0,16,1
1739700662618,MMW 13,B02,823490,Zhiri; Oumelbanine,15,0,16,1
1739700662618,MMW 13,B03,823491,Zhiri; Oumelbanine,14,0,16,2
1739700662618,MMW 13,B04,823492,Zhiri; Oumelbanine,15,0,16,1
1739700662618,MMW 13,B05,823493,Zhiri; Oumelbanine,16,0,16,0
1739700662618,MMW 13,B06,823494,Zhiri; Oumelbanine,13,0,16,3
1739700662618,MMW 13,B07,823495,Zhiri; Oumelbanine,15,0,16,1
1739700662618,MMW 13,B08,823496,Zhiri; Oumelbanine,15,0,16,1
1739700662618,MMW 13,B09,823522,Zhiri; Oumelbanine,16,0,16,0
1739700662618,MMW 13,B10,823528,Zhiri; Oumelbanine,16,0,16,0
1739700662618,MMW 13,B11,823604,Zhiri; Oumelbanine,16,0,16,0
1739700662618,MMW 13,B12,823613,Zhiri; Oumelbanine,16,0,16,0
1739700662618,MMW 13,B13,823624,Zhiri; Oumelbanine,16,0,16,0
1739700662618,MMW 13,B14,823627,Zhiri; Oumelbanine,15,0,16,1
1739700662618,MMW 13,B15,823631,Zhiri; Oumelbanine,16,0,16,0
1739700662618,MMW 13,B16,823642,Zhiri; Oumelbanine,15,0,16,1
1739700662618,MMW 13,C01,823773,Murillo; Dana V.,16,0,16,0
1739700662618,MMW 13,C02,823774,Murillo; Dana V.,16,0,16,0
1739700662618,MMW 13,C03,823793,Murillo; Dana V.,16,0,16,0
1739700662618,MMW 13,C04,823794,Murillo; Dana V.,16,0,16,0
1739700662618,MMW 13,C05,823801,Murillo; Dana V.,16,0,16,0
1739700662618,MMW 13,C06,823856,Murillo; Dana V.,16,0,16,0
1739700662618,MMW 13,C07,823876,Murillo; Dana V.,16,0,16,0
1739700662618,MMW 13,C08,823878,Murillo; Dana V.,16,0,16,0
1739700662618,MMW 13,C09,823956,Murillo; Dana V.,0,0,0,0
1739700662618,MMW 13,C10,823978,Murillo; Dana V.,0,0,0,0
1739700662618,MMW 13,C11,824009,Murillo; Dana V.,0,0,0,0
1739700662618,MMW 13,C12,824022,Murillo; Dana V.,0,0,0,0
1739700662618,MMW 13,C13,824023,Murillo; Dana V.,16,0,16,0
1739700662618,MMW 13,C14,824027,Murillo; Dana V.,15,0,16,1
1739700662618,MMW 13,C15,824029,Murillo; Dana V.,0,0,0,0
1739700662618,MMW 13,C16,824036,Murillo; Dana V.,0,0,0,0
1739700662618,MMW 13,D01,824044,Vitkus; Daniel J.,16,0,16,0
1739700662618,MMW 13,D02,824045,Vitkus; Daniel J.,16,0,16,0
1739700662618,MMW 13,D03,824050,Vitkus; Daniel J.,16,0,16,0
1739700662618,MMW 13,D04,824066,Vitkus; Daniel J.,16,0,16,0
1739700662618,MMW 13,D05,824070,Vitkus; Daniel J.,16,0,16,0
1739700662618,MMW 13,D06,824080,Vitkus; Daniel J.,16,0,16,0
1739700662618,MMW 13,D07,824081,Vitkus; Daniel J.,16,0,16,0
1739700662618,MMW 13,D08,824092,Vitkus; Daniel J.,16,0,16,0
1739700662618,MMW 13,D09,824112,Vitkus; Daniel J.,0,0,0,0
1739700662618,MMW 13,D10,824248,Vitkus; Daniel J.,0,0,0,0
1739700662618,MMW 13,D11,824303,Vitkus; Daniel J.,0,0,0,0
1739700662618,MMW 13,D12,824311,Vitkus; Daniel J.,0,0,0,0
1739700662618,MMW 13,D13,824312,Vitkus; Daniel J.,16,0,16,0
1739700662618,MMW 13,D14,824317,Vitkus; Daniel J.,16,0,16,0
1739700662618,MMW 13,D15,824377,Vitkus; Daniel J.,0,0,0,0
1739700662618,MMW 13,D16,824378,Vitkus; Daniel J.,0,0,0,0
1739700663649,MMW 15,A01,824426,Chang; Edmond Yi-Teh,27,0,28,1
1739700663649,MMW 15,A02,824586,Chang; Edmond Yi-Teh,26,0,28,2
1739700663649,MMW 15,A03,824617,Chang; Edmond Yi-Teh,24,0,28,4
1739700663649,MMW 15,A04,824641,Chang; Edmond Yi-Teh,26,0,28,2
1739700663649,MMW 15,A05,824653,Chang; Edmond Yi-Teh,25,0,28,3
1739700663649,MMW 15,A06,824689,Chang; Edmond Yi-Teh,28,0,28,0
1739700663649,MMW 15,A07,824735,Chang; Edmond Yi-Teh,28,0,28,0
1739700663649,MMW 15,A08,824804,Chang; Edmond Yi-Teh,27,0,28,1
1739700663649,MMW 15,A09,824805,Chang; Edmond Yi-Teh,0,0,0,0
1739700663649,MMW 15,A10,824963,Chang; Edmond Yi-Teh,0,0,0,0
1739700663649,MMW 15,B01,824999,Peterson; Johanna L,0,0,0,0
1739700663649,MMW 15,B02,825015,Peterson; Johanna L,0,0,0,0
1739700663649,MMW 15,B03,825050,Peterson; Johanna L,18,0,28,10
1739700663649,MMW 15,B04,825079,Peterson; Johanna L,24,0,28,4
1739700663649,MMW 15,B05,825109,Peterson; Johanna L,27,0,28,1
1739700663649,MMW 15,B06,825114,Peterson; Johanna L,24,0,28,4
1739700663649,MMW 15,B07,825151,Peterson; Johanna L,23,0,28,5
1739700663649,MMW 15,B08,825183,Peterson; Johanna L,19,0,28,9
1739700663649,MMW 15,B09,825190,Peterson; Johanna L,28,0,28,0
1739700663649,MMW 15,B10,825191,Peterson; Johanna L,26,0,28,2
1739700663649,MMW 15,B11,825192,Peterson; Johanna L,0,0,0,0
1739700663649,MMW 15,B12,825193,Peterson; Johanna L,0,0,0,0
1739700664675,MSED 295,A00,825207,Staff,5,0,5,0
1739700665703,MUS 1C,A01,826943,Staff,24,0,25,1
1739700665703,MUS 1C,A02,826944,Staff,23,0,25,2
1739700665703,MUS 1C,A03,826945,Staff,25,0,25,0
1739700666730,MUS 2C,A01,826955,Obermueller; Karola,29,0,30,1
1739700667756,MUS 2CK,A00,826957,Ohnishi; Takae,14,0,15,1
1739700667756,MUS 2CK,B00,826960,Ohnishi; Takae,15,0,15,0
1739700668780,MUS 2JK,A00,826963,Kenyatta; Kamau,13,0,15,2
1739700669806,MUS 4,A01,826968,Day; Kevin Alexander,24,0,25,1
1739700669806,MUS 4,A02,826969,Day; Kevin Alexander,24,0,25,1
1739700669806,MUS 4,A03,826970,Day; Kevin Alexander,25,0,25,0
1739700669806,MUS 4,A04,826972,Day; Kevin Alexander,25,0,25,0
1739700669806,MUS 4,A05,826973,Day; Kevin Alexander,25,0,25,0
1739700669806,MUS 4,A06,826986,Day; Kevin Alexander,25,0,25,0
1739700669806,MUS 4,A07,826987,Day; Kevin Alexander,25,0,25,0
1739700669806,MUS 4,A08,826988,Day; Kevin Alexander,25,0,25,0
1739700669806,MUS 4,A09,826989,Day; Kevin Alexander,25,0,25,0
1739700669806,MUS 4,A10,826990,Day; Kevin Alexander,24,0,25,1
1739700670832,MUS 6,A01,826992,Hankins; Sarah E.,24,0,25,1
1739700670832,MUS 6,A02,826993,Hankins; Sarah E.,23,0,25,2
1739700670832,MUS 6,A03,826994,Hankins; Sarah E.,25,0,25,0
1739700670832,MUS 6,A04,826995,Hankins; Sarah E.,22,0,25,3
1739700671858,MUS 8,A01,826997,Smythe; Cory Benjamin,23,0,25,2
1739700671858,MUS 8,A02,826998,Smythe; Cory Benjamin,25,0,25,0
1739700671858,MUS 8,A03,827002,Smythe; Cory Benjamin,25,0,25,0
1739700671858,MUS 8,A04,827003,Smythe; Cory Benjamin,22,0,25,3
1739700671858,MUS 8,A05,827004,Smythe; Cory Benjamin,25,0,25,0
1739700671858,MUS 8,A06,827005,Smythe; Cory Benjamin,25,0,25,0
1739700671858,MUS 8,A07,827006,Smythe; Cory Benjamin,24,0,25,1
1739700671858,MUS 8,A08,827007,Smythe; Cory Benjamin,23,0,25,2
1739700672884,MUS 11,A01,827011,Terrazas Perez; Wilfrido D,23,0,25,2
1739700672884,MUS 11,A02,827012,Terrazas Perez; Wilfrido D,23,0,25,2
1739700672884,MUS 11,A03,827013,Terrazas Perez; Wilfrido D,25,0,25,0
1739700672884,MUS 11,A04,827014,Terrazas Perez; Wilfrido D,24,0,25,1
1739700672884,MUS 11,A05,827015,Terrazas Perez; Wilfrido D,25,0,25,0
1739700672884,MUS 11,A06,827016,Terrazas Perez; Wilfrido D,25,0,25,0
1739700672884,MUS 11,A07,827017,Terrazas Perez; Wilfrido D,25,0,25,0
1739700672884,MUS 11,A08,827018,Terrazas Perez; Wilfrido D,22,0,25,3
1739700673911,MUS 12,A01,827020,Guy; Nancy,24,0,25,1
1739700673911,MUS 12,A02,827021,Guy; Nancy,25,0,25,0
1739700673911,MUS 12,A03,827022,Guy; Nancy,25,0,25,0
1739700673911,MUS 12,A04,827023,Guy; Nancy,24,0,25,1
1739700674937,MUS 14,A01,827025,McCormack; Timothy Matthew,25,0,25,0
1739700674937,MUS 14,A02,827026,McCormack; Timothy Matthew,25,0,25,0
1739700674937,MUS 14,A03,827027,McCormack; Timothy Matthew,24,0,25,1
1739700674937,MUS 14,A04,827028,McCormack; Timothy Matthew,25,0,25,0
1739700675964,MUS 15,A01,827031,Staff,22,0,25,3
1739700675964,MUS 15,A02,827032,Staff,23,0,25,2
1739700675964,MUS 15,A03,827033,Staff,24,0,25,1
1739700675964,MUS 15,A04,827034,Staff,25,0,25,0
1739700675964,MUS 15,A05,827035,Staff,25,0,25,0
1739700675964,MUS 15,A06,827036,Staff,23,0,25,2
1739700675964,MUS 15,A07,827037,Staff,25,0,25,0
1739700675964,MUS 15,A08,827038,Staff,24,0,25,1
1739700675964,MUS 15,A09,827039,Staff,25,0,25,0
1739700675964,MUS 15,A10,827049,Staff,23,0,25,2
1739700676993,MUS 17,A01,827051,Staff,24,0,25,1
1739700676993,MUS 17,A02,827052,Staff,25,0,25,0
1739700676993,MUS 17,A03,827053,Staff,25,0,25,0
1739700676993,MUS 17,A04,827054,Staff,24,0,25,1
1739700676993,MUS 17,A05,827055,Staff,25,0,25,0
1739700676993,MUS 17,A06,827056,Staff,24,0,25,1
1739700676993,MUS 17,A07,827057,Staff,24,0,25,1
1739700676993,MUS 17,A08,827060,Staff,23,0,25,2
1739700676993,MUS 17,A09,827061,Staff,25,0,25,0
1739700676993,MUS 17,A10,827062,Staff,25,0,25,0
1739700676993,MUS 17,A11,827063,Staff,25,0,25,0
1739700676993,MUS 17,A12,827064,Staff,25,0,25,0
1739700678020,MUS 19R,A01,827066,Britt; King James,23,0,25,2
1739700678020,MUS 19R,A02,827067,Britt; King James,15,0,25,10
1739700678020,MUS 19R,A03,827068,Britt; King James,25,0,25,0
1739700678020,MUS 19R,A04,827069,Britt; King James,22,0,25,3
1739700678020,MUS 19R,A05,827070,Britt; King James,25,0,25,0
1739700678020,MUS 19R,A06,827071,Britt; King James,21,0,25,4
1739700678020,MUS 19R,A07,827072,Britt; King James,24,0,25,1
1739700678020,MUS 19R,A08,827083,Britt; King James,23,0,25,2
1739700678020,MUS 19R,B01,827121,Britt; King James,5,0,5,0
1739700678020,MUS 19R,B02,827122,Britt; King James,5,0,5,0
1739700678020,MUS 19R,B03,827123,Britt; King James,5,0,5,0
1739700678020,MUS 19R,B04,827128,Britt; King James,5,0,5,0
1739700678020,MUS 19R,B05,827129,Britt; King James,5,0,5,0
1739700678020,MUS 19R,B06,827130,Britt; King James,5,0,5,0
1739700678020,MUS 19R,B07,827198,Britt; King James,5,0,5,0
1739700678020,MUS 19R,B08,827199,Britt; King James,5,0,5,0
1739700679045,MUS 32,001,855621,Dresser; Mark Stuart,10,0,10,0
1739700679045,MUS 32,002,855622,Kenyatta; Kamau,10,0,10,0
1739700679045,MUS 32,003,855623,Curtis; Charles Rector,10,0,10,0
1739700679045,MUS 32,004,855624,Carlstrom; Mitchell Kraig,10,0,10,0
1739700679045,MUS 32,005,855625,Terrazas Perez; Wilfrido D,10,0,10,0
1739700679045,MUS 32,006,855628,Ohnishi; Takae,10,0,10,0
1739700679045,MUS 32,007,855629,Burr; Anthony I,10,0,10,0
1739700679045,MUS 32,008,855630,Carlson; Erik,10,0,10,0
1739700679045,MUS 32,009,855631,Staff,10,0,10,0
1739700680071,MUS 32V,A00,827206,Narucki; Susan M,10,0,10,0
1739700680071,MUS 32V,B00,827209,Flores Bucio; Mariana,10,0,10,0
1739700680071,MUS 32V,C00,827210,Zazueta Cervera; Miguel Angel,10,0,10,0
1739700681096,MUS 32VM,A00,827211,Zazueta Cervera; Miguel Angel,19,0,19,0
1739700682120,MUS 43,A00,827216,Yadegari; Shahrokh D,91,0,96,5
1739700683143,MUS 95C,A00,827217,Flores Bucio; Mariana,34,0,40,6
1739700684168,MUS 95D,A00,827219,Yadegari; Shahrokh D,40,0,40,0
1739700685194,MUS 95E,A00,827229,Henson; Matthew Alexander,40,0,40,0
1739700686219,MUS 95F,A00,827332,Carlstrom; Mitchell Kraig,40,0,40,0
1739700687242,MUS 95G,A00,827371,Anderson; Kenneth,386,0,395,9
1739700687242,MUS 95G,B00,827384,Anderson; Kenneth,391,0,395,4
1739700688268,MUS 95JC,A00,827385,Kenyatta; Kamau,25,0,25,0
1739700689293,MUS 95L,A00,827386,Pittman; Katherine Sue,65,0,65,0
1739700690316,MUS 95P,A00,827387,Nourai; Keyavash,17,0,20,3
1739700691341,MUS 95W,A00,827388,Seshadri; Kartik,21,0,25,4
1739700691341,MUS 95W,B00,827389,Seshadri; Kartik,25,0,25,0
1739700692364,MUS 101C,A01,827517,Day; Kevin Alexander,34,0,35,1
1739700693390,MUS 103C,A00,827518,Steiger; Rand,14,0,15,1
1739700694426,MUS 103F,A00,827546,Steiger; Rand,1,0,1,0
1739700695451,MUS 107,A00,827547,Guy; Nancy,15,0,15,0
1739700696477,MUS 111,A00,827548,Liang; Lei,118,0,120,2
1739700697501,MUS 113,A00,827549,Narucki; Susan M,30,0,30,0
1739700698526,MUS 114,A00,827550,Schick; Steven,138,0,140,2
1739700699552,MUS 120C,A01,827563,Leslie Santana; Myrta,24,0,25,1
1739700700580,MUS 130,A00,827567,Ohnishi; Takae,35,0,35,0
1739700701606,MUS 132,001,855633,Dresser; Mark Stuart,10,0,10,0
1739700701606,MUS 132,002,855635,Kenyatta; Kamau,10,0,10,0
1739700701606,MUS 132,003,855637,Curtis; Charles Rector,10,0,10,0
1739700701606,MUS 132,004,855639,Carlstrom; Mitchell Kraig,10,0,10,0
1739700701606,MUS 132,006,855641,Terrazas Perez; Wilfrido D,10,0,10,0
1739700701606,MUS 132,007,855642,Ohnishi; Takae,10,0,10,0
1739700701606,MUS 132,008,855643,Burr; Anthony I,10,0,10,0
1739700701606,MUS 132,009,855646,Carlson; Erik,10,0,10,0
1739700701606,MUS 132,010,855647,Smythe; Cory Benjamin,10,0,10,0
1739700701606,MUS 132,011,855648,Richards; Stephanie F,10,0,10,0
1739700701606,MUS 132,012,855649,Nourai; Keyavash,10,0,10,0
1739700702631,MUS 132R,A00,827568,Narucki; Susan M,2,0,2,0
1739700703659,MUS 132V,A00,827569,Narucki; Susan M,15,0,15,0
1739700703659,MUS 132V,B00,827570,Zazueta Cervera; Miguel Angel,15,0,15,0
1739700703659,MUS 132V,C00,827572,Flores Bucio; Mariana,15,0,15,0
1739700704684,MUS 134,A00,827573,Yadegari; Shahrokh D,30,0,30,0
1739700705712,MUS 137C,A00,827574,Kenyatta; Kamau,35,0,35,0
1739700706737,MUS 143,A00,827575,Yadegari; Shahrokh D,28,0,30,2
1739700707761,MUS 150,A00,872496,Roberts; Matana,28,0,30,2
1739700708786,MUS 151,A00,827577,Hankins; Sarah E.,9,0,20,11
1739700709813,MUS 160B,A00,827579,Dubnov; Shlomo,14,0,15,1
1739700709813,MUS 160B,B00,827581,Freitas Caetano; Marcelo,15,0,15,0
1739700710838,MUS 172,A01,827584,Staff,38,0,45,7
1739700711862,MUS 174C,A00,827585,Erbe; Tom,21,0,27,6
1739700712890,MUS 175,A00,827586,Smyth; Tamara R.,27,0,30,3
1739700713969,MUS 176,A00,827587,Britt; King James,30,0,30,0
1739700714993,MUS 201A,A00,827590,Narucki; Susan M,15,0,15,0
1739700714993,MUS 201A,B00,827592,Dresser; Mark Stuart,15,0,15,0
1739700716021,MUS 201C,A00,827593,Schick; Steven,15,0,15,0
1739700717045,MUS 202,A00,827596,Schick; Steven,40,0,40,0
1739700718069,MUS 203C,A00,827597,McCormack; Timothy Matthew,13,0,15,2
1739700719098,MUS 203D,A00,827598,Davis; Anthony Curtis,10,0,10,0
1739700719098,MUS 203D,B00,827599,Obermueller; Karola,10,0,10,0
1739700719098,MUS 203D,C00,827600,Liang; Lei,10,0,10,0
1739700719098,MUS 203D,D00,827601,Lou; Michelle Siulai,10,0,10,0
1739700719098,MUS 203D,E00,827602,Steiger; Rand,10,0,10,0
1739700719098,MUS 203D,F00,827605,McCormack; Timothy Matthew,10,0,10,0
1739700720122,MUS 204,A00,827607,Obermueller; Karola,24,0,25,1
1739700721150,MUS 205,A00,827608,Hankins; Sarah E.,14,0,15,1
1739700722176,MUS 206,A00,827609,Lou; Michelle Siulai,0,0,0,0
1739700722176,MUS 206,B00,827610,Dresser; Mark Stuart,15,0,15,0
1739700722176,MUS 206,C00,872457,Roberts; Matana,14,0,15,1
1739700723200,MUS 207,A00,827611,Leslie Santana; Myrta,13,0,15,2
1739700723200,MUS 207,B00,872458,Guy; Nancy,15,0,15,0
1739700724227,MUS 210,A00,827612,Davis; Anthony Curtis,15,0,15,0
1739700725252,MUS 229,A00,872460,Liang; Lei,15,0,15,0
1739700726276,MUS 232,001,855654,Dresser; Mark Stuart,10,0,10,0
1739700726276,MUS 232,002,855655,Kenyatta; Kamau,10,0,10,0
1739700726276,MUS 232,003,855656,Curtis; Charles Rector,10,0,10,0
1739700726276,MUS 232,004,855659,Terrazas Perez; Wilfrido D,10,0,10,0
1739700726276,MUS 232,005,855660,Ohnishi; Takae,10,0,10,0
1739700726276,MUS 232,006,855661,Burr; Anthony I,10,0,10,0
1739700726276,MUS 232,007,855662,Carlson; Erik,10,0,10,0
1739700726276,MUS 232,008,855663,Schick; Steven,10,0,10,0
1739700726276,MUS 232,009,855664,Narucki; Susan M,10,0,10,0
1739700727299,MUS 234,A00,827614,Yadegari; Shahrokh D,20,0,20,0
1739700728325,MUS 245,A00,827616,Carlson; Erik,15,0,15,0
1739700729352,MUS 267,A00,827617,Erbe; Tom,13,0,15,2
1739700730379,MUS 270C,A00,827618,Dubnov; Shlomo,18,0,20,2
1739700731404,NANO 100L,A00,808557,Vecchio; Kenneth S,17,0,20,3
1739700732427,NANO 103,A00,808560,Jahed Motlagh; Zeinab,49,0,50,1
1739700733453,NANO 108,A00,808561,Lubarda; Vlado,100,0,100,0
1739700734476,NANO 112,A01,808563,Vazquez Mena; Oscar,69,0,70,1
1739700735501,NANO 115L,A01,808567,Xu; Sheng,32,0,38,6
1739700735501,NANO 115L,B01,808569,Yang; Kesong,38,0,38,0
1739700736527,NANO 120B,A01,808575,Pokorski; Jonathan Kyle,32,0,35,3
1739700736527,NANO 120B,B01,808577,Ong; Shyue Ping,34,0,35,1
1739700737552,NANO 158,A00,808580,Luo; Jian,50,0,50,0
1739700738577,NANO 174,A00,808582,Meyers; Marc,49,0,50,1
1739700739603,NANO 181R,A00,869155,Ong; Shyue Ping,38,0,40,2
1739700740630,NANO 200,A00,808584,Jahed Motlagh; Zeinab,108,0,120,12
1739700741658,NANO 273,A00,808614,Shah; Nisarg,24,0,30,6
1739700742683,NANO 279,A00,808619,Liu; Ping,44,0,50,6
1739700743707,NANO 281R,A00,808633,Ong; Shyue Ping,37,0,60,23
1739700744732,NANO 282,A00,808661,Steinmetz; Nicole F,49,0,50,1
1739700745757,NEU 200C,A00,827621,Miller; Cory T.,15,0,18,3
1739700746783,NEU 276,A01,827623,Castle; Michael James,26,0,28,2
1739700747808,NEU 296,001,866729,Evans; Sean Jeffrey,6,0,10,4
1739700747808,NEU 296,002,866730,Staff,5,0,5,0
1739700747808,NEU 296,003,866731,Staff,5,0,5,0
1739700748835,NEUG 221,A00,827624,Zou; Yimin,8,0,12,4
1739700749861,NEUG 280,A00,827625,Chen; Xu,12,0,12,0
1739700750891,NEUG 296,A00,827626,Bloodgood; Brenda Laurie,9999,0,9999,0
1739700750891,NEUG 296,B00,827627,Allen; Nicola J,9999,0,9999,0
1739700751917,OPTH 296,001,866835,Afshari; Natalie,4,0,5,1
1739700751917,OPTH 296,002,866836,Staff,5,0,5,0
1739700751917,OPTH 296,003,866838,Staff,5,0,5,0
1739700752942,ORTH 296,A00,866851,Staff,5,0,5,0
1739700752942,ORTH 296,001,866849,Schwartz; Alexandra K.,4,0,5,1
1739700752942,ORTH 296,002,866850,Staff,5,0,5,0
1739700753967,PAE 240,A00,866068,Villarreal Jr.; Elias,30,0,30,0
1739700754995,PAE 241,A01,866073,Villarreal Jr.; Elias,30,0,30,0
1739700756022,PAE 242,A00,866077,Villarreal Jr.; Elias,30,0,30,0
1739700757048,PAE 243,A00,866078,Villarreal Jr.; Elias,30,0,30,0
1739700758073,PAE 244,A00,866119,Villarreal Jr.; Elias,30,0,30,0
1739700759097,PAE 245,A01,866083,Villarreal Jr.; Elias,30,0,30,0
1739700760123,PAE 246,A00,866085,Villarreal Jr.; Elias,30,0,30,0
1739700761146,PATH 296,001,866942,Staff,5,0,5,0
1739700761146,PATH 296,002,866945,Staff,5,0,5,0
1739700761146,PATH 296,003,866947,Staff,5,0,5,0
1739700762170,PEDS 296,001,866976,Staff,5,0,5,0
1739700762170,PEDS 296,002,866982,Staff,5,0,5,0
1739700762170,PEDS 296,003,866985,Staff,5,0,5,0
1739700763199,PH 45,A01,818863,Stone; Matthew David,28,0,30,2
1739700763199,PH 45,A02,818864,Stone; Matthew David,26,0,30,4
1739700764222,PH 50,A00,818865,Glockner; Susan Mariscal,291,0,300,9
1739700765248,PH 95,A00,885315,Larsen; Britta Ann,39,0,40,1
1739700766272,PH 101,A00,818868,Tan; Gene Brian,43,0,50,7
1739700767301,PH 102,A01,818870,Rana; Brinda Kanti,17,0,25,8
1739700767301,PH 102,A02,818871,Rana; Brinda Kanti,22,0,25,3
1739700767301,PH 102,B01,818963,Rana; Brinda Kanti,21,0,25,4
1739700767301,PH 102,B02,818965,Rana; Brinda Kanti,24,0,25,1
1739700768326,PH 110,A00,818966,Campbell; Chadwick Karl,58,0,60,2
1739700768326,PH 110,B00,818968,Zoumas-Morse; Christine E.,46,0,50,4
1739700769355,PH 120,A00,818972,Wynn; Adriane Michelle,50,0,60,10
1739700770380,PH 130,A00,818976,Gould; Carlos Francisco,36,0,50,14
1739700771409,PH 155,A00,818977,Fielding-Miller; Rebecca,68,0,70,2
1739700772436,PH 162,A00,872363,Eikey; Elizabeth Victoria,23,0,30,7
1739700773463,PH 194,A00,818984,Zoumas-Morse; Christine E.,0,0,0,0
1739700773463,PH 194,B00,819006,Zoumas-Morse; Christine E.,0,0,0,0
1739700773463,PH 194,C00,819010,Nguyen-Grozavu; France T.,0,0,0,0
1739700773463,PH 194,D00,819013,Nguyen-Grozavu; France T.,0,0,0,0
1739700773463,PH 194,E00,819017,White; Anne Elizabeth Clar,0,0,0,0
1739700773463,PH 194,F00,819024,Marquez; Becky,0,0,0,0
1739700774490,PH 196BH,A01,819028,Binkin; Nancy Jeanne,20,0,20,0
1739700775514,PHAR 219,A00,828488,Ross; Camille,0,0,0,0
1739700776540,PHAR 227,A00,872418,Zhang; Jin,19,0,20,1
1739700777568,PHAR 231,A00,881484,Daneman; Richard & Newton; Alexandra C.,20,0,20,0
1739700777568,PHAR 231,B00,881486,Staff,20,0,20,0
1739700777568,PHAR 231,C00,881489,Schoeneberg; Johannes,20,0,20,0
1739700778592,PHAR 234,A00,881479,Newton; Alexandra C.,20,0,20,0
1739700779617,PHAR 276,A00,828494,Mc Culloch; Andrew Douglas,0,0,0,0
1739700780644,PHAR 295,A00,828499,Joiner; William J.,14,0,15,1
1739700781670,PHB 223,A00,819029,Vaida; Florin,17,0,36,19
1739700782696,PHB 228,A00,819036,Thomas; Ronald G,26,0,36,10
1739700783724,PHB 248,A00,819043,Xu; Ronghui,10,0,25,15
1739700784750,PHB 281,A00,872569,Staff,55,0,65,10
1739700785775,PHIL 1,A00,829682,Grush; Rick Scott,57,0,60,3
1739700786809,PHIL 10,A01,829896,Grush; Rick Scott,44,0,44,0
1739700786809,PHIL 10,A02,829897,Grush; Rick Scott,43,0,44,1
1739700786809,PHIL 10,A03,829898,Grush; Rick Scott,43,0,44,1
1739700786809,PHIL 10,A04,829899,Grush; Rick Scott,42,0,44,2
1739700786809,PHIL 10,A05,829900,Grush; Rick Scott,42,0,44,2
1739700786809,PHIL 10,A06,829901,Grush; Rick Scott,42,0,44,2
1739700787834,PHIL 13,A01,829909,Brandt; Reuven A,0,0,0,0
1739700787834,PHIL 13,A02,829910,Brandt; Reuven A,21,0,25,4
1739700787834,PHIL 13,A03,829911,Brandt; Reuven A,0,0,0,0
1739700787834,PHIL 13,A04,829912,Brandt; Reuven A,25,0,25,0
1739700787834,PHIL 13,A05,829913,Brandt; Reuven A,23,0,25,2
1739700787834,PHIL 13,A06,829914,Brandt; Reuven A,24,0,25,1
1739700788866,PHIL 27,A01,829916,Harrell; Maralee Mae,20,0,25,5
1739700788866,PHIL 27,A02,829917,Harrell; Maralee Mae,21,0,25,4
1739700788866,PHIL 27,A03,829918,Harrell; Maralee Mae,17,0,25,8
1739700788866,PHIL 27,A04,829919,Harrell; Maralee Mae,23,0,25,2
1739700789895,PHIL 28,A01,829921,Lamey; Andy M.,24,0,25,1
1739700789895,PHIL 28,A02,829922,Lamey; Andy M.,24,0,25,1
1739700789895,PHIL 28,A03,829923,Lamey; Andy M.,15,0,25,10
1739700789895,PHIL 28,A04,829924,Lamey; Andy M.,24,0,25,1
1739700789895,PHIL 28,A05,829925,Lamey; Andy M.,23,0,25,2
1739700789895,PHIL 28,A06,829926,Lamey; Andy M.,24,0,25,1
1739700790921,PHIL 33,A01,829928,Tolley; Clinton,23,0,25,2
1739700790921,PHIL 33,A02,829929,Tolley; Clinton,24,0,25,1
1739700791948,PHIL 50,A00,829930,Yuan; Yuan,111,0,120,9
1739700792977,PHIL 60,A00,829989,Marechal; Patricia,33,0,33,0
1739700794002,PHIL 101,A00,829994,Marechal; Patricia,58,0,60,2
1739700795028,PHIL 102,A00,830057,Johnson; Monte,30,0,33,3
1739700796056,PHIL 108,A00,830058,Hardimon; Michael O.,31,0,33,2
1739700797082,PHIL 112,A00,830059,Hardimon; Michael O.,35,0,40,5
1739700798109,PHIL 120,A00,830060,Carr; Jennifer Rose,50,0,55,5
1739700799136,PHIL 125,A00,830063,Carr; Jennifer Rose,32,0,33,1
1739700800161,PHIL 131,A00,830065,Watkins; Eric,32,0,33,1
1739700801187,PHIL 134,A00,830066,Rudolph; Rachel Etta,31,0,33,2
1739700802212,PHIL 145,A00,830069,McKenzie; Kerry V.,54,0,60,6
1739700803237,PHIL 155,A00,830070,Tolley; Clinton,116,0,120,4
1739700804264,PHIL 160,A00,830071,Yuan; Yuan,32,0,33,1
1739700805292,PHIL 162,A00,830072,Lamey; Andy M.,41,0,42,1
1739700806315,PHIL 173,A00,830076,Brandt; Reuven A,108,0,120,12
1739700807341,PHIL 174,A01,830079,Danks; David J,27,0,27,0
1739700807341,PHIL 174,A02,830080,Danks; David J,27,0,27,0
1739700807341,PHIL 174,A03,830081,Danks; David J,27,0,27,0
1739700807341,PHIL 174,A04,830083,Danks; David J,27,0,27,0
1739700807341,PHIL 174,A05,830084,Danks; David J,26,0,27,1
1739700807341,PHIL 174,A06,830089,Danks; David J,27,0,27,0
1739700807341,PHIL 174,A07,830090,Danks; David J,27,0,27,0
1739700807341,PHIL 174,A08,830093,Danks; David J,27,0,27,0
1739700808368,PHIL 201A,A00,830095,Watkins; Eric,17,0,20,3
1739700809393,PHIL 202,A00,830097,Brink; David O.,16,0,20,4
1739700810417,PHIL 209B,A00,830098,Gere; Catherina M.,9,0,10,1
1739700811443,PHIL 209C,A00,830108,McKenzie; Kerry V.,10,0,10,0
1739700812469,PHIL 232,A00,830138,Sher; Gila,18,0,20,2
1739700813493,PHIL 234,A00,830139,Rudolph; Rachel Etta,18,0,20,2
1739700814518,PHIL 271,A00,830142,Vargas; Manuel Rogelio & Fulkerson; Matthew Todd,10,0,10,0
1739700815546,PHIL 275,A00,830179,Watkins; Eric,9,0,10,1
1739700816572,PHIL 277,A00,830185,Tolley; Clinton,9,0,10,1
1739700817650,PHIL 278,A00,830186,Fulkerson; Matthew Todd & Cohen; Jonathan David,10,0,10,0
1739700818676,PHIL 280,A00,830192,Kovaka; Karenc,10,0,10,0
1739700819704,PHIL 281,A00,830207,Tolley; Clinton,10,0,10,0
1739700820732,PHIL 283,A00,830214,Tolley; Clinton & Vargas; Manuel Rogelio,9,0,10,1
1739700821756,PHIL 284,A00,830244,Kovaka; Karenc,10,0,10,0
1739700822782,PHIL 285,A00,830255,Fulkerson; Matthew Todd & Cohen; Jonathan David,18,0,20,2
1739700823810,PHIL 286,A00,830259,Callender; Craig Adam & Chen; Keming,10,0,10,0
1739700824834,PHIL 287,A00,830262,Johnson; Monte,10,0,10,0
1739700825863,PHIL 290,001,828857,Nelkin; Dana Kay,9999,0,9999,0
1739700825863,PHIL 290,002,828858,Bazargan-Forward; Saba,9999,0,9999,0
1739700825863,PHIL 290,003,828861,Brandt; Reuven A,9999,0,9999,0
1739700825863,PHIL 290,004,828864,Brink; David O.,9999,0,9999,0
1739700825863,PHIL 290,005,828868,Callender; Craig Adam,9999,0,9999,0
1739700825863,PHIL 290,006,828869,Carr; Jennifer Rose,9999,0,9999,0
1739700825863,PHIL 290,007,828875,Cartwright; Nancy D.,9999,0,9999,0
1739700825863,PHIL 290,008,828878,Cohen; Jonathan David,9999,0,9999,0
1739700825863,PHIL 290,009,828880,Danks; David J,9999,0,9999,0
1739700825863,PHIL 290,010,828896,Fulkerson; Matthew Todd,9999,0,9999,0
1739700825863,PHIL 290,011,828897,Grush; Rick Scott,9999,0,9999,0
1739700825863,PHIL 290,012,828934,Hardimon; Michael O.,9999,0,9999,0
1739700825863,PHIL 290,013,828950,Harrell; Maralee Mae,9999,0,9999,0
1739700825863,PHIL 290,014,828951,Johnson; Monte,9999,0,9999,0
1739700825863,PHIL 290,015,828956,Kovaka; Karenc,9999,0,9999,0
1739700825863,PHIL 290,016,828959,Lamey; Andy M.,9999,0,9999,0
1739700825863,PHIL 290,017,828963,Marechal; Patricia,9999,0,9999,0
1739700825863,PHIL 290,018,828969,McKenzie; Kerry V.,9999,0,9999,0
1739700825863,PHIL 290,019,828970,Rickless; Samuel Charles,9999,0,9999,0
1739700825863,PHIL 290,020,828971,Sher; Gila,9999,0,9999,0
1739700825863,PHIL 290,021,828983,Shields; Christopher John,9999,0,9999,0
1739700825863,PHIL 290,022,829062,Tolley; Clinton,9999,0,9999,0
1739700825863,PHIL 290,023,829063,Vargas; Manuel Rogelio,9999,0,9999,0
1739700825863,PHIL 290,024,829065,Watkins; Eric,9999,0,9999,0
1739700825863,PHIL 290,025,829067,Chen; Keming,9999,0,9999,0
1739700825863,PHIL 290,026,829069,Yuan; Yuan,9999,0,9999,0
1739700825863,PHIL 290,027,829070,Kocurek; Alexander William,9999,0,9999,0
1739700825863,PHIL 290,028,829073,Rudolph; Rachel Etta,9999,0,9999,0
1739700826890,PHIL 295,001,829074,Bazargan-Forward; Saba,9999,0,9999,0
1739700826890,PHIL 295,002,829076,Brandt; Reuven A,9999,0,9999,0
1739700826890,PHIL 295,003,829080,Brink; David O.,9999,0,9999,0
1739700826890,PHIL 295,004,829081,Callender; Craig Adam,9999,0,9999,0
1739700826890,PHIL 295,005,829082,Carr; Jennifer Rose,9999,0,9999,0
1739700826890,PHIL 295,006,829135,Cartwright; Nancy D.,9999,0,9999,0
1739700826890,PHIL 295,007,829136,Chen; Keming,9999,0,9999,0
1739700826890,PHIL 295,008,829137,Cohen; Jonathan David,9999,0,9999,0
1739700826890,PHIL 295,009,829138,Danks; David J,9999,0,9999,0
1739700826890,PHIL 295,010,829139,Fulkerson; Matthew Todd,9999,0,9999,0
1739700826890,PHIL 295,011,829143,Grush; Rick Scott,9999,0,9999,0
1739700826890,PHIL 295,012,829144,Hardimon; Michael O.,9999,0,9999,0
1739700826890,PHIL 295,013,829145,Harrell; Maralee Mae,9999,0,9999,0
1739700826890,PHIL 295,014,829146,Johnson; Monte,9999,0,9999,0
1739700826890,PHIL 295,015,829147,Kovaka; Karenc,9999,0,9999,0
1739700826890,PHIL 295,016,829148,Lamey; Andy M.,9999,0,9999,0
1739700826890,PHIL 295,017,829149,Marechal; Patricia,9999,0,9999,0
1739700826890,PHIL 295,018,829150,McKenzie; Kerry V.,9999,0,9999,0
1739700826890,PHIL 295,019,829151,Nelkin; Dana Kay,9999,0,9999,0
1739700826890,PHIL 295,020,829152,Rickless; Samuel Charles,9999,0,9999,0
1739700826890,PHIL 295,021,829153,Sher; Gila,9999,0,9999,0
1739700826890,PHIL 295,022,829154,Shields; Christopher John,9999,0,9999,0
1739700826890,PHIL 295,023,829156,Tolley; Clinton,9999,0,9999,0
1739700826890,PHIL 295,024,829157,Vargas; Manuel Rogelio,9999,0,9999,0
1739700826890,PHIL 295,025,829158,Watkins; Eric,9999,0,9999,0
1739700826890,PHIL 295,026,829159,Kocurek; Alexander William,9999,0,9999,0
1739700826890,PHIL 295,027,829160,Rudolph; Rachel Etta,9999,0,9999,0
1739700826890,PHIL 295,028,829161,Yuan; Yuan,9999,0,9999,0
1739700827919,PHYS 1A,A00,830264,Tsai; Philbert S,350,0,360,10
1739700828953,PHYS 1AL,001,830274,Yagil; Avi & Tsai; Philbert S,25,0,30,5
1739700828953,PHYS 1AL,002,830320,Yagil; Avi & Tsai; Philbert S,28,0,30,2
1739700828953,PHYS 1AL,003,830324,Yagil; Avi & Tsai; Philbert S,29,0,30,1
1739700828953,PHYS 1AL,004,830352,Yagil; Avi & Tsai; Philbert S,30,0,30,0
1739700828953,PHYS 1AL,005,830364,Yagil; Avi & Tsai; Philbert S,27,0,30,3
1739700828953,PHYS 1AL,006,830365,Yagil; Avi & Tsai; Philbert S,25,0,30,5
1739700828953,PHYS 1AL,007,830366,Yagil; Avi & Tsai; Philbert S,30,0,30,0
1739700828953,PHYS 1AL,008,830378,Yagil; Avi & Tsai; Philbert S,29,0,30,1
1739700828953,PHYS 1AL,009,830485,Yagil; Avi & Tsai; Philbert S,29,0,30,1
1739700828953,PHYS 1AL,010,830486,Yagil; Avi & Tsai; Philbert S,30,0,30,0
1739700828953,PHYS 1AL,011,830496,Yagil; Avi & Tsai; Philbert S,30,0,30,0
1739700829980,PHYS 1B,A00,830497,Groisman; Alexander,344,0,360,16
1739700831011,PHYS 1BL,001,830498,Yagil; Avi & Tsai; Philbert S,29,0,30,1
1739700831011,PHYS 1BL,002,830499,Yagil; Avi & Tsai; Philbert S,29,0,30,1
1739700831011,PHYS 1BL,003,830500,Yagil; Avi & Tsai; Philbert S,29,0,30,1
1739700831011,PHYS 1BL,004,830501,Yagil; Avi & Tsai; Philbert S,28,0,30,2
1739700831011,PHYS 1BL,005,830502,Yagil; Avi & Tsai; Philbert S,29,0,30,1
1739700831011,PHYS 1BL,006,830503,Yagil; Avi & Tsai; Philbert S,28,0,30,2
1739700831011,PHYS 1BL,007,830504,Yagil; Avi & Tsai; Philbert S,26,0,30,4
1739700831011,PHYS 1BL,008,830505,Yagil; Avi & Tsai; Philbert S,29,0,30,1
1739700831011,PHYS 1BL,009,830507,Yagil; Avi & Tsai; Philbert S,29,0,30,1
1739700831011,PHYS 1BL,010,830508,Yagil; Avi & Tsai; Philbert S,26,0,30,4
1739700831011,PHYS 1BL,011,830509,Yagil; Avi & Tsai; Philbert S,29,0,30,1
1739700831011,PHYS 1BL,012,830510,Yagil; Avi & Tsai; Philbert S,29,0,30,1
1739700832039,PHYS 1C,A00,830511,Popmintchev; Tenio,591,0,600,9
1739700832039,PHYS 1C,B00,830512,Popmintchev; Tenio,562,0,600,38
1739700833068,PHYS 1CL,001,830513,Yagil; Avi & Tsai; Philbert S,29,0,30,1
1739700833068,PHYS 1CL,002,830514,Yagil; Avi & Tsai; Philbert S,30,0,30,0
1739700833068,PHYS 1CL,003,830515,Yagil; Avi & Tsai; Philbert S,24,0,30,6
1739700833068,PHYS 1CL,004,830516,Yagil; Avi & Tsai; Philbert S,26,0,30,4
1739700833068,PHYS 1CL,005,830517,Yagil; Avi & Tsai; Philbert S,24,0,30,6
1739700833068,PHYS 1CL,006,830518,Yagil; Avi & Tsai; Philbert S,30,0,30,0
1739700833068,PHYS 1CL,007,830519,Yagil; Avi & Tsai; Philbert S,26,0,30,4
1739700833068,PHYS 1CL,008,830520,Yagil; Avi & Tsai; Philbert S,25,0,30,5
1739700833068,PHYS 1CL,009,830521,Yagil; Avi & Tsai; Philbert S,28,0,30,2
1739700833068,PHYS 1CL,010,830522,Yagil; Avi & Tsai; Philbert S,29,0,30,1
1739700833068,PHYS 1CL,011,872498,Yagil; Avi & Tsai; Philbert S,30,0,30,0
1739700833068,PHYS 1CL,012,872499,Yagil; Avi & Tsai; Philbert S,30,0,30,0
1739700833068,PHYS 1CL,013,830584,Yagil; Avi & Tsai; Philbert S,18,0,30,12
1739700833068,PHYS 1CL,014,830586,Yagil; Avi & Tsai; Philbert S,27,0,30,3
1739700833068,PHYS 1CL,015,830588,Yagil; Avi & Tsai; Philbert S,26,0,30,4
1739700833068,PHYS 1CL,016,830591,Yagil; Avi & Tsai; Philbert S,24,0,30,6
1739700833068,PHYS 1CL,017,830592,Yagil; Avi & Tsai; Philbert S,29,0,30,1
1739700833068,PHYS 1CL,018,830598,Yagil; Avi & Tsai; Philbert S,27,0,30,3
1739700833068,PHYS 1CL,019,830604,Yagil; Avi & Tsai; Philbert S,29,0,30,1
1739700833068,PHYS 1CL,020,830605,Yagil; Avi & Tsai; Philbert S,28,0,30,2
1739700833068,PHYS 1CL,021,830607,Yagil; Avi & Tsai; Philbert S,27,0,30,3
1739700833068,PHYS 1CL,022,830609,Yagil; Avi & Tsai; Philbert S,28,0,30,2
1739700833068,PHYS 1CL,023,872500,Yagil; Avi & Tsai; Philbert S,28,0,30,2
1739700833068,PHYS 1CL,024,872501,Yagil; Avi & Tsai; Philbert S,30,0,30,0
1739700833068,PHYS 1CL,025,830613,Yagil; Avi & Tsai; Philbert S,29,0,30,1
1739700833068,PHYS 1CL,026,830617,Yagil; Avi & Tsai; Philbert S,30,0,30,0
1739700833068,PHYS 1CL,027,830658,Yagil; Avi & Tsai; Philbert S,30,0,30,0
1739700833068,PHYS 1CL,028,830661,Yagil; Avi & Tsai; Philbert S,29,0,30,1
1739700833068,PHYS 1CL,029,830669,Yagil; Avi & Tsai; Philbert S,25,0,30,5
1739700833068,PHYS 1CL,030,830676,Yagil; Avi & Tsai; Philbert S,30,0,30,0
1739700833068,PHYS 1CL,031,830679,Yagil; Avi & Tsai; Philbert S,24,0,30,6
1739700833068,PHYS 1CL,032,830680,Yagil; Avi & Tsai; Philbert S,28,0,30,2
1739700833068,PHYS 1CL,033,872502,Yagil; Avi & Tsai; Philbert S,30,0,30,0
1739700833068,PHYS 1CL,034,872503,Yagil; Avi & Tsai; Philbert S,27,0,30,3
1739700834102,PHYS 2A,A01,830828,Shotwell; Brian,19,0,30,11
1739700834102,PHYS 2A,A02,830829,Shotwell; Brian,29,0,30,1
1739700834102,PHYS 2A,A03,830830,Shotwell; Brian,30,0,30,0
1739700834102,PHYS 2A,A04,830831,Shotwell; Brian,30,0,30,0
1739700834102,PHYS 2A,A05,830832,Shotwell; Brian,28,0,30,2
1739700834102,PHYS 2A,A06,830849,Shotwell; Brian,27,0,30,3
1739700834102,PHYS 2A,A07,830887,Shotwell; Brian,28,0,30,2
1739700834102,PHYS 2A,A08,830888,Shotwell; Brian,30,0,30,0
1739700834102,PHYS 2A,A09,830889,Shotwell; Brian,30,0,30,0
1739700834102,PHYS 2A,A10,830890,Shotwell; Brian,30,0,30,0
1739700834102,PHYS 2A,A11,830934,Shotwell; Brian,0,0,0,0
1739700834102,PHYS 2A,A12,830938,Shotwell; Brian,0,0,0,0
1739700835137,PHYS 2B,A01,830950,Meyertholen; Andrew D.,29,0,30,1
1739700835137,PHYS 2B,A02,830982,Meyertholen; Andrew D.,30,0,30,0
1739700835137,PHYS 2B,A03,830983,Meyertholen; Andrew D.,30,0,30,0
1739700835137,PHYS 2B,A04,830984,Meyertholen; Andrew D.,30,0,30,0
1739700835137,PHYS 2B,A05,830985,Meyertholen; Andrew D.,25,0,30,5
1739700835137,PHYS 2B,A06,830986,Meyertholen; Andrew D.,30,0,30,0
1739700835137,PHYS 2B,A07,830987,Meyertholen; Andrew D.,28,0,30,2
1739700835137,PHYS 2B,A08,830988,Meyertholen; Andrew D.,29,0,30,1
1739700835137,PHYS 2B,A09,830989,Meyertholen; Andrew D.,30,0,30,0
1739700835137,PHYS 2B,A10,831009,Meyertholen; Andrew D.,29,0,30,1
1739700835137,PHYS 2B,A11,831010,Meyertholen; Andrew D.,24,0,30,6
1739700835137,PHYS 2B,A12,831018,Meyertholen; Andrew D.,30,0,30,0
1739700835137,PHYS 2B,B01,831020,Meyertholen; Andrew D.,21,0,30,9
1739700835137,PHYS 2B,B02,831021,Meyertholen; Andrew D.,30,0,30,0
1739700835137,PHYS 2B,B03,831022,Meyertholen; Andrew D.,29,0,30,1
1739700835137,PHYS 2B,B04,831036,Meyertholen; Andrew D.,28,0,30,2
1739700835137,PHYS 2B,B05,831037,Meyertholen; Andrew D.,29,0,30,1
1739700835137,PHYS 2B,B06,831043,Meyertholen; Andrew D.,30,0,30,0
1739700835137,PHYS 2B,B07,831046,Meyertholen; Andrew D.,30,0,30,0
1739700835137,PHYS 2B,B08,831047,Meyertholen; Andrew D.,30,0,30,0
1739700835137,PHYS 2B,B09,831061,Meyertholen; Andrew D.,29,0,30,1
1739700835137,PHYS 2B,B10,831062,Meyertholen; Andrew D.,29,0,30,1
1739700835137,PHYS 2B,B11,831069,Meyertholen; Andrew D.,30,0,30,0
1739700835137,PHYS 2B,B12,831070,Meyertholen; Andrew D.,30,0,30,0
1739700836167,PHYS 2BL,A01,831108,Sharma; Vivek A.,24,0,24,0
1739700836167,PHYS 2BL,A02,831109,Sharma; Vivek A.,12,0,24,12
1739700836167,PHYS 2BL,A03,831112,Sharma; Vivek A.,22,0,24,2
1739700836167,PHYS 2BL,A04,831113,Sharma; Vivek A.,21,0,24,3
1739700836167,PHYS 2BL,A05,831127,Sharma; Vivek A.,24,0,24,0
1739700836167,PHYS 2BL,A06,831150,Sharma; Vivek A.,17,0,24,7
1739700836167,PHYS 2BL,A07,831327,Sharma; Vivek A.,21,0,24,3
1739700836167,PHYS 2BL,A08,831329,Sharma; Vivek A.,23,0,24,1
1739700836167,PHYS 2BL,A09,831338,Sharma; Vivek A.,24,0,24,0
1739700836167,PHYS 2BL,A10,831345,Sharma; Vivek A.,23,0,24,1
1739700836167,PHYS 2BL,A11,831355,Sharma; Vivek A.,21,0,24,3
1739700836167,PHYS 2BL,A12,831357,Sharma; Vivek A.,24,0,24,0
1739700836167,PHYS 2BL,A13,831428,Sharma; Vivek A.,24,0,24,0
1739700836167,PHYS 2BL,A14,831433,Sharma; Vivek A.,21,0,24,3
1739700836167,PHYS 2BL,A15,831434,Sharma; Vivek A.,21,0,24,3
1739700837198,PHYS 2C,A01,831436,Shotwell; Brian,29,0,30,1
1739700837198,PHYS 2C,A02,831440,Shotwell; Brian,30,0,30,0
1739700837198,PHYS 2C,A03,831441,Shotwell; Brian,27,0,30,3
1739700837198,PHYS 2C,A04,831444,Shotwell; Brian,29,0,30,1
1739700837198,PHYS 2C,A05,831445,Shotwell; Brian,27,0,30,3
1739700837198,PHYS 2C,A06,831446,Shotwell; Brian,30,0,30,0
1739700837198,PHYS 2C,A07,831453,Shotwell; Brian,28,0,30,2
1739700837198,PHYS 2C,A08,831454,Shotwell; Brian,29,0,30,1
1739700837198,PHYS 2C,A09,831469,Shotwell; Brian,25,0,30,5
1739700837198,PHYS 2C,A10,831470,Shotwell; Brian,27,0,30,3
1739700837198,PHYS 2C,A11,831471,Shotwell; Brian,30,0,30,0
1739700837198,PHYS 2C,A12,831481,Shotwell; Brian,27,0,30,3
1739700838224,PHYS 2CL,A01,831597,Ni; Kaixuan,25,0,28,3
1739700838224,PHYS 2CL,A02,831598,Ni; Kaixuan,23,0,28,5
1739700838224,PHYS 2CL,A03,831599,Ni; Kaixuan,27,0,28,1
1739700838224,PHYS 2CL,A04,831601,Ni; Kaixuan,26,0,28,2
1739700838224,PHYS 2CL,A05,831602,Ni; Kaixuan,26,0,28,2
1739700838224,PHYS 2CL,A06,831603,Ni; Kaixuan,26,0,28,2
1739700839250,PHYS 2D,A01,831605,Branson; James G,26,0,30,4
1739700839250,PHYS 2D,A02,831606,Branson; James G,30,0,30,0
1739700839250,PHYS 2D,A03,831607,Branson; James G,30,0,30,0
1739700840275,PHYS 4B,A01,831609,Grinstein; Benjamin,30,0,30,0
1739700840275,PHYS 4B,A02,831610,Grinstein; Benjamin,29,0,30,1
1739700840275,PHYS 4B,A03,831611,Grinstein; Benjamin,29,0,30,1
1739700840275,PHYS 4B,A04,831612,Grinstein; Benjamin,28,0,30,2
1739700841304,PHYS 4E,A01,831622,Intriligator; Kenneth Arthur,39,0,40,1
1739700841304,PHYS 4E,A02,831630,Intriligator; Kenneth Arthur,40,0,40,0
1739700841304,PHYS 4E,A03,831631,Intriligator; Kenneth Arthur,39,0,40,1
1739700842332,PHYS 87,A00,869095,Grinstein; Benjamin,20,0,20,0
1739700843357,PHYS 100C,A01,831698,Barreiro Guerrero; Julio,57,0,60,3
1739700844384,PHYS 105B,A01,831700,Green; Daniel Richard,24,0,24,0
1739700845413,PHYS 120,A01,831702,Yang; Liang,31,0,32,1
1739700845413,PHYS 120,A02,831916,Yang; Liang,30,0,32,2
1739700846441,PHYS 130A,A01,831918,You; Yizhuang,90,0,90,0
1739700847468,PHYS 130B,A01,831921,You; Yizhuang,49,0,50,1
1739700848497,PHYS 137,A01,831924,Intriligator; Kenneth Arthur,33,0,36,3
1739700849523,PHYS 140A,A01,831928,Frano Pereira; Alex M,45,0,50,5
1739700850548,PHYS 141,A00,831929,Zhao; Hongbo,57,0,60,3
1739700851576,PHYS 152B,A01,831932,Hirsch; Jorge Eduardo,17,0,20,3
1739700852603,PHYS 154,A01,872509,Grinstein; Benjamin,21,0,23,2
1739700853633,PHYS 162,A01,831935,Keating; Brian,43,0,46,3
1739700854660,PHYS 170,A01,831938,Oh; Seungeun,23,0,25,2
1739700855688,PHYS 177,A00,831940,Dudko; Olga,18,0,20,2
1739700856718,PHYS 202,A00,831941,Vergassola; Massimo & Diamond; Patrick H,19,0,20,1
1739700857743,PHYS 203B,A01,831943,Fogler; Michael M.,17,0,20,3
1739700858773,PHYS 210A,A01,831946,Arovas; Daniel P,19,0,20,1
1739700859801,PHYS 212C,A01,831948,Grover; Tarun,18,0,20,2
1739700860827,PHYS 215C,A00,831949,McGreevy; John A.,10,0,10,0
1739700861852,PHYS 221A,A00,831953,Tan; Tzer Han,20,0,20,0
1739700862880,PHYS 222A,A00,831954,Ni; Kaixuan,10,0,10,0
1739700863908,PHYS 227,A00,831958,Fuller; George Michael,22,0,25,3
1739700864935,PHYS 228,A00,831961,Flauger; Raphael M,24,0,25,1
1739700865960,PHYS 232,A00,831962,Hirsch; Jorge Eduardo,5,0,5,0
1739700866986,PHYS 239,A00,831963,Goldenfeld; Nigel,7,0,10,3
1739700866986,PHYS 239,B00,831964,Serra; Mattia,8,0,10,2
1739700868014,PHYS 241,A00,831965,Zhao; Hongbo,4,0,5,1
1739700869038,PHYS 250,A00,831969,Di Ventra; Massimiliano,50,0,50,0
1739700870065,PHYS 251,A00,831970,Grinstein; Benjamin,20,0,20,0
1739700871090,PHYS 252,A00,831971,Diamond; Patrick H,10,0,10,0
1739700872115,PHYS 253,A00,831972,Fuller; George Michael,30,0,30,0
1739700873139,PHYS 254,A00,831973,Serra; Mattia,29,0,30,1
1739700874164,PHYS 255,A00,831974,Hwa; Terence T.,30,0,30,0
1739700875188,PHYS 260,A00,831975,Fuller; George Michael,50,0,50,0
1739700876211,PHYS 277,A00,831976,Dudko; Olga,14,0,20,6
1739700877237,POLI 5D,A01,832046,Arnold; David Hall,7,0,8,1
1739700877237,POLI 5D,A02,832047,Arnold; David Hall,8,0,8,0
1739700877237,POLI 5D,A03,832049,Arnold; David Hall,8,0,8,0
1739700877237,POLI 5D,A04,832050,Arnold; David Hall,7,0,8,1
1739700877237,POLI 5D,A05,832051,Arnold; David Hall,8,0,8,0
1739700877237,POLI 5D,B01,832055,Dai; Yinlin,5,0,5,0
1739700877237,POLI 5D,B02,832056,Dai; Yinlin,4,0,5,1
1739700878263,POLI 10D,A01,832058,Noble; Benjamin S,33,0,34,1
1739700878263,POLI 10D,A02,832059,Noble; Benjamin S,33,0,34,1
1739700878263,POLI 10D,A03,832060,Noble; Benjamin S,34,0,34,0
1739700878263,POLI 10D,A04,832061,Noble; Benjamin S,33,0,34,1
1739700878263,POLI 10D,A05,832062,Noble; Benjamin S,33,0,34,1
1739700878263,POLI 10D,A06,832064,Noble; Benjamin S,34,0,34,0
1739700879292,POLI 12D,A01,832067,Thai; Eric,30,0,34,4
1739700879292,POLI 12D,A02,832068,Thai; Eric,32,0,34,2
1739700879292,POLI 12D,A03,832069,Thai; Eric,34,0,34,0
1739700879292,POLI 12D,A04,832070,Thai; Eric,34,0,34,0
1739700879292,POLI 12D,A05,832072,Thai; Eric,33,0,34,1
1739700879292,POLI 12D,A06,832074,Thai; Eric,34,0,34,0
1739700880318,POLI 27,A01,832079,Elgin; Samuel Zincke,27,0,34,7
1739700880318,POLI 27,A02,832081,Elgin; Samuel Zincke,31,0,34,3
1739700880318,POLI 27,A03,832082,Elgin; Samuel Zincke,34,0,34,0
1739700880318,POLI 27,A04,832083,Elgin; Samuel Zincke,32,0,34,2
1739700881348,POLI 28,A01,832085,Elgin; Samuel Zincke,29,0,34,5
1739700881348,POLI 28,A02,832087,Elgin; Samuel Zincke,30,0,34,4
1739700881348,POLI 28,A03,832092,Elgin; Samuel Zincke,32,0,34,2
1739700881348,POLI 28,A04,832093,Elgin; Samuel Zincke,33,0,34,1
1739700882374,POLI 30D,A01,832096,Anderson; Anthony Michael,19,0,28,9
1739700882374,POLI 30D,A02,832098,Anderson; Anthony Michael,23,0,28,5
1739700882374,POLI 30D,A03,832100,Anderson; Anthony Michael,27,0,28,1
1739700882374,POLI 30D,A04,832102,Anderson; Anthony Michael,27,0,28,1
1739700882374,POLI 30D,A05,832103,Anderson; Anthony Michael,20,0,28,8
1739700882374,POLI 30D,A06,832252,Anderson; Anthony Michael,28,0,28,0
1739700883399,POLI 87,A00,881663,Mignozzetti; Umberto,20,0,20,0
1739700884428,POLI 100O,A00,832254,Boehmer; Alison Paige,106,0,115,9
1739700885454,POLI 104Q,A00,832257,Nichter; Maysa,100,0,120,20
1739700886480,POLI 104U,A00,869584,Nichter; Maysa,56,0,75,19
1739700887504,POLI 104V,A00,832258,Staff,43,0,50,7
1739700888534,POLI 110C,A00,832259,Soon; Valerie,49,0,50,1
1739700889559,POLI 119A,A00,832260,Staff,45,0,50,5
1739700890584,POLI 120D,A00,832261,Hansen; Jan Eric,45,0,50,5
1739700891609,POLI 121D,A00,832262,Roberts; Margaret Earling,113,0,115,2
1739700892633,POLI 126AB,A00,832263,Fisk; David Lee,154,0,156,2
1739700893661,POLI 131CR,A00,832264,Hoston; Germaine,131,0,135,4
1739700893661,POLI 131CR,B00,877489,Hoston; Germaine,30,0,30,0
1739700894686,POLI 140D,A00,832265,Wong; Tak Kei,191,0,200,9
1739700895711,POLI 145C,A00,832267,Fisk; David Lee,191,0,196,5
1739700896736,POLI 149,A00,832268,Joseph; Michael F,192,0,196,4
1739700897760,POLI 150A,A00,832269,Wong; Tak Kei,235,0,245,10
1739700898786,POLI 170,A00,872371,Staff,110,0,115,5
1739700899811,POLI 176,A00,832337,Roberts; Margaret Earling,73,0,80,7
1739700900836,POLI 194,A00,832339,Staff,9999,0,9999,0
1739700901863,POLI 194SD,A00,832431,Nichter; Maysa,25,0,25,0
1739700902890,POLI 197SD,001,832432,Nichter; Maysa,25,0,25,0
1739700903916,POLI 198RA,001,832499,Broz; James Lawrence,25,0,25,0
1739700904943,POLI 203B,A00,832500,Slantchev; Branislav,23,0,25,2
1739700905968,POLI 218R,A00,832535,Hoston; Germaine,24,0,25,1
1739700906993,POLI 219,A00,832536,Soon; Valerie,10,0,10,0
1739700908020,POLI 220A,A00,832537,Ferree; Karen E,21,0,25,4
1739700909047,POLI 243,A00,832538,Joseph; Michael F,24,0,25,1
1739700910074,POLI 250,A00,832539,Stout; Christopher Timothy,22,0,25,3
1739700912126,POLI 273,A00,832541,Mignozzetti; Umberto,8,0,25,17
1739700913152,POLI 281,A00,832542,Ban; Pamela M,11,0,12,1
1739700914179,POLI 282,A00,832543,Ferree; Karen E,24,0,25,1
1739700915205,POLI 283,A00,832544,Slantchev; Branislav,23,0,25,2
1739700916229,POLI 285,A00,832545,Ingham; Sean,12,0,12,0
1739700917254,POLI 286,A00,832546,Mignozzetti; Umberto,25,0,25,0
1739700918279,PSY 296,001,867611,Eyler; Lisa T.,4,0,5,1
1739700918279,PSY 296,002,867612,Fettes; Danielle Lynn,4,0,5,1
1739700918279,PSY 296,003,867613,Staff,5,0,5,0
1739700919305,PSYC 1,A00,841780,Hurwitz; Ethan Scott,292,0,300,8
1739700920330,PSYC 3R,A00,841782,Pilegard; Celeste Cristine,297,0,310,13
1739700921411,PSYC 60,A01,862444,Lowe; Angela Beth,34,0,35,1
1739700921411,PSYC 60,A02,862476,Lowe; Angela Beth,33,0,35,2
1739700921411,PSYC 60,A03,862477,Lowe; Angela Beth,34,0,35,1
1739700921411,PSYC 60,A04,862499,Lowe; Angela Beth,32,0,35,3
1739700921411,PSYC 60,A05,862516,Lowe; Angela Beth,35,0,35,0
1739700921411,PSYC 60,A06,862578,Lowe; Angela Beth,34,0,35,1
1739700921411,PSYC 60,A07,862603,Lowe; Angela Beth,34,0,35,1
1739700921411,PSYC 60,B01,862605,Rose; Fred E.,32,0,35,3
1739700921411,PSYC 60,B02,862622,Rose; Fred E.,34,0,35,1
1739700921411,PSYC 60,B03,862658,Rose; Fred E.,33,0,35,2
1739700921411,PSYC 60,B04,862659,Rose; Fred E.,32,0,35,3
1739700921411,PSYC 60,B05,862669,Rose; Fred E.,35,0,35,0
1739700921411,PSYC 60,B06,862680,Rose; Fred E.,33,0,35,2
1739700921411,PSYC 60,B07,862682,Rose; Fred E.,34,0,35,1
1739700922436,PSYC 70,A01,862683,Pilegard; Celeste Cristine,29,0,35,6
1739700922436,PSYC 70,A02,862684,Pilegard; Celeste Cristine,33,0,35,2
1739700922436,PSYC 70,A03,862688,Pilegard; Celeste Cristine,35,0,35,0
1739700922436,PSYC 70,A04,862697,Pilegard; Celeste Cristine,35,0,35,0
1739700922436,PSYC 70,A05,862698,Pilegard; Celeste Cristine,35,0,35,0
1739700922436,PSYC 70,A06,862738,Pilegard; Celeste Cristine,35,0,35,0
1739700923467,PSYC 71,A01,841792,Geller; Emma Harlan,21,0,25,4
1739700923467,PSYC 71,A02,841793,Geller; Emma Harlan,25,0,26,1
1739700923467,PSYC 71,B01,841795,Steiner; Eric Tomas,16,0,21,5
1739700923467,PSYC 71,B02,841797,Steiner; Eric Tomas,20,0,21,1
1739700924492,PSYC 88,A00,841802,Dobkins; Karen R.,52,0,65,13
1739700925518,PSYC 100,A00,841803,Chapman; Eddie Nathaniel,299,0,348,49
1739700926543,PSYC 101,A00,841804,Schachner; Adena,264,0,295,31
1739700927571,PSYC 102,A00,841807,Moranton; Nirelia Melbina-,294,0,295,1
1739700928595,PSYC 104,A00,841810,McCullough; Michael E,193,0,265,72
1739700929620,PSYC 105,A00,841812,Lau; Aubrey,294,0,295,1
1739700930646,PSYC 108,A00,841813,Adrian; Julia Anna,291,0,295,4
1739700931676,PSYC 111B,A01,841865,Geller; Emma Harlan,35,0,35,0
1739700932701,PSYC 116C,A01,841922,Lang; Ariel,25,0,25,0
1739700933728,PSYC 117,A01,872925,Bajic; Daniel Andrew,25,0,25,0
1739700934754,PSYC 118,A01,841931,Miller; Cory T.,39,0,45,6
1739700935784,PSYC 124,A00,841932,Chapman; Eddie Nathaniel,336,0,348,12
1739700936808,PSYC 125,A00,841933,Rose; Fred E.,140,0,146,6
1739700937833,PSYC 127,A00,841934,Dickenson; Janna Alene,17,0,20,3
1739700938857,PSYC 131,A00,841936,Anagnostaras; Stephan,47,0,65,18
1739700939881,PSYC 132,A00,841937,Steiner; Eric Tomas,90,0,120,30
1739700940905,PSYC 137,A00,841939,Winkielman; Piotr,212,0,216,4
1739700941931,PSYC 144,A00,841941,Wixted; John T,293,0,295,2
1739700942956,PSYC 164,A00,841943,Kaplan; Paul,276,0,295,19
1739700943984,PSYC 169,A00,841944,Tallman; Catherine Walsh,271,0,295,24
1739700945010,PSYC 178,A00,841945,Glaser; Dale,132,0,146,14
1739700946036,PSYC 179,A00,841980,Lacefield; Katharine I,290,0,350,60
1739700947061,PSYC 188,A00,842062,Lacefield; Katharine I,233,0,300,67
1739700948089,PSYC 190,A00,842063,Barner; David A.,274,0,300,26
1739700949120,PSYC 193,A00,842067,Brashier; Nadia Marie,214,0,216,2
1739700949120,PSYC 193,B00,842068,Gremel; Christina M,33,0,35,2
1739700949120,PSYC 193,C00,842095,Harris; Christine Renee,20,0,20,0
1739700949120,PSYC 193,D00,842096,Lin; Chujun,59,0,60,1
1739700949120,PSYC 193,E00,842154,Long; Bria,24,0,25,1
1739700949120,PSYC 193,F00,872477,Mukku; Dhananjaya,35,0,35,0
1739700950144,PSYC 193L,A01,842159,Aron; Adam,18,0,21,3
1739700950144,PSYC 193L,B01,842163,Barner; David A.,22,0,24,2
1739700950144,PSYC 193L,C01,842167,Brown; Sandra A,65,0,65,0
1739700951172,PSYC 194C,A01,842196,Heyman; Gail D.,1,0,1,0
1739700952197,PSYC 210,A00,842202,Powell; Lindsey Jane,17,0,20,3
1739700953222,PSYC 222,A00,842339,Gorman; Michael R.,20,0,20,0
1739700954264,PSYC 224,A00,842402,Miller; Cory T.,29,0,30,1
1739700955291,PSYC 242,A00,842579,Walker; Caren Michelle,28,0,30,2
1739700956315,PSYC 270C,A00,842580,Dobkins; Karen R.,19,0,20,1
1739700957342,PSYC 271,A00,842581,Anagnostaras; Stephan,19,0,20,1
1739700958372,PSYC 272,A00,842582,Gentner; Tim,18,0,20,2
1739700958372,PSYC 272,B00,872469,Mukku; Dhananjaya,20,0,20,0
1739700959399,PSYC 274,A00,842583,McCullough; Michael E,30,0,30,0
1739700960425,PSYC 275,A00,842600,Brady; Timothy Francis,29,0,30,1
1739700961450,PSYC 276,A00,842601,McCullough; Michael E,15,0,20,5
1739700962474,PSYC 280,A00,842760,Serences; John Thomas,76,0,80,4
1739700963511,PSYC 296,001,851620,Anagnostaras; Stephan,9999,0,9999,0
1739700963511,PSYC 296,002,851621,Aron; Adam,9999,0,9999,0
1739700963511,PSYC 296,003,851622,Mukku; Dhananjaya,9999,0,9999,0
1739700963511,PSYC 296,004,851623,Barner; David A.,9998,0,9999,1
1739700963511,PSYC 296,005,851624,Schachner; Adena,9999,0,9999,0
1739700963511,PSYC 296,006,851625,Brady; Timothy Francis,9999,0,9999,0
1739700963511,PSYC 296,007,851627,Brashier; Nadia Marie,9999,0,9999,0
1739700963511,PSYC 296,008,851628,Brown; Sandra A,9999,0,9999,0
1739700963511,PSYC 296,009,851629,Carver; Leslie J.,9999,0,9999,0
1739700963511,PSYC 296,010,851630,Chapman; Eddie Nathaniel,9999,0,9999,0
1739700963511,PSYC 296,011,851631,Dickenson; Janna Alene,9999,0,9999,0
1739700963511,PSYC 296,012,851632,Dobkins; Karen R.,9999,0,9999,0
1739700963511,PSYC 296,014,851635,Ferreira; Victor,9999,0,9999,0
1739700963511,PSYC 296,015,851636,Geller; Emma Harlan,9999,0,9999,0
1739700963511,PSYC 296,016,851637,Gentner; Tim,9998,0,9999,1
1739700963511,PSYC 296,017,851642,Gorman; Michael R.,9999,0,9999,0
1739700963511,PSYC 296,018,851644,Gremel; Christina M,9999,0,9999,0
1739700963511,PSYC 296,019,851645,Harris; Christine Renee,9999,0,9999,0
1739700963511,PSYC 296,020,851646,Heyman; Gail D.,9999,0,9999,0
1739700963511,PSYC 296,021,851647,Lin; Chujun,9999,0,9999,0
1739700963511,PSYC 296,022,851648,Long; Bria,9999,0,9999,0
1739700963511,PSYC 296,023,851650,McCullough; Michael E,9999,0,9999,0
1739700963511,PSYC 296,024,851655,Mc Kenzie; Craig R.M.,9999,0,9999,0
1739700963511,PSYC 296,025,851656,Miller; Cory T.,9999,0,9999,0
1739700963511,PSYC 296,026,851657,Oesch; Nicholas W,9999,0,9999,0
1739700963511,PSYC 296,028,851662,Pilegard; Celeste Cristine,9999,0,9999,0
1739700963511,PSYC 296,029,851664,Powell; Lindsey Jane,9999,0,9999,0
1739700963511,PSYC 296,030,851665,Rickard; Timothy C.,9999,0,9999,0
1739700963511,PSYC 296,031,851672,Serences; John Thomas,9999,0,9999,0
1739700963511,PSYC 296,032,851774,Walker; Caren Michelle,9999,0,9999,0
1739700963511,PSYC 296,033,851778,Winkielman; Piotr,9999,0,9999,0
1739700963511,PSYC 296,034,851808,Wixted; John T,9999,0,9999,0
1739700964537,RAD 296,001,867654,Staff,5,0,5,0
1739700964537,RAD 296,002,867659,Staff,5,0,5,0
1739700964537,RAD 296,003,867666,Staff,5,0,5,0
1739700965563,RELI 150,A00,832548,Rahimi; Babak,37,0,40,3
1739700966589,RELI 189,A00,832549,Rahimi; Babak,40,0,40,0
1739700967613,REV 12,A00,869164,Yu; Paul K L,40,0,40,0
1739700968637,REV 20,A00,869165,Yu; Paul K L,40,0,40,0
1739700969666,REV 87,A00,869166,Rodriguez; Bretton Sigfred,19,0,20,1
1739700970693,RMAS 296,001,867895,Murphy; James D,5,0,5,0
1739700970693,RMAS 296,002,867896,Staff,5,0,5,0
1739700970693,RMAS 296,003,867897,Staff,5,0,5,0
1739700971721,RMED 296,001,867854,Duleba; Antoni,4,0,5,1
1739700971721,RMED 296,002,867860,Staff,5,0,5,0
1739700971721,RMED 296,003,867882,Staff,5,0,5,0
1739700972748,SE 3,A01,838151,Van Den Einde; Yael Dahlia,42,0,52,10
1739700972748,SE 3,A02,838152,Van Den Einde; Yael Dahlia,50,0,52,2
1739700972748,SE 3,A03,838153,Van Den Einde; Yael Dahlia,50,0,53,3
1739700972748,SE 3,A04,838154,Van Den Einde; Yael Dahlia,51,0,53,2
1739700972748,SE 3,A05,838155,Van Den Einde; Yael Dahlia,49,0,50,1
1739700973775,SE 101B,A01,838160,Van Den Einde; Yael Dahlia,53,0,56,3
1739700974800,SE 105,A01,838162,Qiao; Yu,85,0,88,3
1739700975825,SE 110A,A01,838164,Staff,53,0,56,3
1739700976854,SE 110B,A00,838166,Zhu; Qiang,123,0,125,2
1739700977882,SE 130B,A01,838174,Krysl; Petr,93,0,100,7
1739700978911,SE 131A,A01,838499,Krysl; Petr,103,0,110,7
1739700979937,SE 140B,A01,838504,Palermo; Alessandro,22,0,24,2
1739700979937,SE 140B,A02,838505,Palermo; Alessandro,21,0,24,3
1739700979937,SE 140B,A03,838507,Palermo; Alessandro,23,0,24,1
1739700979937,SE 140B,A04,871139,Palermo; Alessandro,14,0,24,10
1739700979937,SE 140B,A05,871140,Palermo; Alessandro,0,0,24,24
1739700979937,SE 140B,A06,871141,Palermo; Alessandro,23,0,24,1
1739700980961,SE 143B,A01,838512,Kosmatka; John B,4,0,15,11
1739700980961,SE 143B,A02,838513,Kosmatka; John B,9,0,15,6
1739700981990,SE 150A,A01,838526,Uang; Chia-Ming,94,0,100,6
1739700983016,SE 150B,A01,838538,Morrison; Machel Leigh,36,0,50,14
1739700984041,SE 151B,A00,838540,Tsampras; Georgios,62,0,75,13
1739700985069,SE 160B,A01,838543,Kim; Hyunsun Alicia,96,0,100,4
1739700986097,SE 165,A00,838544,Todd; Michael,1,0,10,9
1739700987125,SE 183,A00,872450,Tomac; Ingrid,0,0,0,3
1739700988154,SE 202,A00,838832,Kosmatka; John B,28,0,30,2
1739700989179,SE 203B,A00,838855,Tsampras; Georgios,49,0,65,16
1739700990204,SE 213,A00,838859,Palermo; Alessandro,21,0,30,9
1739700991228,SE 214,A00,870032,Shing; P. Benson,19,0,40,21
1739700992257,SE 215,A00,838876,Zhu; Qiang,34,0,45,11
1739700993285,SE 224,A00,838921,Conte; Joel P,36,0,50,14
1739700994312,SE 246,A00,838926,McCartney; John Scott,25,0,30,5
1739700995340,SE 249,A01,839605,Tomac; Ingrid,15,0,20,5
1739700996365,SE 251B,A00,838934,Qiao; Yu,17,0,25,8
1739700997392,SE 253B,A00,838942,Kim; Hyonny,30,0,30,0
1739700998423,SE 260B,A00,838947,Kim; Hyunsun Alicia,10,0,10,0
1739700999448,SE 265,A00,838954,Todd; Michael,10,0,20,10
1739701000472,SE 279,A00,838959,Chen; Jiun-Shyan,24,0,30,6
1739701001499,SE 290,A00,838962,Loh; Kenneth J. H.,74,0,100,26
1739701002528,SE 296,001,838963,Asaro; Robert J,9999,0,9999,0
1739701002528,SE 296,002,838980,Chen; Jiun-Shyan,9999,0,9999,0
1739701002528,SE 296,003,838992,Conte; Joel P,9999,0,9999,0
1739701002528,SE 296,004,839039,Elgamal; Ahmed,9999,0,9999,0
1739701002528,SE 296,005,839040,Hutchinson; Tara,9999,0,9999,0
1739701002528,SE 296,006,839041,Jandaghi Semnani; Shabnam,9999,0,9999,0
1739701002528,SE 296,007,839042,Kim; Hyonny,9999,0,9999,0
1739701002528,SE 296,008,839055,Kim; Hyunsun Alicia,9999,0,9999,0
1739701002528,SE 296,009,839059,Kosmatka; John B,9999,0,9999,0
1739701002528,SE 296,010,839087,Krysl; Petr,9999,0,9999,0
1739701002528,SE 296,011,839094,Kuester; Falko,9999,0,9999,0
1739701002528,SE 296,012,839115,Lanza Di Scalea; Francesco,9999,0,9999,0
1739701002528,SE 296,013,839173,Loh; Kenneth J. H.,9999,0,9999,0
1739701002528,SE 296,014,839174,McCartney; John Scott,9999,0,9999,0
1739701002528,SE 296,015,839198,Morrison; Machel Leigh,9999,0,9999,0
1739701002528,SE 296,016,839229,Mosqueda; Gilberto,9999,0,9999,0
1739701002528,SE 296,017,839230,Qiao; Yu,9999,0,9999,0
1739701002528,SE 296,018,839234,Restrepo; Jose,9999,0,9999,0
1739701002528,SE 296,019,839243,Shing; P. Benson,9999,0,9999,0
1739701002528,SE 296,020,839323,Todd; Michael,9999,0,9999,0
1739701002528,SE 296,021,839326,Tomac; Ingrid,9999,0,9999,0
1739701002528,SE 296,022,839327,Tsampras; Georgios,9999,0,9999,0
1739701002528,SE 296,023,839329,Uang; Chia-Ming,9999,0,9999,0
1739701002528,SE 296,024,839340,Van Den Einde; Yael Dahlia,9999,0,9999,0
1739701002528,SE 296,025,839342,Zhu; Qiang,9999,0,9999,0
1739701002528,SE 296,026,839351,Tehrani; Mehran,9999,0,9999,0
1739701002528,SE 296,027,839356,Palermo; Alessandro,9999,0,9999,0
1739701003554,SEV 20,A00,838033,Antonovics; Kate L.,30,0,30,0
1739701004579,SIO 10,A00,839607,Borsa; Adrian Antal,591,0,600,9
1739701005607,SIO 16,A00,839615,Stegman; David,146,0,150,4
1739701006633,SIO 35,A00,839616,Driscoll; Neal W.,189,0,210,21
1739701007660,SIO 50,A01,839691,Cook; Geoffrey W,20,0,22,2
1739701007660,SIO 50,A02,839692,Cook; Geoffrey W,20,0,22,2
1739701008688,SIO 60,A01,839695,Ricke; Katharine L & Lucas; Andrew J.,29,0,34,5
1739701009717,SIO 75,A00,839696,Norris; Richard D.,28,0,30,2
1739701010741,SIO 87,A00,839697,Cook; Geoffrey W,20,0,20,0
1739701010741,SIO 87,B00,839698,Cook; Geoffrey W,20,0,20,0
1739701010741,SIO 87,C00,872480,Feddersen; Falk & Morzfeld; Matthias,15,0,15,0
1739701010741,SIO 87,D00,876215,Jensen; Paul R.,19,0,20,1
1739701011766,SIO 90,A00,839699,Shipp; Lauren Elizabeth,60,0,65,5
1739701012791,SIO 111,A01,839895,Feddersen; Falk,27,0,30,3
1739701013816,SIO 112,A01,839701,Morzfeld; Matthias,38,0,40,2
1739701014841,SIO 113,A01,839703,May; David Alexander,33,0,40,7
1739701015869,SIO 115,A01,872479,Fricker; Helen A.,61,0,65,4
1739701016895,SIO 121,A00,839704,Bowman; Jeff Shovlowsky,25,0,30,5
1739701017921,SIO 135,A01,839706,Fricker; Helen A. & Sandwell; David T,20,0,20,0
1739701017921,SIO 135,A02,872452,Fricker; Helen A. & Sandwell; David T,20,0,20,0
1739701018950,SIO 136,A01,839708,Kacev; David & Shipp; Lauren Elizabeth,29,0,34,5
1739701018950,SIO 136,A02,839709,Kacev; David & Shipp; Lauren Elizabeth,32,0,34,2
1739701019977,SIO 139,A00,839713,Kacev; David,89,0,95,6
1739701021002,SIO 141,A01,839715,Pomeroy; Robert S.,14,0,14,0
1739701022028,SIO 143,A01,839717,Andersson; Andreas Jerry,31,0,35,4
1739701023054,SIO 145,A01,872421,Choy; Carolyn Anela,9,0,18,9
1739701024078,SIO 152,A01,839719,Van Allen; Emily Joyce,17,0,20,3
1739701025156,SIO 153,A01,839722,Capaldi; Tomas,29,0,30,1
1739701026182,SIO 160,A00,839723,Fialko; Yuri A.,26,0,30,4
1739701027207,SIO 173,A00,839724,Xie; Shang-Ping,26,0,30,4
1739701028232,SIO 174,A00,839725,Aluwihare; Lihini & Russell; Lynn M.,26,0,30,4
1739701029258,SIO 176,A00,839726,Merrifield; Sophia T,27,0,30,3
1739701030288,SIO 181,A01,839728,Tresguerres; Martin,20,0,25,5
1739701030288,SIO 181,A02,839729,Tresguerres; Martin,23,0,25,2
1739701030288,SIO 181,A03,839730,Tresguerres; Martin,25,0,25,0
1739701030288,SIO 181,A04,839731,Tresguerres; Martin,23,0,25,2
1739701030288,SIO 181,A05,839732,Tresguerres; Martin,25,0,25,0
1739701030288,SIO 181,A06,839733,Tresguerres; Martin,24,0,25,1
1739701031315,SIO 184,A01,839735,Rouse; Gregory W.,17,0,24,7
1739701031315,SIO 184,A02,839736,Rouse; Gregory W.,20,0,24,4
1739701032342,SIO 190,A01,839738,Lin; Ying-Tsong,18,0,20,2
1739701032342,SIO 190,B01,839740,Kacev; David,26,0,30,4
1739701032342,SIO 190,D01,839742,Gaasterland; Theresa,20,0,20,0
1739701033370,SIO 190L,A00,886144,Staff,28,0,30,2
1739701033370,SIO 190L,A01,886145,Staff,30,0,30,0
1739701034402,SIO 194,A00,851602,Staff,0,0,0,0
1739701035431,SIOB 242C,A01,839746,Gaasterland; Theresa,25,0,25,0
1739701036457,SIOB 243,A00,839748,Gerwick; William Henry,17,0,20,3
1739701037484,SIOB 262,A00,839749,Gerwick; William Henry,25,0,25,0
1739701038513,SIOB 270A,A01,839751,Petrik; Colleen Mary,11,0,15,4
1739701039540,SIOB 278,A00,839752,Jensen; Paul R.,13,0,15,2
1739701039540,SIOB 278,B00,872373,Hechinger; Ryan F.,11,0,15,4
1739701039540,SIOB 278,C00,874430,Allen; Andrew Ellis,14,0,15,1
1739701040565,SIOB 279,A00,871153,Barton; Andrew David,43,0,50,7
1739701041591,SIOB 282,A00,839753,Palenik; Brian,19,0,20,1
1739701042621,SIOB 284,A01,839755,Rouse; Gregory W.,1,0,3,2
1739701042621,SIOB 284,A02,839756,Rouse; Gregory W.,2,0,3,1
1739701043646,SIOB 286,A01,839758,Aburto Oropeza; Marco Octavio,20,0,25,5
1739701044674,SIOB 291,A00,839759,Staff,0,0,0,0
1739701045700,SIOB 297,A00,839760,Allen; Eric,19,0,25,6
1739701046725,SIOC 202B,A00,839761,Stramski; Dariusz & Gabriel; Anne Alice-Agnes,16,0,20,4
1739701047754,SIOC 203C,A01,839763,Young; William Roy,18,0,20,2
1739701048779,SIOC 207C,A00,872521,Vasconcelos; Manuela,5,0,5,0
1739701049803,SIOC 208,A00,839764,Lucas; Andrew J.,45,0,50,5
1739701050832,SIOC 209,A00,872379,Werner; Bradley T.,10,0,10,0
1739701050832,SIOC 209,B00,874420,Watson-Parris; Duncan & Hao; Xuanting,17,0,20,3
1739701051857,SIOC 211B,A00,839779,Feddersen; Falk,5,0,8,3
1739701052882,SIOC 212B,A01,839861,Cessi; Paola,11,0,15,4
1739701053909,SIOC 217C,A00,839862,Lutsko; Nicholas J.,23,0,25,2
1739701054936,SIOC 218A,A00,839863,Send; Uwe,3,0,10,7
1739701055963,SIOC 228,A00,839865,Shi; Yuanyuan,1,0,10,9
1739701056989,SIOC 235,A00,839866,Xie; Shang-Ping,7,0,10,3
1739701058013,SIOC 250,A00,839871,Norris; Joel Roland,20,0,20,0
1739701059038,SIOC 296,A00,871155,Gabriel; Corey John,9,0,20,11
1739701060063,SIOG 200B,A00,839873,Gabriel; Anne Alice-Agnes,19,0,20,1
1739701061088,SIOG 224,A00,839876,Laske; Gabi & Stegman; David,20,0,20,0
1739701062117,SIOG 227C,A00,839879,Fan; Wenyuan & Gabriel; Anne Alice-Agnes,20,0,20,0
1739701063144,SIOG 228,A00,839880,Van Allen; Emily Joyce,14,0,20,6
1739701064170,SIOG 230,A00,839882,Constable; Catherine G,25,0,25,0
1739701065193,SIOG 232,A00,839885,Constable; Steven C & Constable; Catherine G,49,0,50,1
1739701066217,SIOG 236,A01,839890,Fricker; Helen A. & Sandwell; David T,5,0,5,0
1739701066217,SIOG 236,A02,872451,Fricker; Helen A. & Sandwell; David T,5,0,5,0
1739701067244,SIOG 239,A00,839891,Fan; Wenyuan,19,0,20,1
1739701068271,SIOG 268,A00,872652,Martz; Todd R.,9,0,10,1
1739701069296,SOCE 194,A00,851601,Staff,0,0,0,0
1739701070323,SOCG 204,A00,838022,Ng; Kwai,0,0,10,10
1739701071349,SOCG 206,A00,838023,Alvarez; Camila Huerta,6,0,10,4
1739701072377,SOCG 246,A00,838024,Kenworthy; Lane A.,4,0,10,6
1739701073402,SOCG 255B,A00,838025,Gere; Catherina M.,7,0,10,3
1739701074426,SOCG 255C,A00,838026,McKenzie; Kerry V.,7,0,10,3
1739701075450,SOCG 263,A00,838027,Jules-Rosette; Bennetta W.,9,0,10,1
1739701076479,SOCG 278,A00,838030,Watson; Tobias,4,0,10,6
1739701077506,SOCG 280,A00,838031,Fitzgerald; David S,4,0,10,6
1739701078532,SOCG 290,A00,838032,Goldman; Harvey Stern,7,0,10,3
1739701079559,SOCI 2,A01,837726,Payne; Christine Anna,27,0,30,3
1739701079559,SOCI 2,A02,837727,Payne; Christine Anna,30,0,30,0
1739701079559,SOCI 2,A03,837728,Payne; Christine Anna,29,0,30,1
1739701079559,SOCI 2,A04,837729,Payne; Christine Anna,29,0,30,1
1739701079559,SOCI 2,A05,837730,Payne; Christine Anna,30,0,30,0
1739701079559,SOCI 2,A06,837766,Payne; Christine Anna,0,0,0,0
1739701079559,SOCI 2,A07,837769,Payne; Christine Anna,0,0,0,0
1739701079559,SOCI 2,A08,837770,Payne; Christine Anna,0,0,0,0
1739701080589,SOCI 10,A01,869965,Kenworthy; Lane A.,27,0,30,3
1739701080589,SOCI 10,A02,869977,Kenworthy; Lane A.,28,0,30,2
1739701080589,SOCI 10,A03,869985,Kenworthy; Lane A.,30,0,30,0
1739701080589,SOCI 10,A04,869986,Kenworthy; Lane A.,28,0,30,2
1739701081617,SOCI 20,A01,837783,Calderon-Zaks; Michael Aar,35,0,35,0
1739701081617,SOCI 20,A02,837807,Calderon-Zaks; Michael Aar,34,0,35,1
1739701082647,SOCI 60,A01,837816,Sutton; April Marie,28,0,32,4
1739701082647,SOCI 60,A02,837817,Sutton; April Marie,32,0,32,0
1739701082647,SOCI 60,A03,837818,Sutton; April Marie,29,0,32,3
1739701082647,SOCI 60,A04,837819,Sutton; April Marie,31,0,32,1
1739701083675,SOCI 100,A01,837840,Medvetz; Thomas Matthew,29,0,30,1
1739701083675,SOCI 100,A02,837848,Medvetz; Thomas Matthew,30,0,30,0
1739701083675,SOCI 100,A03,837849,Medvetz; Thomas Matthew,30,0,30,0
1739701083675,SOCI 100,A04,837850,Medvetz; Thomas Matthew,28,0,30,2
1739701084700,SOCI 103M,A00,837862,Kilpatrick; Kevin,29,0,30,1
1739701085726,SOCI 104,A00,837863,Arnal; Maud Marie Leonie,28,0,30,2
1739701086754,SOCI 106,A00,837869,Payne; Christine Anna,27,0,30,3
1739701087779,SOCI 109,A00,837870,Kilpatrick; Kevin,29,0,30,1
1739701088806,SOCI 111,A00,837871,Ribas Norris; Janet Vanesa,56,0,56,0
1739701089831,SOCI 111T,A00,837872,Thorpe; Charles Robert,65,0,65,0
1739701090859,SOCI 112,A00,837885,Pitt; Richard Norris,58,0,65,7
1739701091887,SOCI 113,A00,837886,Rogers; Julia Ellen,73,0,75,2
1739701092915,SOCI 115,A00,837889,Sutton; April Marie,63,0,65,2
1739701093941,SOCI 117,A01,851612,Jones; Makeba,9,0,13,4
1739701093941,SOCI 117,A02,851613,Jones; Makeba,13,0,13,0
1739701093941,SOCI 117,A03,851614,Jones; Makeba,12,0,12,0
1739701093941,SOCI 117,A04,851616,Jones; Makeba,12,0,12,0
1739701093941,SOCI 117,B01,870980,Staff,10,0,10,0
1739701093941,SOCI 117,B02,870985,Staff,10,0,10,0
1739701093941,SOCI 117,B03,870987,Staff,10,0,10,0
1739701093941,SOCI 117,B04,871055,Staff,10,0,10,0
1739701094969,SOCI 119,A00,837925,Victoria Torres; Pablo,87,0,90,3
1739701095996,SOCI 125C,A00,872640,Watson; Tobias,55,0,56,1
1739701097022,SOCI 125M,A00,837948,Fitzgerald; David S,45,0,45,0
1739701098047,SOCI 126,A01,851618,Jones; Makeba,18,0,20,2
1739701098047,SOCI 126,A02,837966,Jones; Makeba,20,0,20,0
1739701098047,SOCI 126,A03,837969,Jones; Makeba,20,0,20,0
1739701099071,SOCI 129,A00,837973,Pitt; Richard Norris,72,0,75,3
1739701100099,SOCI 132,A00,837974,Blair-Loy; Mary,74,0,75,1
1739701101124,SOCI 133,A00,837983,Calderon-Zaks; Michael Aar,55,0,56,1
1739701102149,SOCI 134,A00,837989,Rogers; Julia Ellen,45,0,45,0
1739701103192,SOCI 135,A00,838005,Ruiz; Jonathan Joseph,54,0,56,2
1739701104220,SOCI 138,A00,838006,Ruiz; Jonathan Joseph,55,0,56,1
1739701105246,SOCI 139,A00,838007,Ribas Norris; Janet Vanesa,41,0,46,5
1739701106271,SOCI 139A,A00,838008,Estefan; Michel,52,0,56,4
1739701107298,SOCI 140A,A00,838009,Gong; Neil M,66,0,70,4
1739701108323,SOCI 140J,A00,838010,Estefan; Michel,92,0,100,8
1739701109353,SOCI 148,A00,838011,Maron; Asa,34,0,35,1
1739701110381,SOCI 150,A00,838012,Victoria Torres; Pablo,68,0,75,7
1739701111405,SOCI 151,A00,838013,Goldman; Harvey Stern,64,0,65,1
1739701112430,SOCI 156,A00,838014,Ostovany; Khashayar,40,0,40,0
1739701113455,SOCI 157,A00,838015,Crofts; Christine,45,0,56,11
1739701114479,SOCI 158,A00,838016,Ostovany; Khashayar,39,0,40,1
1739701115506,SOCI 160,A00,838017,Medvetz; Thomas Matthew,70,0,70,0
1739701116532,SOCI 161,A00,838018,Arnal; Maud Marie Leonie,49,0,50,1
1739701117558,SOCI 168,A00,838019,Thorpe; Charles Robert,40,0,40,0
1739701118586,SOCI 168E,A00,838021,Crofts; Christine,19,0,35,16
1739701119610,SOCI 174,A00,872915,Shafir; Gershon,28,0,30,2
1739701120635,SOMC 229,A00,867907,Hoang; Mai Phuong,160,0,160,0
1739701121661,SOMC 240,A00,867911,Coyne; Christopher John,160,0,160,0
1739701122691,SOMC 242,A00,867913,Kline; Ahnika Sarah,160,0,160,0
1739701123717,SOMC 244,A00,867940,Evans; Sean Jeffrey,160,0,160,0
1739701124741,SOMC 245C,A01,867952,Noel; Geoffroy Pierre Jean,160,0,160,0
1739701125768,SOMC 246C,A00,867953,Eyler; Lisa T.,160,0,160,0
1739701126796,SOMC 247C,A50,867992,Calcutt; Nigel A,160,0,160,0
1739701127823,SOMC 248C,A00,867993,Joshi; Weena Erin,160,0,160,0
1739701128902,SOMC 249,A00,867994,Bui; Jack D,160,0,160,0
1739701129926,SOMC 250,A00,867997,Reid; Erin G.,160,0,160,0
1739701130951,SOMC 255C,A00,868050,Allison; Matthew,160,0,160,0
1739701131975,SOMI 296,A00,868065,Staff,5,0,5,0
1739701133010,SPPH 161R,A01,864775,Chambers; Christina D,29,0,30,1
1739701133010,SPPH 161R,C01,886226,Chambers; Christina D,20,0,20,0
1739701134039,SPPH 263B,A01,884929,Hook; Vivian Yuan-Ho,98,0,99,1
1739701135066,SPPS 200A,A00,864810,Luli; Alex J,100,0,100,0
1739701136095,SPPS 200B,A00,864827,Luli; Alex J,99,0,99,0
1739701137120,SPPS 200C,A00,864829,Luli; Alex J,99,0,99,0
1739701138147,SPPS 203,A00,864831,Painter; Nathan A.,92,0,99,7
1739701139175,SPPS 205,A01,864838,Bandeira; Nuno Filipe Cabrita,92,0,99,7
1739701140200,SPPS 209,A00,864842,Bounthavong; Mark,93,0,99,6
1739701141227,SPPS 211A,A00,864862,Ferguson; Fleur,92,0,99,7
1739701142252,SPPS 211B,A00,864920,Ferguson; Fleur,96,0,99,3
1739701143280,SPPS 211C,A00,864924,Ferguson; Fleur,93,0,99,6
1739701144306,SPPS 211D,A00,864925,Tsunoda; Shirley M.,99,0,99,0
1739701145332,SPPS 212C,A01,864927,Saunders; Ila Maewal,93,0,99,6
1739701146356,SPPS 213C,A00,864928,Namba; Jennifer Mariko,93,0,99,6
1739701147384,SPPS 218B,A00,864929,Vijapurkar; Ulka,93,0,99,6
1739701148412,SPPS 225,A01,864932,Reed; Chantal,92,0,99,7
1739701149439,SPPS 229,A01,864934,Reid; Erin G.,96,0,99,3
1739701150467,SPPS 237,A00,864935,Mimoto; Mizuho Stacy,96,0,99,3
1739701151493,SPPS 238,A00,864937,Beyhan; Sinem,96,0,99,3
1739701152521,SPPS 239,A01,864942,Bui; Jack D,96,0,99,3
1739701153547,SPPS 241,A01,864944,Tsunoda; Shirley M.,92,0,99,7
1739701154571,SPPS 249,A00,864945,Brandl; Katharina,96,0,99,3
1739701155598,SPPS 250,A00,864946,Tsunoda; Shirley M.,97,0,99,2
1739701156625,SPPS 251,A00,864953,Chen; Timothy,20,0,20,0
1739701157650,SPPS 252,A00,865004,Abdul-Mutakabbir; Jacinda,96,0,99,3
1739701158675,SPPS 253,A00,865006,Tsunoda; Shirley M.,99,0,99,0
1739701159699,SPPS 255,A00,865010,Bounthavong; Mark,98,0,99,1
1739701160724,SPPS 261,A00,865011,Chambers; Christina D,97,0,99,2
1739701161753,SPPS 278,A00,865012,Fricovsky; Eduardo Santiago,98,0,99,1
1739701162780,SPPS 280,A00,865013,Fricovsky; Eduardo Santiago,23,0,23,0
1739701163808,SPPS 281,A00,865014,Gerwick; William Henry,95,0,99,4
1739701164835,SPPS 283,A00,865015,Tsunoda; Shirley M.,98,0,99,1
1739701165860,SURG 296,001,868067,Harris; Jeffrey Paul,4,0,5,1
1739701165860,SURG 296,002,868068,Coffey; Charles Stuart,4,0,5,1
1739701165860,SURG 296,003,868069,Malas; Mahmoud,4,0,5,1
1739701166898,SYN 1,001,836580,Rock; Martin,20,0,20,0
1739701166898,SYN 1,002,836582,Birberick; Brittany Celest,17,0,20,3
1739701166898,SYN 1,003,836583,Meyer; Leslie Rose,20,0,20,0
1739701166898,SYN 1,004,836584,Fish; Gwendolyn Anne,19,0,20,1
1739701166898,SYN 1,005,836585,Fish; Gwendolyn Anne,20,0,20,0
1739701166898,SYN 1,006,836586,Tawater; Hanna Jean,20,0,20,0
1739701166898,SYN 1,007,836590,Fish; Gwendolyn Anne,20,0,20,0
1739701166898,SYN 1,008,836591,Iatarola; Briana Marie,18,0,20,2
1739701166898,SYN 1,009,836592,Browne; Emily,20,0,20,0
1739701166898,SYN 1,010,836594,Staff,20,0,20,0
1739701166898,SYN 1,011,836595,Hom; Kirstyn Courtney,20,0,20,0
1739701166898,SYN 1,012,836599,Hom; Kirstyn Courtney,19,0,20,1
1739701166898,SYN 1,013,836600,Lagapa; Jason,20,0,20,0
1739701166898,SYN 1,014,836603,Deavenport; James Cary,18,0,20,2
1739701166898,SYN 1,015,836606,Girard; Gabrielle,19,0,20,1
1739701166898,SYN 1,016,836607,Deavenport; James Cary,20,0,20,0
1739701166898,SYN 1,017,836622,Girard; Gabrielle,20,0,20,0
1739701166898,SYN 1,018,836653,Atkinson; Arthur Laird,20,0,20,0
1739701166898,SYN 1,019,836656,Girard; Gabrielle,18,0,20,2
1739701166898,SYN 1,020,836658,Atkinson; Arthur Laird,18,0,20,2
1739701166898,SYN 1,021,836659,Staff,20,0,20,0
1739701166898,SYN 1,022,836662,Bishop; Graham,19,0,20,1
1739701166898,SYN 1,023,836663,Bishop; Graham,20,0,20,0
1739701166898,SYN 1,024,836666,Lagapa; Jason,18,0,20,2
1739701166898,SYN 1,025,836723,Lagapa; Jason,20,0,20,0
1739701166898,SYN 1,026,836728,Iatarola; Briana Marie,20,0,20,0
1739701166898,SYN 1,027,836729,Iatarola; Briana Marie,20,0,20,0
1739701166898,SYN 1,028,836730,Difruscio; Mark,20,0,20,0
1739701166898,SYN 1,029,836731,Difruscio; Mark,19,0,20,1
1739701167939,SYN 100,A01,836744,Gladstein; Jill M,12,0,15,3
1739701167939,SYN 100,A02,836745,Gladstein; Jill M,15,0,15,0
1739701167939,SYN 100,B01,836748,Rock; Martin,15,0,15,0
1739701167939,SYN 100,B02,836809,Rock; Martin,14,0,15,1
1739701167939,SYN 100,C01,836812,Browne; Emily,14,0,15,1
1739701167939,SYN 100,C02,836818,Browne; Emily,13,0,15,2
1739701167939,SYN 100,D01,836820,Meyer; Leslie Rose,10,0,15,5
1739701167939,SYN 100,D02,836822,Meyer; Leslie Rose,15,0,15,0
1739701167939,SYN 100,E01,836824,Tawater; Hanna Jean,13,0,15,2
1739701167939,SYN 100,E02,836825,Tawater; Hanna Jean,12,0,15,3
1739701167939,SYN 100,F01,836975,Meyer; Leslie Rose,15,0,15,0
1739701167939,SYN 100,F02,837038,Meyer; Leslie Rose,14,0,15,1
1739701167939,SYN 100,G01,837132,Deavenport; James Cary,13,0,15,2
1739701167939,SYN 100,G02,837133,Deavenport; James Cary,14,0,15,1
1739701167939,SYN 100,H01,837155,Gormally; Brenna,15,0,15,0
1739701167939,SYN 100,H02,872920,Gormally; Brenna,15,0,15,0
1739701167939,SYN 100,I01,837161,Gormally; Brenna,13,0,15,2
1739701167939,SYN 100,I02,837166,Gormally; Brenna,15,0,15,0
1739701167939,SYN 100,J01,837169,Difruscio; Mark,9,0,15,6
1739701167939,SYN 100,J02,837171,Difruscio; Mark,12,0,15,3
1739701167939,SYN 100,K01,837174,Rosenberg; Ryan Glenn,9,0,15,6
1739701167939,SYN 100,K02,837176,Rosenberg; Ryan Glenn,15,0,15,0
1739701167939,SYN 100,L01,837264,Rosenberg; Ryan Glenn,13,0,15,2
1739701167939,SYN 100,L02,837265,Rosenberg; Ryan Glenn,15,0,15,0
1739701167939,SYN 100,M01,837268,Hom; Kirstyn Courtney,12,0,15,3
1739701167939,SYN 100,M02,837269,Hom; Kirstyn Courtney,12,0,15,3
1739701167939,SYN 100,N01,837272,Atkinson; Arthur Laird,14,0,15,1
1739701167939,SYN 100,N02,837275,Atkinson; Arthur Laird,14,0,15,1
1739701167939,SYN 100,O01,837278,Bishop; Graham,13,0,15,2
1739701167939,SYN 100,O02,837284,Bishop; Graham,15,0,15,0
1739701168967,SYN 150,001,837627,Vega; Adrian,20,0,20,0
1739701168967,SYN 150,002,837643,Vega; Adrian,20,0,20,0
1739701169993,TDAC 1,A00,835839,Walsh; Kim C.,19,0,20,1
1739701169993,TDAC 1,B00,835840,Walsh; Kim C.,20,0,20,0
1739701169993,TDAC 1,C00,835841,Walsh; Kim C.,7,0,20,13
1739701169993,TDAC 1,D00,835843,Walsh; Kim C.,19,0,20,1
1739701169993,TDAC 1,E00,835844,Walsh; Kim C.,6,0,20,14
1739701169993,TDAC 1,F00,835845,Walsh; Kim C.,15,0,20,5
1739701171022,TDAC 101,A00,836005,Basso; Beatrice,17,0,20,3
1739701172049,TDAC 102,A00,836006,Harting; Carla Kelso,16,0,20,4
1739701173075,TDAC 105,A00,836007,Barricelli; Marc Alexander,20,0,20,0
1739701174103,TDAC 108,A00,836008,Buescher; Stephen W.,17,0,20,3
1739701174103,TDAC 108,B00,836009,Buescher; Stephen W.,16,0,20,4
1739701174103,TDAC 108,C00,836010,Walsh; Kim C.,20,0,20,0
1739701175129,TDAC 109,A00,836012,Blair; Kyle Adam,20,0,20,0
1739701176160,TDAC 122,A00,836014,Stalling; Vanessa,30,0,30,0
1739701176160,TDAC 122,B00,836015,Perry; Lamar,30,0,30,0
1739701176160,TDAC 122,C00,872388,Celik; Aysan Karagasli,30,0,30,0
1739701176160,TDAC 122,D00,874223,Caban; Andrea Chudnow,30,0,30,0
1739701176160,TDAC 122,E00,874224,Staff,30,0,30,0
1739701177185,TDDE 101,A00,836016,Guirguis; Mark C,20,0,20,0
1739701178213,TDDE 121,A01,836018,Kuhl; Christopher August,16,0,17,1
1739701179240,TDDE 130,A00,836019,Guirguis; Mark C,20,0,20,0
1739701180265,TDDE 131,A00,836020,Petrovich; Victoria A.,19,0,20,1
1739701180265,TDDE 131,B00,872473,Brill; Robert L.,100,0,100,0
1739701181291,TDDE 132,A00,836021,Guirguis; Mark C,20,0,20,0
1739701182331,TDDM 1,A00,835853,Sammartano; Tonnie,40,0,40,0
1739701183359,TDDM 100,A00,836022,Alvarez; Ana Maria,29,0,30,1
1739701184384,TDDR 102,A00,836024,Powell; Lora,19,0,20,1
1739701185409,TDDR 108,A00,836029,Stalling; Vanessa,20,0,20,0
1739701186438,TDDR 111,A00,836039,Castro; Robert Jess,15,0,16,1
1739701186438,TDDR 111,B00,836070,Castro; Robert Jess,16,0,16,0
1739701187464,TDDR 190,A00,836072,Perry; Lamar,35,0,35,0
1739701188490,TDGE 1,A01,835855,Salovey; Todd,19,0,20,1
1739701188490,TDGE 1,A02,835856,Salovey; Todd,20,0,20,0
1739701188490,TDGE 1,A03,835857,Salovey; Todd,19,0,20,1
1739701188490,TDGE 1,A04,835858,Salovey; Todd,20,0,20,0
1739701188490,TDGE 1,A05,835859,Salovey; Todd,19,0,20,1
1739701188490,TDGE 1,A06,835861,Salovey; Todd,17,0,20,3
1739701189515,TDGE 11,A00,835862,Fulton; Julia,224,0,245,21
1739701189515,TDGE 11,B00,835863,Salimi; Rana,158,0,158,0
1739701190540,TDGE 25,A00,835864,Harting; Carla Kelso,15,0,20,5
1739701190540,TDGE 25,B00,835865,Harting; Carla Kelso,14,0,20,6
1739701190540,TDGE 25,C00,835866,Harting; Carla Kelso,19,0,20,1
1739701190540,TDGE 25,D00,835868,Harting; Carla Kelso,16,0,20,4
1739701191568,TDGE 40,A02,835872,Power; Jade Yukana,29,0,30,1
1739701191568,TDGE 40,A03,835873,Power; Jade Yukana,30,0,30,0
1739701192592,TDGE 100,A01,836080,Salovey; Todd,24,0,25,1
1739701192592,TDGE 100,A02,836084,Salovey; Todd,24,0,25,1
1739701193620,TDGE 124,A00,836091,Fulton; Julia,232,0,250,18
1739701194646,TDGE 125,B00,836162,Havis; Allan,215,0,220,5
1739701195672,TDGE 196B,A00,872390,Brown; Bernard Joseph,1,0,1,0
1739701195672,TDGE 196B,B00,872391,Burelle; Julie Sara Veronique,2,0,2,0
1739701195672,TDGE 196B,C00,872392,Celik; Aysan Karagasli,2,0,2,0
1739701195672,TDGE 196B,D00,872394,Havis; Allan,1,0,1,0
1739701195672,TDGE 196B,E00,872396,Mehrishi; Rishika,1,0,1,0
1739701195672,TDGE 196B,F00,872397,Powell; Lora,1,0,1,0
1739701195672,TDGE 196B,G00,872398,Stalling; Vanessa,1,0,1,0
1739701195672,TDGE 196B,H00,872399,Stein; Deborah Isobel,2,0,2,0
1739701196697,TDGR 212,A00,836303,Meyer; Ursula,10,0,10,0
1739701197721,TDGR 219,A00,836305,Portes; Elizabeth Marie,5,0,5,0
1739701198747,TDGR 221B,A00,836306,Caban; Andrea Chudnow,10,0,10,0
1739701199773,TDGR 229,A00,836307,Meyer; Ursula,9,0,9,0
1739701200800,TDGR 233,A00,836308,Staff,9,0,9,0
1739701201824,TDGR 245,A00,836309,Stalling; Vanessa,3,0,3,0
1739701202853,TDGR 250,A00,836311,Staff,5,0,5,0
1739701203883,TDGR 251,A00,836314,Iizuka; Naomi Hisako,5,0,5,0
1739701203883,TDGR 251,B00,836315,Stein; Deborah Isobel,5,0,5,0
1739701204908,TDGR 257B,A00,836388,Stein; Deborah Isobel,7,0,7,0
1739701205932,TDGR 278,A00,836431,Petrovich; Victoria A.,20,0,20,0
1739701206958,TDGR 279,A00,836437,Brill; Robert L.,3,0,3,0
1739701206958,TDGR 279,B00,836440,Petrovich; Victoria A.,3,0,3,0
1739701206958,TDGR 279,C00,836441,McElver; Robert Harrison,3,0,3,0
1739701206958,TDGR 279,D00,836443,Kuhl; Christopher August,3,0,3,0
1739701206958,TDGR 279,E00,836444,Bokovikova; Alina V,3,0,3,0
1739701207985,TDGR 289C,A00,836447,Anderson; Mysia Anyse,10,0,10,0
1739701209013,TDGR 289D,A00,836448,Burelle; Julie Sara Veronique,10,0,10,0
1739701210038,TDGR 292,A00,836449,Anderson; Mysia Anyse,15,0,15,0
1739701211064,TDGR 296,A00,872384,Powell; Lora,10,0,10,0
1739701212090,TDHD 175,A00,836190,Brown; Bernard Joseph,19,0,20,1
1739701213117,TDHT 10,A00,835875,Power; Jade Yukana,24,0,25,1
1739701214142,TDHT 23,A01,835878,Burelle; Julie Sara Veronique,24,0,24,0
1739701214142,TDHT 23,A02,835879,Burelle; Julie Sara Veronique,24,0,24,0
1739701214142,TDHT 23,A03,835880,Burelle; Julie Sara Veronique,22,0,24,2
1739701215168,TDHT 101,A00,836191,Anderson; Mysia Anyse,23,0,25,2
1739701215168,TDHT 101,B00,836193,Staff,24,0,25,1
1739701216196,TDHT 104,A00,836196,Basso; Beatrice,24,0,25,1
1739701217225,TDHT 115,A00,872386,Staff,21,0,25,4
1739701218256,TDMV 1,A00,835881,Caligagan; Maria T.,21,0,30,9
1739701219282,TDMV 2,A00,835882,Weinberg; Sadie,25,0,30,5
1739701220310,TDMV 3,A00,835884,Mack; Kara Shanai',28,0,40,12
1739701221337,TDMV 11,A00,835886,Naves Tannus; Melissa,27,0,30,3
1739701222363,TDMV 20,A00,835890,Smith; Alison D,18,0,20,2
1739701222363,TDMV 20,B00,835920,Brown; Bernard Joseph,40,0,40,0
1739701223390,TDMV 110,A00,836197,Caligagan; Maria T.,29,0,30,1
1739701224418,TDMV 111,A00,836201,Smith; Alison D,26,0,30,4
1739701225446,TDMV 120,A00,836206,Johnston; Holly,30,0,30,0
1739701226473,TDMV 122,A00,836209,Weinberg; Sadie,30,0,30,0
1739701227499,TDMV 123,A00,836214,Johnston; Holly,30,0,30,0
1739701228527,TDMV 130,A00,836216,Mack; Kara Shanai',40,0,40,0
1739701229558,TDMV 138,A00,836222,Jun; Grace Shin Hae,17,0,40,23
1739701230589,TDMV 140,A00,836225,Caligagan; Maria T.,38,0,40,2
1739701230589,TDMV 140,B00,836226,Corrales; Joseph Bernales,39,0,40,1
1739701230589,TDMV 140,C00,836228,Mack; Kara Shanai',30,0,30,0
1739701230589,TDMV 140,D00,836229,Power; Jade Yukana,27,0,30,3
1739701230589,TDMV 140,E00,836232,Lima; Paulo Henrique,30,0,30,0
1739701231618,TDMV 141,A00,836236,Caligagan; Tony,29,0,30,1
1739701232698,TDMV 142,A00,836239,Blanco; Juan Carlos,27,0,30,3
1739701233726,TDMV 143,A00,836288,Fyall; Daunte Edward,29,0,30,1
1739701234753,TDMV 144,A00,836289,Camaya; Michelle Ann,25,0,30,5
1739701234753,TDMV 144,B00,836293,Patnaik; Shibani,30,0,30,0
1739701235780,TDMV 146,A00,836295,Caligagan; Tony,39,0,40,1
1739701236805,TDMV 149,A00,836296,Jun; Grace Shin Hae,38,0,40,2
1739701237828,TDPF 162,A00,836297,Alvarez; Ana Maria,30,0,30,0
1739701238857,TDPR 6,A01,835924,Guirguis; Mark C,50,0,50,0
1739701238857,TDPR 6,A02,835925,Guirguis; Mark C,50,0,50,0
1739701239882,TDPR 102,A00,836298,Guirguis; Mark C,20,0,20,0
1739701240905,TDPR 104,A00,836299,Powell; Lora,15,0,15,0
1739701241931,TDPW 1,A00,835931,Stein; Deborah Isobel,14,0,15,1
1739701241931,TDPW 1,B00,835932,Stein; Deborah Isobel,15,0,15,0
1739701241931,TDPW 1,C00,835934,Stein; Deborah Isobel,15,0,15,0
1739701241931,TDPW 1,D00,835936,Stein; Deborah Isobel,13,0,15,2
1739701241931,TDPW 1,E00,835939,Stein; Deborah Isobel,13,0,15,2
1739701242957,TDPW 102,A00,836300,Iizuka; Naomi Hisako,19,0,20,1
1739701243982,TDTR 10,A00,836002,Wilson; Terry A.,26,0,30,4
1739701245007,TDTR 15,A00,836003,Johnston; Holly,29,0,30,1
1739701246032,TDTR 20,A00,836004,Smith; Alison D,19,0,20,1
1739701247056,TMC 15,A00,836574,Hemans; Patricia Ann Benitez,25,0,27,2
1739701248080,TMC 120,A01,836579,Browne; Errol Tsekani,24,0,25,1
1739701249105,UROL 296,001,868229,Staff,5,0,5,0
1739701249105,UROL 296,002,868230,Staff,5,0,5,0
1739701250135,USP 1,A01,835156,Kwak; Nancy,30,0,30,0
1739701250135,USP 1,A02,835157,Kwak; Nancy,27,0,30,3
1739701250135,USP 1,A03,835158,Kwak; Nancy,29,0,30,1
1739701250135,USP 1,A04,835159,Kwak; Nancy,28,0,30,2
1739701250135,USP 1,A05,835160,Kwak; Nancy,30,0,30,0
1739701250135,USP 1,A06,835161,Kwak; Nancy,30,0,30,0
1739701251161,USP 2,A01,835188,Pezzoli; Keith,34,0,35,1
1739701251161,USP 2,A02,835191,Pezzoli; Keith,33,0,35,2
1739701252186,USP 3,A01,835207,Wickland; Teo Akande,30,0,30,0
1739701252186,USP 3,A02,835290,Wickland; Teo Akande,28,0,30,2
1739701253214,USP 4,A00,835371,Shi; Xiao,24,0,25,1
1739701254241,USP 5,A01,835376,Shenkman; Michael Thomas,30,0,35,5
1739701254241,USP 5,A02,835381,Shenkman; Michael Thomas,34,0,35,1
1739701255269,USP 6,A01,835456,Shvartzberg Carrio; Manuel,35,0,35,0
1739701255269,USP 6,A02,835457,Shvartzberg Carrio; Manuel,35,0,35,0
1739701256298,USP 15,A01,835460,Martin; Isaac,32,0,35,3
1739701256298,USP 15,A02,835461,Martin; Isaac,35,0,35,0
1739701257321,USP 25,A00,835462,Sun; Feiyang,58,0,60,2
1739701258349,USP 60,A01,835468,Wali; Behram,27,0,28,1
1739701259377,USP 100,A00,835469,Moses; Kelema Lee,68,0,70,2
1739701260402,USP 119,A00,835472,Schwaller; Nora Louise,30,0,35,5
1739701261427,USP 124,A00,835475,Hinds; Juli Beth,67,0,70,3
1739701262452,USP 125,A00,835477,Garcia; Guadalupe,22,0,22,0
1739701263477,USP 128B,A01,835530,Lewis; Leslie R,13,0,13,0
1739701264505,USP 131,A00,835537,Wartell; Julie Dara,35,0,65,30
1739701265532,USP 142C,A00,835546,Lerner; Amy M,0,0,0,3
1739701266560,USP 145,A00,835547,Yaghmaee; Saman,142,0,146,4
1739701267588,USP 150,A00,835548,Holmes; Michael Joseph,58,0,60,2
1739701268617,USP 151,A00,835551,Clark; Christopher N,42,0,45,3
1739701269644,USP 152A,A01,835569,Moeder; Nathan L,22,0,22,0
1739701269644,USP 152A,A02,835571,Moeder; Nathan L,21,0,22,1
1739701270673,USP 152B,A00,835581,Moeder; Nathan L,23,0,25,2
1739701271698,USP 153,A00,835641,Shenkman; Michael Thomas,63,0,65,2
1739701272723,USP 158A,A00,835683,Sun; Feiyang,25,0,25,0
1739701273748,USP 159B,A00,835704,Gherini; Paul Pier-Carlo,7,0,8,1
1739701274772,USP 160,A00,835742,Wartell; Julie Dara,25,0,25,0
1739701275800,USP 164,A00,835796,Moses; Kelema Lee,24,0,32,8
1739701276824,USP 165C,A00,835797,Frank; Lawrence Douglas,20,0,20,0
1739701277849,USP 169,A00,835799,Bajaj; Ravi Siddharth,29,0,30,1
1739701278878,USP 170,A00,835800,Entezam; Maryam,61,0,65,4
1739701279904,USP 171,A00,835802,Herzog; Lawrence,65,0,70,5
1739701280932,USP 172,A00,835804,Peerson; Susan,13,0,22,9
1739701281958,USP 175,A00,835805,Velasco; Diego,20,0,22,2
1739701281958,USP 175,B00,835806,Staff,20,0,22,2
1739701282984,USP 177A,A00,835807,Velasco; Diego,21,0,22,1
1739701284008,USP 177B,A00,835814,Peerson; Susan,22,0,25,3
1739701285034,USP 180,A00,835815,Frank; Lawrence Douglas,29,0,30,1
1739701286058,USP 188B,A00,835817,Pezzoli; Keith,30,0,30,0
1739701287083,USP 190,A00,835818,Collins; Caroline Imani,15,0,15,0
1739701288108,USP 191B,A00,835823,Shi; Xiao,18,0,20,2
1739701289135,USP 193,A00,835825,Staff,22,0,22,0
1739701290159,USP 194,A00,835837,Staff,0,0,0,0
1739701291183,USP 198,A00,880741,Moses; Kelema Lee,9999,0,9999,0
1739701292208,USP 265C,A00,835838,Frank; Lawrence Douglas,10,0,10,0
1739701293237,VIS 3,A01,833730,Fayman; Eva,25,0,25,0
1739701293237,VIS 3,A02,833731,Fayman; Eva,22,0,25,3
1739701293237,VIS 3,A03,833806,Fayman; Eva,24,0,25,1
1739701293237,VIS 3,A04,833888,Fayman; Eva,25,0,25,0
1739701293237,VIS 3,A05,833889,Fayman; Eva,25,0,25,0
1739701293237,VIS 3,A06,833890,Fayman; Eva,22,0,25,3
1739701293237,VIS 3,A07,833891,Fayman; Eva,24,0,25,1
1739701293237,VIS 3,A08,833892,Fayman; Eva,23,0,25,2
1739701293237,VIS 3,A09,833893,Fayman; Eva,25,0,25,0
1739701293237,VIS 3,A10,833894,Fayman; Eva,24,0,25,1
1739701293237,VIS 3,A11,833895,Fayman; Eva,25,0,25,0
1739701293237,VIS 3,A12,833896,Fayman; Eva,22,0,25,3
1739701294261,VIS 9,A00,833897,Sprague; Sean Jeffrey,213,0,250,37
1739701295286,VIS 10,A00,833898,Stone; Patricia,238,0,250,12
1739701296316,VIS 21A,A01,833900,Newsome; Elizabeth Ann,32,0,32,0
1739701296316,VIS 21A,A02,833901,Newsome; Elizabeth Ann,31,0,32,1
1739701296316,VIS 21A,A03,833902,Newsome; Elizabeth Ann,32,0,32,0
1739701296316,VIS 21A,A04,833903,Newsome; Elizabeth Ann,31,0,32,1
1739701296316,VIS 21A,A05,833904,Newsome; Elizabeth Ann,32,0,32,0
1739701296316,VIS 21A,A06,833905,Newsome; Elizabeth Ann,32,0,32,0
1739701297345,VIS 22,A01,833907,Williams; Alena J,32,0,32,0
1739701297345,VIS 22,A02,833908,Williams; Alena J,32,0,32,0
1739701297345,VIS 22,A03,833909,Williams; Alena J,30,0,32,2
1739701297345,VIS 22,A04,833910,Williams; Alena J,31,0,32,1
1739701297345,VIS 22,A05,833911,Williams; Alena J,31,0,32,1
1739701297345,VIS 22,A06,833912,Williams; Alena J,32,0,32,0
1739701297345,VIS 22,A07,833913,Williams; Alena J,32,0,32,0
1739701297345,VIS 22,A08,833914,Williams; Alena J,32,0,32,0
1739701297345,VIS 22,A09,833915,Williams; Alena J,32,0,32,0
1739701297345,VIS 22,A10,833916,Williams; Alena J,32,0,32,0
1739701297345,VIS 22,A11,833917,Williams; Alena J,31,0,32,1
1739701297345,VIS 22,A12,833918,Williams; Alena J,32,0,32,0
1739701298370,VIS 31,A00,833919,Dominguez; Ricardo,308,0,320,12
1739701299394,VIS 32,A01,833921,Yoldas; Pinar,31,0,32,1
1739701299394,VIS 32,A02,833922,Yoldas; Pinar,31,0,32,1
1739701300422,VIS 41,A01,833924,D'Elena-Tweed; Jessica Erin,25,0,25,0
1739701300422,VIS 41,A02,833925,D'Elena-Tweed; Jessica Erin,20,0,25,5
1739701300422,VIS 41,A03,833926,D'Elena-Tweed; Jessica Erin,25,0,25,0
1739701300422,VIS 41,A04,833927,D'Elena-Tweed; Jessica Erin,22,0,25,3
1739701300422,VIS 41,A05,833928,D'Elena-Tweed; Jessica Erin,25,0,25,0
1739701300422,VIS 41,A06,833929,D'Elena-Tweed; Jessica Erin,25,0,25,0
1739701301447,VIS 70N,A01,833931,Garnett; Mariah J,22,0,22,0
1739701301447,VIS 70N,A02,833932,Garnett; Mariah J,21,0,22,1
1739701301447,VIS 70N,A03,833972,Garnett; Mariah J,22,0,22,0
1739701301447,VIS 70N,A04,833974,Garnett; Mariah J,20,0,22,2
1739701301447,VIS 70N,A05,834047,Garnett; Mariah J,22,0,22,0
1739701301447,VIS 70N,A06,834048,Garnett; Mariah J,22,0,22,0
1739701302471,VIS 85A,A01,834098,Balboni; Francesca Jean,32,0,34,2
1739701302471,VIS 85A,A02,834099,Balboni; Francesca Jean,33,0,34,1
1739701303498,VIS 87,A00,872413,Mullin; Jennifer S & Twomey; Robert Daniel,10,0,10,0
1739701304524,VIS 100A,A00,834100,Cruz; Edwin Teddy,7,0,15,8
1739701305549,VIS 102,A00,834103,Cruz; Edwin Teddy,140,0,146,6
1739701306575,VIS 105A,A00,834105,Adler; Amy,29,0,30,1
1739701307603,VIS 105B,A00,834106,Tonies; Joshua Vanjaymes,26,0,30,4
1739701308627,VIS 105C,A00,834107,Herc-Balaszek; Malgorzata,14,0,15,1
1739701309655,VIS 106A,A00,834184,Staff,25,0,25,0
1739701309655,VIS 106A,B00,834185,Chew Ii; Troy Lamarr,24,0,25,1
1739701310684,VIS 106B,A00,834191,Ortiz-Torres; Ruben,24,0,25,1
1739701311710,VIS 106C,A00,834192,Staff,12,0,15,3
1739701312736,VIS 107A,A00,834193,Staff,21,0,25,4
1739701313760,VIS 107B,A00,834194,Pylypchuk; Jonathan,22,0,25,3
1739701314786,VIS 110A,A00,834217,Dinco; Dino,14,0,15,1
1739701315811,VIS 110B,A00,834218,Iglesias; Janelle Ann,13,0,15,2
1739701316836,VIS 110D,A00,834220,Tonies; Joshua Vanjaymes,14,0,15,1
1739701317860,VIS 110F,A00,834224,Fayman; Eva,15,0,15,0
1739701318888,VIS 110N,A00,834226,Adler; Amy,15,0,15,0
1739701319915,VIS 113BN,A00,834227,Staff,14,0,15,1
1739701320942,VIS 117E,A00,834229,Newsome; Elizabeth Ann,11,0,15,4
1739701321968,VIS 121AN,A00,834231,Tronzo; William,72,0,75,3
1739701322995,VIS 124E,A00,834312,Rose; Jordan M,70,0,75,5
1739701324023,VIS 127B,A00,834313,Shen; Kuiyi,146,0,146,0
1739701325051,VIS 128A,A00,834314,Tronzo; William,73,0,75,2
1739701326080,VIS 133,A01,834317,Cantrell; Joe Leo,33,0,34,1
1739701326080,VIS 133,A02,834318,Cantrell; Joe Leo,34,0,34,0
1739701327104,VIS 133A,A00,834409,Chevalier; Clarissa Maria,15,0,15,0
1739701328130,VIS 134,A00,834422,Staff,70,0,75,5
1739701329156,VIS 141B,A00,834423,Stalbaum; Brett,13,0,15,2
1739701330181,VIS 145B,A00,834455,Akten; Mehmet,13,0,15,2
1739701330181,VIS 145B,B00,834467,Alexander; Amy J,14,0,15,1
1739701331205,VIS 146A,A00,834482,Paden; Jonathon Dean,18,0,22,4
1739701332230,VIS 147A,A01,834484,Stalbaum; Brett,20,0,22,2
1739701332230,VIS 147A,A02,834485,Stalbaum; Brett,22,0,22,0
1739701332230,VIS 147A,A03,834493,Stalbaum; Brett,21,0,22,1
1739701332230,VIS 147A,A04,834494,Stalbaum; Brett,20,0,22,2
1739701333255,VIS 147B,A00,834495,Paden; Jonathon Dean,15,0,15,0
1739701334282,VIS 149,A00,834496,Yoldas; Pinar,12,0,15,3
1739701335306,VIS 150A,A00,834506,Staff,11,0,15,4
1739701336385,VIS 152D,A01,834679,Wardwell; Mariana Razo,33,0,34,1
1739701336385,VIS 152D,A02,834754,Wardwell; Mariana Razo,34,0,34,0
1739701336385,VIS 152D,A03,834757,Wardwell; Mariana Razo,32,0,34,2
1739701336385,VIS 152D,A04,834760,Wardwell; Mariana Razo,33,0,34,1
1739701337414,VIS 159,A01,834850,Cartwright; Lisa,34,0,34,0
1739701337414,VIS 159,A02,834851,Cartwright; Lisa,30,0,34,4
1739701337414,VIS 159,A03,834852,Cartwright; Lisa,32,0,34,2
1739701337414,VIS 159,A04,834853,Cartwright; Lisa,34,0,34,0
1739701337414,VIS 159,A05,834855,Cartwright; Lisa,31,0,34,3
1739701337414,VIS 159,A06,834857,Cartwright; Lisa,34,0,34,0
1739701338439,VIS 160A,A00,871872,Paden; Jonathon Dean,15,0,15,0
1739701339464,VIS 160B,A00,834858,Akten; Mehmet,8,0,15,7
1739701339464,VIS 160B,B00,834860,Twomey; Robert Daniel,12,0,15,3
1739701339464,VIS 160B,C00,834861,Alexander; Amy J,13,0,15,2
1739701340492,VIS 164,A00,834867,Sprague; Sean Jeffrey,21,0,22,1
1739701340492,VIS 164,B00,834868,Zurita; Dmitri,22,0,22,0
1739701341518,VIS 167,A00,835011,Staff,22,0,22,0
1739701342546,VIS 168,A00,835015,Zurita; Dmitri,21,0,22,1
1739701343571,VIS 169A,A00,881456,Cross; Brian R,21,0,22,1
1739701344598,VIS 171,A00,835016,Cross; Brian R,20,0,22,2
1739701345624,VIS 172,A00,835090,Trigilio; Michael,20,0,22,2
1739701346649,VIS 174,A00,835102,Stone; Patricia,18,0,22,4
1739701346649,VIS 174,B00,835113,Zurita; Dmitri,21,0,22,1
1739701347677,VIS 177,A00,835114,Crandall; Jordan,22,0,22,0
1739701348704,VIS 179,A00,835118,Segade; Alexandro Abraham,22,0,22,0
1739701349730,VIS 180A,A00,835120,Dinco; Dino,22,0,22,0
1739701350758,VIS 180B,A00,835121,Miller; Nicole L,21,0,22,1
1739701351784,VIS 182,A00,835141,Dinco; Dino,17,0,22,5
1739701352812,VIS 185,A00,835142,Miller; Nicole L,22,0,22,0
1739701353840,VIS 190,A00,835143,Dominguez; Ricardo,15,0,15,0
1739701353840,VIS 190,B00,835144,D'Elena-Tweed; Jessica Erin,13,0,15,2
1739701353840,VIS 190,C00,835146,Yoldas; Pinar,15,0,15,0
1739701354864,VIS 202,A00,835148,Garnett; Mariah J,12,0,15,3
1739701355894,VIS 203,A00,835149,Iglesias; Janelle Ann,9,0,15,6
1739701356922,VIS 206,A00,835150,Kester; Grant,9,0,15,6
1739701357949,VIS 208,A00,835151,Moss; Ceci,15,0,15,0
1739701358975,VIS 211,A00,871767,Dean; Danielle Adobi,4,0,15,11
1739701360003,VIS 220,A00,835152,Williams; Alena J,11,0,15,4
1739701361031,VIS 258,A00,835153,Shen; Kuiyi,11,0,15,4
1739701362059,WCWP 10A,001,833211,Dhir; Simrita,20,0,20,0
1739701362059,WCWP 10A,002,833218,Dhir; Simrita,19,0,20,1
1739701362059,WCWP 10A,003,833221,Staff,0,0,0,0
1739701362059,WCWP 10A,006,833232,Susi; Natalie,0,0,0,0
1739701362059,WCWP 10A,011,833250,Staff,0,0,0,0
1739701362059,WCWP 10A,012,833255,Windham; Emily,18,0,20,2
1739701362059,WCWP 10A,013,833258,Windham; Emily,14,0,20,6
1739701362059,WCWP 10A,014,833259,Holloway Ii; Mathew,19,0,20,1
1739701362059,WCWP 10A,015,833261,Windham; Emily,17,0,20,3
1739701362059,WCWP 10A,016,833262,Holloway Ii; Mathew,20,0,20,0
1739701362059,WCWP 10A,017,833263,Holloway Ii; Mathew,20,0,20,0
1739701362059,WCWP 10A,018,872017,Escobar; Jordan Christophe,20,0,20,0
1739701362059,WCWP 10A,019,872087,Escobar; Jordan Christophe,19,0,20,1
1739701362059,WCWP 10A,020,872122,Escobar; Jordan Christophe,19,0,20,1
1739701362059,WCWP 10A,021,872361,Martiniuk; Jill,20,0,20,0
1739701362059,WCWP 10A,022,872362,Martiniuk; Jill,20,0,20,0
1739701362059,WCWP 10A,023,872364,Martiniuk; Jill,20,0,20,0
1739701362059,WCWP 10A,024,872365,Welji; Haleema Nazir,0,0,0,0
1739701363090,WCWP 10B,003,833318,Merryman; Walter,20,0,20,0
1739701363090,WCWP 10B,005,833340,Merryman; Walter,19,0,20,1
1739701363090,WCWP 10B,006,833342,Merryman; Walter,18,0,20,2
1739701363090,WCWP 10B,007,833358,Staff,0,0,0,0
1739701363090,WCWP 10B,008,833359,Ornelas; Tricia,18,0,20,2
1739701363090,WCWP 10B,009,833364,Ornelas; Tricia,16,0,20,4
1739701363090,WCWP 10B,010,833371,Uriarte; Emma,9,0,20,11
1739701363090,WCWP 10B,011,833378,Gagnon; Jeffrey C,0,0,0,0
1739701363090,WCWP 10B,012,833395,Uriarte; Emma,17,0,20,3
1739701363090,WCWP 10B,013,833397,Uriarte; Emma,13,0,20,7
1739701363090,WCWP 10B,014,833398,Staff,0,0,0,0
1739701363090,WCWP 10B,019,833421,Staff,0,0,0,0
1739701363090,WCWP 10B,020,833422,Staff,0,0,0,0
1739701363090,WCWP 10B,021,833423,Staff,0,0,0,0
1739701363090,WCWP 10B,022,833455,Gagnon; Jeffrey C,15,0,16,1
1739701363090,WCWP 10B,023,833489,Gagnon; Jeffrey C,14,0,16,2
1739701363090,WCWP 10B,024,833614,Staff,0,0,0,0
1739701363090,WCWP 10B,025,833615,Gagnon; Jeffrey C,15,0,16,1
1739701363090,WCWP 10B,026,833635,Gagnon; Jeffrey C,16,0,16,0
1739701363090,WCWP 10B,027,833667,Staff,0,0,0,0
1739701363090,WCWP 10B,028,874686,Gagnon; Jeffrey C,14,0,16,2
1739701363090,WCWP 10B,029,874687,Gagnon; Jeffrey C,15,0,16,1
1739701364120,WCWP 100,A00,833668,McCleary; Keith Long,20,0,20,0
1739701364120,WCWP 100,B00,833669,McCleary; Keith Long,19,0,20,1
1739701364120,WCWP 100,C00,833673,Twohig; Niall Ivan,19,0,20,1
1739701364120,WCWP 100,D00,833677,Twohig; Niall Ivan,19,0,20,1
1739701364120,WCWP 100,E00,833678,Young; Mark T,18,0,20,2
1739701364120,WCWP 100,F00,833679,Young; Mark T,19,0,20,1
1739701365148,WES 207,A00,833201,Staff,20,0,20,0
1739701366174,WES 265,A00,833205,Staff,20,0,20,0
1739701368342,AAS 10R,A01,807278,Butler; Elizabeth Annette,28,0,34,6
1739701368342,AAS 10R,A02,807279,Butler; Elizabeth Annette,30,0,34,4
1739701369372,AAS 170R,A00,807281,Butler; Elizabeth Annette,26,0,28,2
1739701370398,AESE 261,A00,804942,Staff,30,0,30,0
1739701371423,AESE 278D,A00,804945,Staff,30,0,30,0
1739701372449,AESE 278E,A00,804981,Staff,30,0,30,0
1739701373476,AESE 279A,A00,804985,Staff,30,0,30,0
1739701374502,ANAR 100,A00,872378,Dunseth; Zachary Clark,19,0,20,1
1739701375532,ANAR 104,A01,803045,Shtienberg; Gilad,24,0,25,1
1739701375532,ANAR 104,A02,803066,Shtienberg; Gilad,0,0,0,0
1739701376559,ANAR 111,A00,803067,Dunseth; Zachary Clark,25,0,25,0
1739701377585,ANAR 138,A00,803079,Algaze; Guillermo,12,0,15,3
1739701378610,ANAR 155,A00,803081,Braswell; Geoffrey E.,19,0,25,6
1739701379638,ANBI 111,A00,803085,Staff,22,0,25,3
1739701380663,ANBI 116,A00,803087,Wilder; Linnea Lorene,149,0,150,1
1739701381688,ANBI 139,A00,870761,Gagneux; Pascal,138,0,145,7
1739701382715,ANBI 144,A00,803091,Wilder; Linnea Lorene,70,0,75,5
1739701383740,ANBI 149,A00,803093,Non; Amy L,20,0,20,0
1739701384764,ANBI 174,A00,803096,Strum; Shirley C.,15,0,15,0
1739701385787,ANES 296,001,866120,Suresh; Preetham John,4,0,5,1
1739701385787,ANES 296,002,866141,Staff,5,0,5,0
1739701385787,ANES 296,003,866168,Staff,5,0,5,0
1739701386815,ANSC 100,A00,803098,Bialecki; Jon Anthony,23,0,25,2
1739701386815,ANSC 100,B00,871150,Rabinowitz; Dan,20,0,20,0
1739701387844,ANSC 101,A00,803099,Sloane; Julia Kathryn,35,0,40,5
1739701388869,ANSC 117,A00,803100,Martin Sandino; Amanda Maria Yoland,16,0,18,2
1739701389894,ANSC 134,A00,803104,Petterson; John C.,25,0,25,0
1739701390919,ANSC 137,A00,803105,Stewart; Alexander B,39,0,40,1
1739701391943,ANSC 147,A00,803106,Stewart; Alexander B,36,0,40,4
1739701392968,ANSC 148,A00,803110,Schonberg; Jeffrey,45,0,46,1
1739701393994,ANSC 173,A00,803119,Brenner; Suzanne A,10,0,12,2
1739701395022,ANSC 180,A00,803121,Hankins; Joseph D.,22,0,25,3
1739701396047,ANSC 191,A00,803124,Yeh; Rihan Wen Xin,11,0,12,1
1739701397073,ANTH 2,A01,803000,Marchetto; Maria Carolina,32,0,33,1
1739701397073,ANTH 2,A02,803001,Marchetto; Maria Carolina,32,0,33,1
1739701397073,ANTH 2,A03,803005,Marchetto; Maria Carolina,30,0,33,3
1739701397073,ANTH 2,A04,803006,Marchetto; Maria Carolina,30,0,33,3
1739701397073,ANTH 2,A05,803007,Marchetto; Maria Carolina,33,0,33,0
1739701397073,ANTH 2,A06,803008,Marchetto; Maria Carolina,31,0,31,0
1739701398101,ANTH 3,A01,803012,Algaze; Guillermo,30,0,30,0
1739701398101,ANTH 3,A02,803013,Algaze; Guillermo,30,0,30,0
1739701398101,ANTH 3,A03,803015,Algaze; Guillermo,30,0,30,0
1739701398101,ANTH 3,A04,803016,Algaze; Guillermo,30,0,30,0
1739701399131,ANTH 4,A01,803020,Yeh; Rihan Wen Xin,27,0,30,3
1739701399131,ANTH 4,A02,803021,Yeh; Rihan Wen Xin,30,0,30,0
1739701399131,ANTH 4,A03,803022,Yeh; Rihan Wen Xin,30,0,30,0
1739701399131,ANTH 4,A04,803024,Yeh; Rihan Wen Xin,30,0,30,0
1739701400159,ANTH 10,A00,803025,Stewart; Alexander B,73,0,80,7
1739701401187,ANTH 21,A01,803027,Stone; Annika Britt,38,0,40,2
1739701401187,ANTH 21,A02,803030,Stone; Annika Britt,36,0,40,4
1739701401187,ANTH 21,A03,803031,Stone; Annika Britt,39,0,40,1
1739701401187,ANTH 21,A04,803032,Stone; Annika Britt,39,0,40,1
1739701402217,ANTH 23,A01,803034,Stone; Annika Britt,39,0,40,1
1739701402217,ANTH 23,A02,803036,Stone; Annika Britt,39,0,40,1
1739701402217,ANTH 23,A03,803037,Stone; Annika Britt,40,0,40,0
1739701402217,ANTH 23,A04,803038,Stone; Annika Britt,40,0,40,0
1739701403241,ANTH 87,A00,875928,Staff,20,0,20,0
1739701404265,ANTH 103,A00,803126,Hankins; Joseph D.,98,0,100,2
1739701405292,ANTH 105,A00,803130,Rabinowitz; Dan,73,0,75,2
1739701406316,ANTH 109,A00,803133,Staff,38,0,40,2
1739701407343,ANTH 110,A00,803135,Staff,15,0,20,5
1739701408367,ANTH 128B,A01,803139,Lewis; Leslie R,12,0,12,0
1739701409394,ANTH 196C,A00,803147,Varma; Saiba,20,0,20,0
1739701410421,ANTH 198,001,886925,Varma; Saiba,15,0,15,0
1739701411449,ANTH 200,A00,803150,Pedersen; David,15,0,15,0
1739701412474,ANTH 230,A00,889211,Gagneux; Pascal,17,0,20,3
1739701413499,ANTH 272,A00,803155,Gere; Catherina M.,9,0,10,1
1739701414523,ANTH 273,A00,803158,McKenzie; Kerry V.,10,0,10,0
1739701415548,ANTH 288,A00,803189,Braswell; Geoffrey E.,25,0,25,0
1739701416591,ANTH 295,001,887807,Algaze; Guillermo,3,0,3,0
1739701416591,ANTH 295,002,887809,Braswell; Geoffrey E.,3,0,3,0
1739701416591,ANTH 295,003,887890,Brenner; Suzanne A,3,0,3,0
1739701416591,ANTH 295,004,887891,Csordas; Thomas J.,3,0,3,0
1739701416591,ANTH 295,005,887909,Fox; Patrick Keolu Ozer,3,0,3,0
1739701416591,ANTH 295,006,887940,Gagneux; Pascal,3,0,3,0
1739701416591,ANTH 295,007,887941,Goldstein; Paul S,3,0,3,0
1739701416591,ANTH 295,008,887942,Hankins; Joseph D.,3,0,3,0
1739701416591,ANTH 295,009,887948,Jassal; Aftab,3,0,3,0
1739701416591,ANTH 295,010,887949,Jenkins; Janis A.,3,0,3,0
1739701416591,ANTH 295,011,887950,Jimenez Cano; Nayeli Guada,3,0,3,0
1739701416591,ANTH 295,012,887951,Kaiser; Bronwyn Nicole,3,0,3,0
1739701416591,ANTH 295,013,887955,Kang; Byung Chu,3,0,3,0
1739701416591,ANTH 295,014,887957,Marchetto; Maria Carolina,3,0,3,0
1739701416591,ANTH 295,015,887960,Non; Amy L,3,0,3,0
1739701416591,ANTH 295,016,887961,Pedersen; David,3,0,3,0
1739701416591,ANTH 295,017,887962,Rivera-Collazo; Isabel C,3,0,3,0
1739701416591,ANTH 295,018,887963,Varma; Saiba,3,0,3,0
1739701416591,ANTH 295,019,887969,Yeh; Rihan Wen Xin,3,0,3,0
1739701417622,ANTH 296,001,888015,Braswell; Geoffrey E.,3,0,3,0
1739701417622,ANTH 296,002,888024,Marchetto; Maria Carolina,3,0,3,0
1739701417622,ANTH 296,003,888035,Rivera-Collazo; Isabel C,3,0,3,0
1739701417622,ANTH 296,004,888050,Varma; Saiba,3,0,3,0
1739701417622,ANTH 296,005,888055,Algaze; Guillermo,3,0,3,0
1739701417622,ANTH 296,006,888067,Brenner; Suzanne A,3,0,3,0
1739701417622,ANTH 296,007,888075,Csordas; Thomas J.,3,0,3,0
1739701417622,ANTH 296,008,888081,Fox; Patrick Keolu Ozer,3,0,3,0
1739701417622,ANTH 296,009,888084,Gagneux; Pascal,3,0,3,0
1739701417622,ANTH 296,010,888086,Goldstein; Paul S,2,0,3,1
1739701417622,ANTH 296,011,888089,Hankins; Joseph D.,3,0,3,0
1739701417622,ANTH 296,012,888093,Jassal; Aftab,3,0,3,0
1739701417622,ANTH 296,013,888095,Jenkins; Janis A.,3,0,3,0
1739701417622,ANTH 296,014,888099,Jimenez Cano; Nayeli Guada,3,0,3,0
1739701417622,ANTH 296,015,888101,Kaiser; Bronwyn Nicole,3,0,3,0
1739701417622,ANTH 296,016,888102,Kang; Byung Chu,3,0,3,0
1739701417622,ANTH 296,017,888106,Levy; Thomas E,3,0,3,0
1739701417622,ANTH 296,018,888109,Non; Amy L,3,0,3,0
1739701417622,ANTH 296,019,888111,Pedersen; David,3,0,3,0
1739701417622,ANTH 296,020,888112,Postero; Nancy Grey,3,0,3,0
1739701417622,ANTH 296,021,888116,Semendeferi; Ekaterini,3,0,3,0
1739701417622,ANTH 296,022,888118,Yeh; Rihan Wen Xin,3,0,3,0
1739701418647,ASTR 2,A01,803214,Nadler; Ethan Oliver,296,0,300,4
1739701419673,ASTR 15,A01,803221,Wright; Shelley Adams,47,0,50,3
1739701420698,ASTR 18,A01,803234,Arnold; Kam S,30,0,30,0
1739701421722,ASTR 60,A01,803300,Burgasser; Adam Jonathan,14,0,15,1
1739701421722,ASTR 60,A02,803301,Burgasser; Adam Jonathan,15,0,15,0
1739701421722,ASTR 60,A03,803302,Burgasser; Adam Jonathan,15,0,15,0
1739701421722,ASTR 60,A04,803303,Burgasser; Adam Jonathan,15,0,15,0
1739701422746,ASTR 87,A00,871154,Burgasser; Adam Jonathan,20,0,20,0
1739701423770,ASTR 103,A01,803305,Diamond; Patrick H,30,0,30,0
1739701424799,ASTR 106,A01,803307,Boggs; Steven Edward,30,0,30,0
1739701425824,ASTR 123,A01,803343,Keres; Dusan,35,0,39,4
1739701426849,ASTR 154,A01,803345,Hosseinzadeh; Griffin Alex,40,0,40,0
1739701427873,ASTR 211,A00,803346,Broekgaarden; Floor Suzan,12,0,15,3
1739701428899,ASTR 250,A00,803347,Theissen; Christopher Alexander & Hosseinzadeh; Griffin Alex,26,0,30,4
1739701429924,ASTR 251,A00,803359,Theissen; Christopher Alexander & Hosseinzadeh; Griffin Alex,28,0,30,2
1739701430949,AUD 236,A00,804989,Harris; Jeffrey Paul,5,0,5,0
1739701431974,AUD 260,A01,804994,Zettner; Erika,13,0,13,0
1739701433002,AUD 272,A00,804997,Zettner; Erika,13,0,13,0
1739701434029,AUD 275,A00,805001,Zettner; Erika,13,0,13,0
1739701435054,AUD 284,A00,805004,Zettner; Erika,13,0,13,0
1739701436079,AUD 291,A00,805008,Zettner; Erika,13,0,13,0
1739701437104,AUD 296,A00,805013,Zettner; Erika,6,0,6,0
1739701438132,AWP 3,001,802590,O'Neil; Courtney L,9,0,9,0
1739701438132,AWP 3,002,802591,O'Neil; Courtney L,9,0,9,0
1739701438132,AWP 3,003,802592,Kolodezh; Samuel,8,0,9,1
1739701438132,AWP 3,004,802593,Zimmerman; Guy,9,0,9,0
1739701438132,AWP 3,005,802594,Vaughn; Kelsey Sara,9,0,9,0
1739701438132,AWP 3,006,802595,Vaughn; Kelsey Sara,9,0,9,0
1739701438132,AWP 3,007,802597,Given; William Allan,9,0,9,0
1739701439158,AWP 4A,A00,802601,Ajo; Frances Margaret,10,0,10,0
1739701439158,AWP 4A,B00,802602,Ajo; Frances Margaret,9,0,10,1
1739701439158,AWP 4A,C00,880738,Bauer; Holly Jean,10,0,10,0
1739701440251,AWP 4B,001,802603,Steinberg; Stacy A,0,0,0,0
1739701440251,AWP 4B,002,802604,Steinberg; Stacy A,0,0,0,2
1739701440251,AWP 4B,003,802605,Gilmore; Lauren Monica,0,0,0,1
1739701440251,AWP 4B,004,802606,Gilmore; Lauren Monica,0,0,0,0
1739701440251,AWP 4B,007,802609,Bolin; Jillian,0,0,0,0
1739701440251,AWP 4B,008,802610,Bolin; Jillian,0,0,0,0
1739701440251,AWP 4B,009,802611,Zroka; Amy Liane,0,0,0,0
1739701440251,AWP 4B,010,802612,Zroka; Amy Liane,0,0,0,0
1739701440251,AWP 4B,011,802614,Christie; Veronica Ann,0,0,0,0
1739701440251,AWP 4B,012,802672,Christie; Veronica Ann,0,0,0,0
1739701440251,AWP 4B,013,802673,Jones; William Jadie,0,0,0,0
1739701440251,AWP 4B,014,802676,Jones; William Jadie,0,0,0,1
1739701440251,AWP 4B,015,802677,Heiser; Jerrod A,0,0,0,0
1739701440251,AWP 4B,016,802679,Heiser; Jerrod A,0,0,0,1
1739701440251,AWP 4B,017,802683,Bourdeau; Joseph Albert,0,0,0,0
1739701440251,AWP 4B,018,802684,Bourdeau; Joseph Albert,0,0,0,1
1739701440251,AWP 4B,019,802690,Wilson; Natalie Ann,0,0,0,0
1739701440251,AWP 4B,020,802691,Wilson; Natalie Ann,0,0,0,0
1739701440251,AWP 4B,021,802692,Stanton; Jennifer K,0,0,0,0
1739701440251,AWP 4B,022,802693,Stanton; Jennifer K,0,0,0,1
1739701440251,AWP 4B,023,802696,Riggle; Amanda L,0,0,0,1
1739701440251,AWP 4B,024,802699,Riggle; Amanda L,0,0,0,0
1739701440251,AWP 4B,025,802702,Homenick; Erik Christopher,0,0,0,0
1739701440251,AWP 4B,026,802703,Homenick; Erik Christopher,0,0,0,0
1739701440251,AWP 4B,027,802705,Ornelas Jr.; David Paul,0,0,0,0
1739701440251,AWP 4B,028,802706,Grant; Melinda G,0,0,0,0
1739701440251,AWP 4B,029,802707,Grant; Melinda G,0,0,0,0
1739701440251,AWP 4B,030,802708,Ornelas Jr.; David Paul,0,0,0,0
1739701440251,AWP 4B,031,802709,Falcon; Jennifer A,0,0,0,0
1739701440251,AWP 4B,032,802710,Falcon; Jennifer A,0,0,0,0
1739701440251,AWP 4B,033,802711,Westerfeld; Kevin John,0,0,0,0
1739701440251,AWP 4B,034,802712,Tiernan; Christa Michelle,0,0,0,0
1739701440251,AWP 4B,035,802714,Tiernan; Christa Michelle,0,0,0,0
1739701440251,AWP 4B,036,802980,Westerfeld; Kevin John,0,0,0,0
1739701440251,AWP 4B,038,802982,Gardella; Alexander Drew,0,0,0,0
1739701440251,AWP 4B,039,802983,Gardella; Alexander Drew,0,0,0,0
1739701440251,AWP 4B,040,802985,Coulter; Jane Elisabeth,0,0,0,0
1739701440251,AWP 4B,041,802986,Spicer; Jacqueline,0,0,0,0
1739701440251,AWP 4B,042,802987,Spicer; Jacqueline,0,0,0,0
1739701440251,AWP 4B,043,802989,Tsurska Svetina; Olena,0,0,0,0
1739701440251,AWP 4B,044,802990,Tsurska Svetina; Olena,0,0,0,1
1739701440251,AWP 4B,045,802991,Chandler; Bailee Daniele,0,0,0,0
1739701440251,AWP 4B,046,802993,Chandler; Bailee Daniele,0,0,0,1
1739701440251,AWP 4B,047,802994,Hall; Graham T,0,0,0,0
1739701440251,AWP 4B,048,802995,Hall; Graham T,0,0,0,0
1739701441279,AWP 10R,001,871136,Gocsik; Karen Marie,13,0,15,2
1739701442313,BENG 87,A00,886240,Sah; Robert Lie-Yuan,20,0,20,0
1739701442313,BENG 87,B00,886257,Sah; Robert Lie-Yuan,20,0,20,0
1739701443340,BENG 100,A01,805026,Alexandrov; Ludmil B,30,0,30,0
1739701443340,BENG 100,A02,805028,Alexandrov; Ludmil B,29,0,30,1
1739701443340,BENG 100,A03,805030,Alexandrov; Ludmil B,30,0,30,0
1739701443340,BENG 100,A04,805031,Alexandrov; Ludmil B,29,0,30,1
1739701444364,BENG 102,A00,805032,Chapelin; Fanny,52,0,56,4
1739701445389,BENG 103B,A00,805039,Fraley; Stephanie I.,116,0,120,4
1739701446415,BENG 112B,A01,805055,Shi; Lingyan,22,0,23,1
1739701446415,BENG 112B,A02,805056,Shi; Lingyan,20,0,23,3
1739701447443,BENG 125,A01,805058,Hasty; Jeff M,14,0,32,18
1739701447443,BENG 125,A02,805059,Hasty; Jeff M,31,0,32,1
1739701447443,BENG 125,A03,805060,Hasty; Jeff M,31,0,32,1
1739701447443,BENG 125,A04,805102,Hasty; Jeff M,32,0,32,0
1739701447443,BENG 125,A05,805109,Hasty; Jeff M,19,0,32,13
1739701448468,BENG 130,A00,805118,Kravets; Vira V.,37,0,40,3
1739701449496,BENG 134,A01,805171,Smarr; Benjamin,34,0,40,6
1739701450522,BENG 140B,A01,805175,Cabrales; Pedro,27,0,30,3
1739701450522,BENG 140B,A02,805176,Cabrales; Pedro,29,0,30,1
1739701450522,BENG 140B,A03,805177,Cabrales; Pedro,28,0,30,2
1739701451547,BENG 160,A50,805180,Aguado; Brian Alberto,18,0,25,7
1739701451547,BENG 160,A51,805181,Aguado; Brian Alberto,23,0,25,2
1739701451547,BENG 160,A52,805182,Aguado; Brian Alberto,25,0,25,0
1739701452572,BENG 168,A01,805184,Khojah; Reem I,30,0,30,0
1739701453597,BENG 172,A50,805187,Cabrales; Pedro & Sah; Robert Lie-Yuan,13,0,20,7
1739701453597,BENG 172,A51,805188,Cabrales; Pedro & Sah; Robert Lie-Yuan,19,0,20,1
1739701454622,BENG 182,A01,805190,Bafna; Vineet,29,0,35,6
1739701455650,BENG 186A,A01,805192,Kwon; Ester Jihae,0,0,25,25
1739701455650,BENG 186A,A02,805193,Kwon; Ester Jihae,23,0,25,2
1739701455650,BENG 186A,A04,805195,Kwon; Ester Jihae,17,0,25,8
1739701456678,BENG 186B,A01,805230,Aran; Kiana,39,0,40,1
1739701457707,BENG 187A,A00,805231,Taylor Amos; Alyssa C,152,0,170,18
1739701458735,BENG 187D,A00,805243,Taylor Amos; Alyssa C,34,0,60,26
1739701458735,BENG 187D,B00,805249,Taylor Amos; Alyssa C,50,0,60,10
1739701458735,BENG 187D,C00,805286,Taylor Amos; Alyssa C,41,0,60,19
1739701459760,BENG 190,A00,872568,Khojah; Reem I,24,0,40,16
1739701460789,BENG 193,A00,805288,Engler; Adam J.,0,0,0,0
1739701461815,BENG 196,A00,803380,Engler; Adam J.,9999,0,9999,0
1739701462839,BENG 197,A00,803381,Engler; Adam J.,9999,0,9999,0
1739701463865,BENG 203,A00,805307,Bafna; Vineet & Zhong; Sheng,20,0,20,0
1739701464897,BENG 207,A00,805308,Kwon; Ester Jihae,1,0,40,39
1739701464897,BENG 207,B00,805309,Taylor Amos; Alyssa C,0,0,30,30
1739701464897,BENG 207,C00,805310,Spang; Martin Thomas,15,0,40,25
1739701465925,BENG 209,A00,805311,Scholtes Acevedo; Claire,30,0,30,0
1739701466951,BENG 213,A00,805312,Palsson; Bernhard O.,16,0,20,4
1739701467979,BENG 224,A00,805313,Prado; Gustavo Rotelli,0,0,20,30
1739701469006,BENG 226,A01,805315,Staff,74,0,140,66
1739701470034,BENG 227,A00,805316,Fraley; Stephanie I.,42,0,120,78
1739701471062,BENG 230C,A00,805318,King; Kevin R,59,0,90,31
1739701472087,BENG 232,A01,805320,Sah; Robert Lie-Yuan,16,0,70,54
1739701473115,BENG 233,A00,805364,Shah; Sameer B,21,0,50,29
1739701474141,BENG 234,A00,805365,Silva; Gabriel,22,0,70,48
1739701475167,BENG 235,A00,805366,Bintu; Bogdan,18,0,40,22
1739701476190,BENG 276,A00,805367,Mc Culloch; Andrew Douglas,0,0,0,0
1739701477220,BENG 280C,A01,805370,McVeigh; Elliot R.,37,0,56,19
1739701478245,BENG 281,A00,805371,Smarr; Benjamin,40,0,110,70
1739701479273,BENG 283,A00,805372,Ghassemian; Majid & Sanchez Roige; Alexandra & Chavez; Alejandro,5,0,5,0
1739701480298,BENG 285,A00,805374,Alexandrov; Ludmil B,8,0,8,0
1739701481323,BENG 292,A01,805387,Ross; Camille,20,0,20,0
1739701482347,BENG 294C,A00,805396,Engler; Adam J.,0,0,0,0
1739701483374,BENG 295,A00,803924,Watson; John Thomas,9999,0,9999,0
1739701484404,BGGN 205,A00,851551,Daugherty; Matthew Dorton,53,0,60,7
1739701485429,BGGN 207,A01,851553,Ross; Camille,0,0,0,0
1739701486453,BGGN 215,A00,851554,Petrie; Katherine Lynn,0,0,30,30
1739701487478,BGGN 232,A00,851556,Briggs; Steven & Troemel; Emily Ruth,0,0,30,30
1739701488505,BGGN 239,A01,851558,Kronenberg; Mitchell E.,22,0,30,8
1739701489532,BGGN 240,A01,851560,Aoi; Mikio C,1,0,5,4
1739701489532,BGGN 240,A02,851561,Aoi; Mikio C,5,0,5,0
1739701489532,BGGN 240,A03,851562,Aoi; Mikio C,2,0,5,3
1739701489532,BGGN 240,A04,851564,Aoi; Mikio C,4,0,5,1
1739701490558,BGGN 249C,A00,851566,Miller; Cory T.,0,0,0,0
1739701491582,BGGN 255,A00,851567,Root; Cory Matthew,9,0,30,21
1739701492617,BGGN 267,A01,851569,Benna; Marcus K & Aljadeff; Johnatan,0,0,2,2
1739701492617,BGGN 267,A02,851570,Benna; Marcus K & Aljadeff; Johnatan,2,0,2,0
1739701492617,BGGN 267,A03,851571,Benna; Marcus K & Aljadeff; Johnatan,1,0,1,0
1739701492617,BGGN 267,A04,851572,Benna; Marcus K & Aljadeff; Johnatan,1,0,1,0
1739701493689,BGGN 271,001,881551,Ackerman; Susan,9999,0,9999,0
1739701493689,BGGN 271,002,881552,Akbari; Omar Sultan,9997,0,9999,2
1739701493689,BGGN 271,003,881553,Allen; Nicola J,9998,0,9999,1
1739701493689,BGGN 271,004,881554,Alperin; Mariann,9998,0,9999,1
1739701493689,BGGN 271,005,881555,Antal; Corina Elena,9999,0,9999,0
1739701493689,BGGN 271,006,881561,Boss; Gerard R.,9998,0,9999,1
1739701493689,BGGN 271,007,881562,Bouvet; Michael,9999,0,9999,0
1739701493689,BGGN 271,008,881563,Breen; Ellen C.,9999,0,9999,0
1739701493689,BGGN 271,009,881564,Bui; Jack D,9999,0,9999,0
1739701493689,BGGN 271,010,881565,Burnett; Lindsey,9998,0,9999,1
1739701493689,BGGN 271,011,881566,Caffrey; Conor,9998,0,9999,1
1739701493689,BGGN 271,012,881567,Castle; Michael James,9998,0,9999,1
1739701493689,BGGN 271,013,881568,Chang; John Tzu-yu,9999,0,9999,0
1739701493689,BGGN 271,014,881569,Cheng; Christine Shiang-Ling,9999,0,9999,0
1739701493689,BGGN 271,015,881612,Cheresh; David A.,9997,0,9999,2
1739701493689,BGGN 271,016,881616,Cherqui; Stephanie,9999,0,9999,0
1739701493689,BGGN 271,017,881620,Chu; Hiutung,9998,0,9999,1
1739701493689,BGGN 271,018,881627,Church; Kellie Breen,9999,0,9999,0
1739701493689,BGGN 271,019,881637,Cleland; Elsa Eleanor,9998,0,9999,1
1739701493689,BGGN 271,020,881638,Croker; Ben Adam,9999,0,9999,0
1739701493689,BGGN 271,021,881639,Crotty Alexander; Laura E,9997,0,9999,2
1739701493689,BGGN 271,022,881640,Daugherty; Matthew Dorton,9999,0,9999,0
1739701493689,BGGN 271,023,881641,De Silva; Shermin,9998,0,9999,1
1739701493689,BGGN 271,024,881642,Dhar; Debanjan,9999,0,9999,0
1739701493689,BGGN 271,025,881643,Doherty; Taylor Alan,9998,0,9999,1
1739701493689,BGGN 271,026,881644,Dore; Kim Bohemie,9998,0,9999,1
1739701493689,BGGN 271,027,881645,Dulawa; Stephanie Carole,9999,0,9999,0
1739701493689,BGGN 271,028,881646,Farley; Emma Kristen,9998,0,9999,1
1739701493689,BGGN 271,029,881647,Feng; Gen-Sheng,9998,0,9999,1
1739701493689,BGGN 271,030,881648,Fisch; Kathleen Marie,9995,0,9999,4
1739701493689,BGGN 271,031,881649,George; Olivier,9998,0,9999,1
1739701493689,BGGN 271,032,881650,Ghosh; Pradipta,9998,0,9999,1
1739701493689,BGGN 271,033,881651,Glasgow; Stacey Marie,9997,0,9999,2
1739701493689,BGGN 271,034,881652,Golden; James W,9999,0,9999,0
1739701493689,BGGN 271,035,881653,Gonzalez Gamboa; Ivonne,9999,0,9999,0
1739701493689,BGGN 271,036,881654,Goren; Alon M,9999,0,9999,0
1739701493689,BGGN 271,037,881655,Guatelli; John C,9998,0,9999,1
1739701493689,BGGN 271,038,881656,Guma; Monica,9999,0,9999,0
1739701493689,BGGN 271,039,881657,Gustafsson; Asa Birgitta,9998,0,9999,1
1739701493689,BGGN 271,040,881658,Hamdoun; Amr,9999,0,9999,0
1739701493689,BGGN 271,041,881659,Hao; Nan,9999,0,9999,0
1739701493689,BGGN 271,042,881660,Hasty; Jeff M,9998,0,9999,1
1739701493689,BGGN 271,043,881661,Jiang; Qingfei,9999,0,9999,0
1739701493689,BGGN 271,044,881664,Jin; Yishi,9998,0,9999,1
1739701493689,BGGN 271,045,881665,Joiner; William J.,9999,0,9999,0
1739701493689,BGGN 271,046,881666,Joshi; Shweta,9998,0,9999,1
1739701493689,BGGN 271,047,881667,Ju; Won-Kyu,9998,0,9999,1
1739701493689,BGGN 271,048,881668,Jun; Suckjoon,9999,0,9999,0
1739701493689,BGGN 271,049,881669,Kaech; Susan Michelle,9999,0,9999,0
1739701493689,BGGN 271,050,881670,Kauffman; Alexander,9997,0,9999,2
1739701493689,BGGN 271,051,881672,Koloski; Miranda Jane,9998,0,9999,1
1739701493689,BGGN 271,052,881673,Komiyama; Takaki,9998,0,9999,1
1739701493689,BGGN 271,053,881674,Kronenberg; Mitchell E.,9999,0,9999,0
1739701493689,BGGN 271,054,881675,Kufareva; Irina,9998,0,9999,1
1739701493689,BGGN 271,055,881676,Lee; Yun Sok,9999,0,9999,0
1739701493689,BGGN 271,056,881677,Leutgeb; Stefan,9999,0,9999,0
1739701493689,BGGN 271,057,881678,Li; Willis Xiaowei,9998,0,9999,1
1739701493689,BGGN 271,058,881679,Lim; Byungkook,9999,0,9999,0
1739701493689,BGGN 271,059,881680,Lo; Stanley M.,9998,0,9999,1
1739701493689,BGGN 271,060,881681,Lopez Ramirez; Miguel Alej,9999,0,9999,0
1739701493689,BGGN 271,061,881740,Lu; Li-Fan,9999,0,9999,0
1739701493689,BGGN 271,062,881741,Lu; Pengzhe,9998,0,9999,1
1739701493689,BGGN 271,063,881743,Lyons; Deirdre Colleen,9998,0,9999,1
1739701493689,BGGN 271,064,881744,Lyumkis; Dmitry Evgenievich,9999,0,9999,0
1739701493689,BGGN 271,065,881746,McConville; Patrick James,9999,0,9999,0
1739701493689,BGGN 271,066,881749,Mertens; Jerome Stefan,9997,0,9999,2
1739701493689,BGGN 271,067,881751,Morris; Gerald P,9999,0,9999,0
1739701493689,BGGN 271,068,881752,Muroyama; Andrew David,9999,0,9999,0
1739701493689,BGGN 271,069,881757,Murre; Cornelis,9999,0,9999,0
1739701493689,BGGN 271,070,881758,Nieh; James Charles,9997,0,9999,2
1739701493689,BGGN 271,071,881759,Niwa; Maho,9999,0,9999,0
1739701493689,BGGN 271,072,881760,Parast; Mana,9999,0,9999,0
1739701493689,BGGN 271,073,881761,Perry; Michael William,9999,0,9999,0
1739701493689,BGGN 271,074,881762,Pillus; Lorraine,9998,0,9999,1
1739701493689,BGGN 271,075,881765,Pogliano; Joseph,9998,0,9999,1
1739701493689,BGGN 271,076,881767,Pruneda-Paz; Jose L.,9999,0,9999,0
1739701493689,BGGN 271,077,881768,Rana; Tariq,9999,0,9999,0
1739701493689,BGGN 271,078,881769,Rao; Anjana,9999,0,9999,0
1739701493689,BGGN 271,079,881771,Raz; Eyal,9998,0,9999,1
1739701493689,BGGN 271,080,881772,Ren; Bing,9999,0,9999,0
1739701493689,BGGN 271,081,881775,Rifkin; Scott,9998,0,9999,1
1739701493689,BGGN 271,082,881777,Risbrough; Victoria Blythe,9999,0,9999,0
1739701493689,BGGN 271,083,881778,Rose; Noah Hartmann,9999,0,9999,0
1739701493689,BGGN 271,084,881779,Saier; Milton H.,9998,0,9999,1
1739701493689,BGGN 271,085,881781,Saltiel; Alan,9997,0,9999,2
1739701493689,BGGN 271,086,881782,Sanchez-Lopez; Elsa,9998,0,9999,1
1739701493689,BGGN 271,087,881784,Schroeder; Julian I,9999,0,9999,0
1739701493689,BGGN 271,088,881794,Sebat; Lilia Mikhailovna,9998,0,9999,1
1739701493689,BGGN 271,089,881796,Sen; George L,9999,0,9999,0
1739701493689,BGGN 271,090,881797,Shaner; Nathan C.,9999,0,9999,0
1739701493689,BGGN 271,091,881804,Shurin; Jonathan,9998,0,9999,1
1739701493689,BGGN 271,092,881819,Sicklick; Jason Keith,9999,0,9999,0
1739701493689,BGGN 271,093,881908,Signer; Robert,9999,0,9999,0
1739701493689,BGGN 271,094,881909,Simonson; Tatum Sasha Summ,9999,0,9999,0
1739701493689,BGGN 271,095,881923,Steinmetz; Nicole F,9999,0,9999,0
1739701493689,BGGN 271,096,881924,Su; Chih-Ying,9999,0,9999,0
1739701493689,BGGN 271,097,881936,Telese; Francesca,9999,0,9999,0
1739701493689,BGGN 271,098,881955,Towers; Christina Garlingt,9998,0,9999,1
1739701493689,BGGN 271,099,881956,Wahlin; Karl Jonas,9997,0,9999,2
1739701493689,BGGN 271,100,882046,Webster; Nicholas J G,9998,0,9999,1
1739701493689,BGGN 271,101,882047,Weiskopf; Daniela,9999,0,9999,0
1739701493689,BGGN 271,102,882130,Welsbie; Derek,9999,0,9999,0
1739701493689,BGGN 271,103,882167,Wildonger; Jill Cathleen,9999,0,9999,0
1739701493689,BGGN 271,104,882168,Yeo; Eugene Wei-Ming,9998,0,9999,1
1739701493689,BGGN 271,105,882175,Ying; Wei,9998,0,9999,1
1739701493689,BGGN 271,106,882196,Young; Jared W.,9998,0,9999,1
1739701493689,BGGN 271,107,882235,Zage; Peter,9999,0,9999,0
1739701493689,BGGN 271,108,882236,Zengler; Karsten B,9999,0,9999,0
1739701493689,BGGN 271,109,882237,Zhang; Jin,9999,0,9999,0
1739701493689,BGGN 271,110,882238,Zhao; Yunde,9999,0,9999,0
1739701493689,BGGN 271,111,882239,Zheng; Ye,9998,0,9999,1
1739701493689,BGGN 271,112,882288,Zhou; Huilin,9999,0,9999,0
1739701493689,BGGN 271,113,882289,Zou; Yimin,9998,0,9999,1
1739701493689,BGGN 271,114,882290,Zuniga; Elina I,9999,0,9999,0
1739701494714,BGGN 273,A01,851574,Mueller; Liam O'Connor,13,0,50,37
1739701495739,BGGN 275,A00,851577,Flagg; Matthew Paul,0,0,0,5
1739701496764,BGGN 276,A00,851578,Flagg; Matthew Paul,0,0,0,5
1739701497788,BGGN 292,A00,851579,Shiau; Andrew K,35,0,35,0
1739701498813,BGGN 293,A00,851580,Wilhelm; James E.,0,0,0,5
1739701499841,BGGN 295,A00,851581,Juavinett; Ashley Lauren,0,0,30,30
1739701500868,BGJC 204,A00,851584,Lu; Li-Fan & Chang; John Tzu-yu,9991,0,9999,8
1739701501922,BGRD 200,001,883698,Ackerman; Susan,9999,0,9999,0
1739701501922,BGRD 200,002,883700,Akbari; Omar Sultan,9998,0,9999,1
1739701501922,BGRD 200,003,883710,Allen; Eric,9999,0,9999,0
1739701501922,BGRD 200,004,883736,Allen; Nicola J,9998,0,9999,1
1739701501922,BGRD 200,005,883737,Alperin; Mariann,9998,0,9999,1
1739701501922,BGRD 200,006,883765,Amaro; Rommie E,9999,0,9999,0
1739701501922,BGRD 200,007,883766,Antal; Corina Elena,9999,0,9999,0
1739701501922,BGRD 200,008,883827,Asahina; Kenta,9999,0,9999,0
1739701501922,BGRD 200,009,883879,Augustine; Vineet,9999,0,9999,0
1739701501922,BGRD 200,010,883881,Ayres; Janelle Samantha,9998,0,9999,1
1739701501922,BGRD 200,011,883883,Banghart; Matthew Ryan,9999,0,9999,0
1739701501922,BGRD 200,012,883884,Barton; Andrew David,9999,0,9999,0
1739701501922,BGRD 200,013,883886,Benna; Marcus K,9999,0,9999,0
1739701501922,BGRD 200,014,883887,Bennett; Eric J,9998,0,9999,1
1739701501922,BGRD 200,015,883888,Biering; Scott B,9999,0,9999,0
1739701501922,BGRD 200,016,883890,Bloodgood; Brenda Laurie,9999,0,9999,0
1739701501922,BGRD 200,017,883891,Boss; Gerard R.,9999,0,9999,0
1739701501922,BGRD 200,018,883893,Bouvet; Michael,9999,0,9999,0
1739701501922,BGRD 200,019,883894,Breen; Ellen C.,9999,0,9999,0
1739701501922,BGRD 200,020,883895,Briggs; Steven,9999,0,9999,0
1739701501922,BGRD 200,021,883896,Bui; Jack D,9999,0,9999,0
1739701501922,BGRD 200,022,883897,Burnett; Lindsey,9998,0,9999,1
1739701501922,BGRD 200,023,883899,Caffrey; Conor,9998,0,9999,1
1739701501922,BGRD 200,024,883908,Callaway; Edward M,9999,0,9999,0
1739701501922,BGRD 200,025,883911,Castle; Michael James,9999,0,9999,0
1739701501922,BGRD 200,026,883915,Chaim; Isaac,9998,0,9999,1
1739701501922,BGRD 200,027,883916,Chang; John Tzu-yu,9999,0,9999,0
1739701501922,BGRD 200,028,883917,Chen; Xu,9999,0,9999,0
1739701501922,BGRD 200,029,883919,Cheng; Christine Shiang-Ling,9999,0,9999,0
1739701501922,BGRD 200,030,883921,Cheresh; David A.,9997,0,9999,2
1739701501922,BGRD 200,031,883924,Cherqui; Stephanie,9999,0,9999,0
1739701501922,BGRD 200,032,883929,Chu; Hiutung,9998,0,9999,1
1739701501922,BGRD 200,033,883931,Church; Kellie Breen,9999,0,9999,0
1739701501922,BGRD 200,034,883933,Cleland; Elsa Eleanor,9998,0,9999,1
1739701501922,BGRD 200,035,883934,Cooper; Kimberly Lynn,9999,0,9999,0
1739701501922,BGRD 200,036,883935,Coufal; Nicole Gabriele,9999,0,9999,0
1739701501922,BGRD 200,037,883938,Croker; Ben Adam,9999,0,9999,0
1739701501922,BGRD 200,038,883939,Crotty Alexander; Laura E,9997,0,9999,2
1739701501922,BGRD 200,039,883940,Daugherty; Matthew Dorton,9999,0,9999,0
1739701501922,BGRD 200,040,883941,De Silva; Shermin,9998,0,9999,1
1739701501922,BGRD 200,041,883946,Desai; Arshad,9999,0,9999,0
1739701501922,BGRD 200,042,883949,Dhar; Debanjan,9999,0,9999,0
1739701501922,BGRD 200,043,883993,Dickinson; Alexandra Jazz,9999,0,9999,0
1739701501922,BGRD 200,044,884003,Dixon; Jesse,9999,0,9999,0
1739701501922,BGRD 200,045,884008,Doherty; Taylor Alan,9998,0,9999,1
1739701501922,BGRD 200,046,884028,Dore; Kim Bohemie,9998,0,9999,1
1739701501922,BGRD 200,047,884082,Dulawa; Stephanie Carole,9999,0,9999,0
1739701501922,BGRD 200,048,884084,Ecker; Joseph R,9999,0,9999,0
1739701501922,BGRD 200,049,884107,Engle; Dannielle D,9999,0,9999,0
1739701501922,BGRD 200,050,884337,Ernst; Andreas,9999,0,9999,0
1739701501922,BGRD 200,051,884338,Esko; Jeffrey D.,9999,0,9999,0
1739701501922,BGRD 200,052,884339,Farley; Emma Kristen,9998,0,9999,1
1739701501922,BGRD 200,053,884340,Feldstein; Ariel E,9999,0,9999,0
1739701501922,BGRD 200,054,884341,Feng; Gen-Sheng,9998,0,9999,1
1739701501922,BGRD 200,055,884342,Fisch; Kathleen Marie,9995,0,9999,4
1739701501922,BGRD 200,056,884343,Friedman; Rick Adam,9999,0,9999,0
1739701501922,BGRD 200,057,884344,Furnari; Frank,9999,0,9999,0
1739701501922,BGRD 200,058,884345,Gage; Fred H,9999,0,9999,0
1739701501922,BGRD 200,059,884346,George; Olivier,9998,0,9999,1
1739701501922,BGRD 200,060,884347,Ghosh; Pradipta,9998,0,9999,1
1739701501922,BGRD 200,061,884348,Glasgow; Stacey Marie,9997,0,9999,2
1739701501922,BGRD 200,062,884349,Glass; Christopher,9999,0,9999,0
1739701501922,BGRD 200,063,884350,Golden; James W,9999,0,9999,0
1739701501922,BGRD 200,064,884352,Golden; Susan S.,9999,0,9999,0
1739701501922,BGRD 200,065,884354,Gonzalez Gamboa; Ivonne,9999,0,9999,0
1739701501922,BGRD 200,066,884355,Goren; Alon M,9999,0,9999,0
1739701501922,BGRD 200,067,884356,Guatelli; John C,9998,0,9999,1
1739701501922,BGRD 200,068,884357,Guma; Monica,9999,0,9999,0
1739701501922,BGRD 200,069,884360,Gustafsson; Asa Birgitta,9998,0,9999,1
1739701501922,BGRD 200,070,884361,Gutkind; Jorge Silvio,9999,0,9999,0
1739701501922,BGRD 200,071,884362,Hamdoun; Amr,9999,0,9999,0
1739701501922,BGRD 200,072,884364,Hampton; Randolph Y.,9999,0,9999,0
1739701501922,BGRD 200,073,884367,Hao; Nan,9999,0,9999,0
1739701501922,BGRD 200,074,884368,Hargreaves; Diana Clare,9999,0,9999,0
1739701501922,BGRD 200,075,884369,Hasty; Jeff M,9998,0,9999,1
1739701501922,BGRD 200,076,884370,Hollern; Daniel Patrick,9999,0,9999,0
1739701501922,BGRD 200,077,884372,Holway; David A.,9999,0,9999,0
1739701501922,BGRD 200,078,884374,Huffaker; Alisa,9999,0,9999,0
1739701501922,BGRD 200,079,884375,Hui; Enfu,9999,0,9999,0
1739701501922,BGRD 200,080,884376,Hwa; Terence T.,9999,0,9999,0
1739701501922,BGRD 200,081,884377,Ideker; Trey,9999,0,9999,0
1739701501922,BGRD 200,082,884378,Jackrel; Sara,9998,0,9999,1
1739701501922,BGRD 200,083,884380,Jiang; Qingfei,9999,0,9999,0
1739701501922,BGRD 200,084,884382,Jin; Yishi,9998,0,9999,1
1739701501922,BGRD 200,085,884384,Joiner; William J.,9999,0,9999,0
1739701501922,BGRD 200,086,884385,Joshi; Shweta,9998,0,9999,1
1739701501922,BGRD 200,087,884386,Ju; Won-Kyu,9998,0,9999,1
1739701501922,BGRD 200,088,884387,Jun; Suckjoon,9999,0,9999,0
1739701501922,BGRD 200,089,884388,Kadonaga; James T,9999,0,9999,0
1739701501922,BGRD 200,090,884389,Kaech; Susan Michelle,9999,0,9999,0
1739701501922,BGRD 200,091,884391,Kauffman; Alexander,9997,0,9999,2
1739701501922,BGRD 200,092,884392,Kleinfeld; David,9999,0,9999,0
1739701501922,BGRD 200,093,884393,Knight; Robin,9999,0,9999,0
1739701501922,BGRD 200,094,884394,Koloski; Miranda Jane,9998,0,9999,1
1739701501922,BGRD 200,095,884395,Komiyama; Takaki,9998,0,9999,1
1739701501922,BGRD 200,096,884396,Kosuri; Pallav,9999,0,9999,0
1739701501922,BGRD 200,097,884397,Kronenberg; Mitchell E.,9999,0,9999,0
1739701501922,BGRD 200,099,884400,Kryazhimskiy; Sergey A,9999,0,9999,0
1739701501922,BGRD 200,100,884401,Kufareva; Irina,9998,0,9999,1
1739701501922,BGRD 200,101,884402,Lee; Kuo Fen,9999,0,9999,0
1739701501922,BGRD 200,102,884403,Lee; Yun Sok,9999,0,9999,0
1739701501922,BGRD 200,103,884404,Leutgeb; Jill K.,9999,0,9999,0
1739701501922,BGRD 200,104,884405,Leutgeb; Stefan,9999,0,9999,0
1739701501922,BGRD 200,105,884406,Li; Willis Xiaowei,9998,0,9999,1
1739701501922,BGRD 200,106,884407,Lim; Byungkook,9998,0,9999,1
1739701501922,BGRD 200,107,884410,Lo; Stanley M.,9998,0,9999,1
1739701501922,BGRD 200,108,884414,Looger; Loren Lee,9999,0,9999,0
1739701501922,BGRD 200,109,884415,Lopez Ramirez; Miguel Alej,9999,0,9999,0
1739701501922,BGRD 200,110,884416,Lovett-Barron; Matthew Rod,9999,0,9999,0
1739701501922,BGRD 200,111,884418,Lu; Li-Fan,9998,0,9999,1
1739701501922,BGRD 200,112,884419,Lu; Pengzhe,9998,0,9999,1
1739701501922,BGRD 200,113,884421,Lykke-Andersen; Jens,9999,0,9999,0
1739701501922,BGRD 200,114,884423,Lyons; Deirdre Colleen,9998,0,9999,1
1739701501922,BGRD 200,115,884424,Lyumkis; Dmitry Evgenievich,9999,0,9999,0
1739701501922,BGRD 200,116,884425,Manor; Uri,9999,0,9999,0
1739701501922,BGRD 200,117,884426,Mayfield; Stephen P.,9998,0,9999,1
1739701501922,BGRD 200,118,884427,McConville; Patrick James,9999,0,9999,0
1739701501922,BGRD 200,119,884428,McDonnell; Lisa Marie,9999,0,9999,0
1739701501922,BGRD 200,120,884429,Mertens; Jerome Stefan,9997,0,9999,2
1739701501922,BGRD 200,121,884430,Meyer; Justin Raymond,9999,0,9999,0
1739701501922,BGRD 200,122,884431,Morris; Gerald P,9999,0,9999,0
1739701501922,BGRD 200,123,884432,Mueller; Lena,9999,0,9999,0
1739701501922,BGRD 200,124,884433,Muotri; Alysson,9999,0,9999,0
1739701501922,BGRD 200,125,884434,Muroyama; Andrew David,9997,0,9999,2
1739701501922,BGRD 200,126,884435,Murre; Cornelis,9999,0,9999,0
1739701501922,BGRD 200,127,884436,Neal; Sonya E,9999,0,9999,0
1739701501922,BGRD 200,128,884438,Nieh; James Charles,9997,0,9999,2
1739701501922,BGRD 200,129,884441,Nimmerjahn; Axel,9999,0,9999,0
1739701501922,BGRD 200,130,884444,Niwa; Maho,9999,0,9999,0
1739701501922,BGRD 200,131,884445,Nizet; Victor F.,9998,0,9999,1
1739701501922,BGRD 200,132,884446,Oegema; Karen,9999,0,9999,0
1739701501922,BGRD 200,133,884447,Panda; Satchidananda,9999,0,9999,0
1739701501922,BGRD 200,134,884448,Parast; Mana,9999,0,9999,0
1739701501922,BGRD 200,135,884449,Pasquinelli; Amy,9998,0,9999,1
1739701501922,BGRD 200,136,884450,Pekkurnaz Banghart; Gulcin,9999,0,9999,0
1739701501922,BGRD 200,137,884451,Perry; Michael William,9999,0,9999,0
1739701501922,BGRD 200,138,884452,Pillus; Lorraine,9998,0,9999,1
1739701501922,BGRD 200,139,884454,Pogliano; Joseph,9998,0,9999,1
1739701501922,BGRD 200,140,884456,Pogliano; Kit J.,9999,0,9999,0
1739701501922,BGRD 200,141,884457,Pride; David Tevis,9999,0,9999,0
1739701501922,BGRD 200,142,884458,Pruneda-Paz; Jose L.,9999,0,9999,0
1739701501922,BGRD 200,143,884459,Ramanan; Deepshika,9998,0,9999,1
1739701501922,BGRD 200,144,884460,Rana; Tariq,9999,0,9999,0
1739701501922,BGRD 200,145,884461,Rao; Anjana,9999,0,9999,0
1739701501922,BGRD 200,146,884462,Raz; Eyal,9998,0,9999,1
1739701501922,BGRD 200,147,884464,Reck-Peterson; Samara L,9999,0,9999,0
1739701501922,BGRD 200,148,884468,Ren; Bing,9999,0,9999,0
1739701501922,BGRD 200,149,884469,Rennison; Diana,9999,0,9999,0
1739701501922,BGRD 200,150,884471,Reyes De Barboza; Nabora S,9999,0,9999,0
1739701501922,BGRD 200,151,884472,Rifkin; Scott,9998,0,9999,1
1739701501922,BGRD 200,152,884482,Risbrough; Victoria Blythe,9999,0,9999,0
1739701501922,BGRD 200,153,884484,Rivera; Fabian Chavez,9999,0,9999,0
1739701501922,BGRD 200,154,884486,Rohner; Patrick Thomas,9999,0,9999,0
1739701501922,BGRD 200,155,884488,Rose; Noah Hartmann,9999,0,9999,0
1739701501922,BGRD 200,156,884491,Rosenfeld; Michael G,9999,0,9999,0
1739701501922,BGRD 200,157,884493,Russell; Alistair B,9999,0,9999,0
1739701501922,BGRD 200,158,884494,Saier; Milton H.,9998,0,9999,1
1739701501922,BGRD 200,159,884496,Saltiel; Alan,9997,0,9999,2
1739701501922,BGRD 200,160,884498,Sanchez-Lopez; Elsa,9999,0,9999,0
1739701501922,BGRD 200,161,884502,Saphire; Erica Ollmann,9999,0,9999,0
1739701501922,BGRD 200,162,884504,Schroeder; Julian I,9999,0,9999,0
1739701501922,BGRD 200,163,884508,Sebat; Lilia Mikhailovna,9998,0,9999,1
1739701501922,BGRD 200,164,884510,Sen; George L,9999,0,9999,0
1739701501922,BGRD 200,165,884513,Shah; Sameer B,9999,0,9999,0
1739701501922,BGRD 200,166,884515,Shaner; Nathan C.,9999,0,9999,0
1739701501922,BGRD 200,167,884517,Sharpee; Tatyana,9999,0,9999,0
1739701501922,BGRD 200,168,884519,Shaw; Reuben,9998,0,9999,1
1739701501922,BGRD 200,169,884522,Shurin; Jonathan,9998,0,9999,1
1739701501922,BGRD 200,170,884524,Sicklick; Jason Keith,9999,0,9999,0
1739701501922,BGRD 200,171,884526,Signer; Robert,9999,0,9999,0
1739701501922,BGRD 200,172,884530,Simonson; Tatum Sasha Summ,9999,0,9999,0
1739701501922,BGRD 200,173,884533,Soncin; Francesca,9999,0,9999,0
1739701501922,BGRD 200,174,884535,Steinmetz; Nicole F,9999,0,9999,0
1739701501922,BGRD 200,175,884536,Su; Chih-Ying,9999,0,9999,0
1739701501922,BGRD 200,176,884537,Suel; Gurol Mehmet,9999,0,9999,0
1739701501922,BGRD 200,177,884538,Sun; Xin,9999,0,9999,0
1739701501922,BGRD 200,178,884540,Telese; Francesca,9999,0,9999,0
1739701501922,BGRD 200,179,884543,Towers; Christina Garlingt,9998,0,9999,1
1739701501922,BGRD 200,180,884544,Traver; David,9999,0,9999,0
1739701501922,BGRD 200,181,884545,Troemel; Emily Ruth,9999,0,9999,0
1739701501922,BGRD 200,182,884546,Valdez-Jasso; Daniela,9999,0,9999,0
1739701501922,BGRD 200,183,884549,Vijayanand; Pandurangan,9999,0,9999,0
1739701501922,BGRD 200,184,884552,Villa Rodriguez; Elizabeth,9999,0,9999,0
1739701501922,BGRD 200,185,884553,Wahlin; Karl Jonas,9997,0,9999,2
1739701501922,BGRD 200,186,884555,Wang; Jean Yin Jen,9998,0,9999,1
1739701501922,BGRD 200,187,884556,Webster; Nicholas J G,9998,0,9999,1
1739701501922,BGRD 200,188,884557,Welsbie; Derek,9999,0,9999,0
1739701501922,BGRD 200,189,884600,Wildonger; Jill Cathleen,9998,0,9999,1
1739701501922,BGRD 200,190,884644,Winzeler; Elizabeth A,9998,0,9999,1
1739701501922,BGRD 200,191,884686,Yaksh; Tony L.,9999,0,9999,0
1739701501922,BGRD 200,192,884695,Yelon; Deborah,9999,0,9999,0
1739701501922,BGRD 200,193,884698,Yeo; Eugene Wei-Ming,9998,0,9999,1
1739701501922,BGRD 200,194,884706,Ying; Wei,9998,0,9999,1
1739701501922,BGRD 200,195,884707,Young; Jared W.,9998,0,9999,1
1739701501922,BGRD 200,196,884737,Zage; Peter,9999,0,9999,0
1739701501922,BGRD 200,197,884740,Zengler; Karsten B,9999,0,9999,0
1739701501922,BGRD 200,198,884749,Zhang; Dong-Er,9999,0,9999,0
1739701501922,BGRD 200,199,884750,Zhang; Jin,9999,0,9999,0
1739701501922,BGRD 200,200,884751,Zhao; Yunde,9999,0,9999,0
1739701501922,BGRD 200,201,884766,Zheng; Binhai,9999,0,9999,0
1739701501922,BGRD 200,202,884774,Zheng; Ye,9998,0,9999,1
1739701501922,BGRD 200,203,884849,Zhou; Huilin,9999,0,9999,0
1739701501922,BGRD 200,204,884894,Zou; Yimin,9998,0,9999,1
1739701501922,BGRD 200,205,884895,Zuniga; Elina I,9999,0,9999,0
1739701502948,BGSE 200,A00,851586,Tour; Ella & Petrie; Katherine Lynn,9989,0,9999,10
1739701503972,BGSE 205,A00,851588,Bennett; Eric J,46,0,50,4
1739701503972,BGSE 205,C00,851589,Bennett; Eric J,43,0,50,7
1739701503972,BGSE 205,D00,851590,Bennett; Eric J,48,0,50,2
1739701503972,BGSE 205,E00,851591,Bennett; Eric J,49,0,50,1
1739701504998,BIBC 102,A01,864157,Hampton; Randolph Y.,48,0,73,25
1739701504998,BIBC 102,A02,864159,Hampton; Randolph Y.,66,0,73,7
1739701504998,BIBC 102,A03,864171,Hampton; Randolph Y.,69,0,73,4
1739701504998,BIBC 102,A04,864227,Hampton; Randolph Y.,63,0,73,10
1739701506025,BIBC 103,A01,850483,Coleman; Aaron B.,19,0,24,5
1739701506025,BIBC 103,A02,850484,Coleman; Aaron B.,24,0,24,0
1739701506025,BIBC 103,B01,850487,Coleman; Aaron B.,21,0,24,3
1739701506025,BIBC 103,B02,850489,Coleman; Aaron B.,24,0,24,0
1739701506025,BIBC 103,C01,850492,Burg; Michael,15,0,24,9
1739701506025,BIBC 103,C02,850493,Burg; Michael,23,0,24,1
1739701507053,BIBC 104,A01,850495,Zhao; Yunde,49,0,50,1
1739701507053,BIBC 104,A02,850496,Zhao; Yunde,50,0,50,0
1739701507053,BIBC 104,A03,850500,Zhao; Yunde,48,0,50,2
1739701507053,BIBC 104,A04,850501,Zhao; Yunde,48,0,50,2
1739701508078,BIBC 194,A00,850502,Ernst; Andreas,20,0,32,12
1739701508078,BIBC 194,B00,850503,Saier; Milton H.,21,0,32,11
1739701509110,BICD 100,A01,864248,Biering; Scott B,70,0,73,3
1739701509110,BICD 100,A02,864249,Biering; Scott B,72,0,73,1
1739701509110,BICD 100,A03,864274,Biering; Scott B,73,0,73,0
1739701509110,BICD 100,A04,864287,Biering; Scott B,70,0,73,3
1739701509110,BICD 100,B01,864290,Reinagel; Pam,70,0,73,3
1739701509110,BICD 100,B02,864291,Reinagel; Pam,72,0,73,1
1739701509110,BICD 100,B03,864294,Reinagel; Pam,72,0,73,1
1739701509110,BICD 100,B04,864299,Reinagel; Pam,73,0,73,0
1739701509110,BICD 100,C01,864303,Nguyen; Vu Quang,72,0,73,1
1739701509110,BICD 100,C02,864314,Nguyen; Vu Quang,71,0,73,2
1739701509110,BICD 100,C03,864347,Nguyen; Vu Quang,72,0,73,1
1739701509110,BICD 100,C04,864362,Nguyen; Vu Quang,73,0,73,0
1739701510136,BICD 110,A01,850512,Ernst; Andreas,42,0,73,31
1739701510136,BICD 110,A02,850513,Ernst; Andreas,53,0,73,20
1739701510136,BICD 110,A03,850516,Ernst; Andreas,61,0,73,12
1739701510136,BICD 110,A04,850518,Ernst; Andreas,53,0,73,20
1739701511161,BICD 123,A01,850521,Zhao; Yunde,29,0,36,7
1739701512189,BICD 140,A01,850561,Lu; Li-Fan,50,0,61,11
1739701512189,BICD 140,A02,850563,Lu; Li-Fan,57,0,61,4
1739701512189,BICD 140,A03,850569,Lu; Li-Fan,57,0,61,4
1739701512189,BICD 140,A04,850577,Lu; Li-Fan,60,0,62,2
1739701513214,BICD 158,A01,850601,Bier; Ethan,30,0,36,6
1739701513214,BICD 158,A02,850644,Bier; Ethan,32,0,36,4
1739701513214,BICD 158,A03,850655,Bier; Ethan,33,0,36,3
1739701513214,BICD 158,A04,850656,Bier; Ethan,36,0,37,1
1739701514242,BIEB 121,A00,850668,Butler; Shannon Rhey,25,0,32,7
1739701514242,BIEB 121,B00,850674,Butler; Shannon Rhey,21,0,32,11
1739701515266,BIEB 146,A01,850680,Petrie; Katherine Lynn,91,0,99,8
1739701515266,BIEB 146,A02,850682,Petrie; Katherine Lynn,81,0,99,18
1739701515266,BIEB 146,A03,850684,Petrie; Katherine Lynn,95,0,99,4
1739701515266,BIEB 146,A04,850687,Petrie; Katherine Lynn,94,0,98,4
1739701516295,BIEB 148,A01,850691,Rose; Noah Hartmann,25,0,36,11
1739701516295,BIEB 148,A02,850706,Rose; Noah Hartmann,33,0,36,3
1739701516295,BIEB 148,A03,850778,Rose; Noah Hartmann,34,0,36,2
1739701516295,BIEB 148,A04,850779,Rose; Noah Hartmann,24,0,36,12
1739701517323,BIEB 152,A01,850784,Wodarz; Dominik Franz Xave,70,0,75,5
1739701517323,BIEB 152,A02,850785,Wodarz; Dominik Franz Xave,73,0,75,2
1739701517323,BIEB 152,A03,850786,Wodarz; Dominik Franz Xave,69,0,75,6
1739701517323,BIEB 152,A04,850789,Wodarz; Dominik Franz Xave,68,0,75,7
1739701518348,BIEB 154,A01,850792,Stockwell; Sarah R,15,0,15,0
1739701518348,BIEB 154,A02,850795,Stockwell; Sarah R,14,0,15,1
1739701518348,BIEB 154,A03,850796,Stockwell; Sarah R,13,0,15,2
1739701518348,BIEB 154,A04,850854,Stockwell; Sarah R,15,0,15,0
1739701519373,BIEB 159,A00,850856,Jackrel; Sara,33,0,36,3
1739701520396,BIEB 164,A01,850859,De Silva; Shermin,47,0,50,3
1739701520396,BIEB 164,A02,850862,De Silva; Shermin,42,0,50,8
1739701520396,BIEB 164,A03,850863,De Silva; Shermin,45,0,50,5
1739701520396,BIEB 164,A04,850865,De Silva; Shermin,45,0,50,5
1739701521428,BILD 1,A01,860138,Patrick; Gentry,62,0,62,0
1739701521428,BILD 1,A02,860253,Patrick; Gentry,61,0,62,1
1739701521428,BILD 1,A03,860277,Patrick; Gentry,61,0,62,1
1739701521428,BILD 1,A04,860281,Patrick; Gentry,61,0,64,3
1739701521428,BILD 1,B01,860381,Gonzalez Gamboa; Ivonne,51,0,62,11
1739701521428,BILD 1,B02,860382,Gonzalez Gamboa; Ivonne,61,0,62,1
1739701521428,BILD 1,B03,860383,Gonzalez Gamboa; Ivonne,59,0,62,3
1739701521428,BILD 1,B04,860384,Gonzalez Gamboa; Ivonne,63,0,64,1
1739701521428,BILD 1,C01,860385,Cooper; Andrew Michael,61,0,62,1
1739701521428,BILD 1,C02,860386,Cooper; Andrew Michael,59,0,62,3
1739701521428,BILD 1,C03,860387,Cooper; Andrew Michael,62,0,62,0
1739701521428,BILD 1,C04,860388,Cooper; Andrew Michael,64,0,64,0
1739701522452,BILD 2,A01,860389,Reyes Gonzalez; Catalina,87,0,99,12
1739701522452,BILD 2,A02,860390,Reyes Gonzalez; Catalina,96,0,99,3
1739701522452,BILD 2,A03,860391,Reyes Gonzalez; Catalina,99,0,99,0
1739701522452,BILD 2,A04,860392,Reyes Gonzalez; Catalina,98,0,98,0
1739701523485,BILD 3,A01,860393,Stockwell; Sarah R,68,0,70,2
1739701523485,BILD 3,A02,860394,Stockwell; Sarah R,66,0,70,4
1739701523485,BILD 3,A03,860395,Stockwell; Sarah R,69,0,70,1
1739701523485,BILD 3,A04,860396,Stockwell; Sarah R,66,0,68,2
1739701523485,BILD 3,B01,860397,Hammond; LaTisha Marie,48,0,63,15
1739701523485,BILD 3,B02,860398,Hammond; LaTisha Marie,54,0,60,6
1739701523485,BILD 3,B03,860399,Hammond; LaTisha Marie,57,0,60,3
1739701523485,BILD 3,B04,860400,Hammond; LaTisha Marie,60,0,62,2
1739701523485,BILD 3,C01,860401,Hammond; LaTisha Marie,60,0,62,2
1739701523485,BILD 3,C02,860402,Hammond; LaTisha Marie,58,0,63,5
1739701523485,BILD 3,C03,860403,Hammond; LaTisha Marie,59,0,60,1
1739701523485,BILD 3,C04,860404,Hammond; LaTisha Marie,60,0,60,0
1739701524512,BILD 4,A01,850172,Ochoa Mikrut; Stacy Daniel,22,0,24,2
1739701524512,BILD 4,A02,850250,Ochoa Mikrut; Stacy Daniel,24,0,24,0
1739701524512,BILD 4,A03,850251,Ochoa Mikrut; Stacy Daniel,22,0,24,2
1739701524512,BILD 4,A04,850252,Ochoa Mikrut; Stacy Daniel,23,0,24,1
1739701524512,BILD 4,A05,850253,Ochoa Mikrut; Stacy Daniel,24,0,24,0
1739701524512,BILD 4,A06,850254,Ochoa Mikrut; Stacy Daniel,24,0,24,0
1739701524512,BILD 4,A07,850255,Ochoa Mikrut; Stacy Daniel,24,0,24,0
1739701524512,BILD 4,A08,850257,Ochoa Mikrut; Stacy Daniel,23,0,24,1
1739701524512,BILD 4,B01,850259,Reuther; Keefe,18,0,24,6
1739701524512,BILD 4,B02,850260,Reuther; Keefe,22,0,24,2
1739701524512,BILD 4,B03,850261,Reuther; Keefe,24,0,24,0
1739701524512,BILD 4,B04,850263,Reuther; Keefe,22,0,24,2
1739701524512,BILD 4,B05,850264,Reuther; Keefe,23,0,24,1
1739701524512,BILD 4,B06,850265,Reuther; Keefe,24,0,24,0
1739701524512,BILD 4,B07,850266,Reuther; Keefe,24,0,24,0
1739701524512,BILD 4,B08,850267,Reuther; Keefe,24,0,24,0
1739701524512,BILD 4,C01,850269,Gonzalez Gamboa; Ivonne,19,0,24,5
1739701524512,BILD 4,C02,850270,Gonzalez Gamboa; Ivonne,24,0,24,0
1739701524512,BILD 4,C03,850271,Gonzalez Gamboa; Ivonne,24,0,24,0
1739701524512,BILD 4,C04,850273,Gonzalez Gamboa; Ivonne,24,0,24,0
1739701524512,BILD 4,C05,850283,Gonzalez Gamboa; Ivonne,23,0,24,1
1739701524512,BILD 4,C06,850329,Gonzalez Gamboa; Ivonne,23,0,24,1
1739701524512,BILD 4,C07,850331,Gonzalez Gamboa; Ivonne,24,0,24,0
1739701524512,BILD 4,C08,850336,Gonzalez Gamboa; Ivonne,23,0,24,1
1739701525539,BILD 5,A01,860586,Reuther; Keefe,63,0,65,2
1739701525539,BILD 5,A02,860597,Reuther; Keefe,62,0,65,3
1739701525539,BILD 5,A03,860600,Reuther; Keefe,65,0,65,0
1739701525539,BILD 5,A04,860672,Reuther; Keefe,64,0,65,1
1739701525539,BILD 5,B01,860673,Yang; Mingyu,65,0,65,0
1739701525539,BILD 5,B02,860681,Yang; Mingyu,64,0,65,1
1739701525539,BILD 5,B03,860686,Yang; Mingyu,65,0,65,0
1739701525539,BILD 5,B04,860687,Yang; Mingyu,65,0,65,0
1739701525539,BILD 5,C01,860694,Day; Christopher D,62,0,65,3
1739701525539,BILD 5,C02,860697,Day; Christopher D,65,0,65,0
1739701525539,BILD 5,C03,860709,Day; Christopher D,63,0,65,2
1739701525539,BILD 5,C04,860714,Day; Christopher D,65,0,65,0
1739701526568,BILD 30,A01,850343,Madigan; Cressida Ariana,28,0,28,0
1739701526568,BILD 30,A02,850344,Madigan; Cressida Ariana,28,0,28,0
1739701526568,BILD 30,A03,850345,Madigan; Cressida Ariana,26,0,28,2
1739701526568,BILD 30,A04,850349,Madigan; Cressida Ariana,30,0,31,1
1739701527592,BILD 88,A00,850480,Kurle; Carolyn M.,20,0,20,0
1739701528617,BIMM 100,A01,860726,Farley; Emma Kristen,35,0,48,13
1739701528617,BIMM 100,A02,860737,Farley; Emma Kristen,43,0,48,5
1739701528617,BIMM 100,A03,860771,Farley; Emma Kristen,46,0,48,2
1739701528617,BIMM 100,A04,860812,Farley; Emma Kristen,45,0,48,3
1739701528617,BIMM 100,B01,860817,Wildonger; Jill Cathleen,35,0,48,13
1739701528617,BIMM 100,B02,860838,Wildonger; Jill Cathleen,38,0,48,10
1739701528617,BIMM 100,B03,860839,Wildonger; Jill Cathleen,44,0,48,4
1739701528617,BIMM 100,B04,860840,Wildonger; Jill Cathleen,46,0,48,2
1739701529644,BIMM 101,A01,850871,Meaders; Clara Leigh,0,0,24,24
1739701529644,BIMM 101,A02,850872,Meaders; Clara Leigh,1,0,24,23
1739701529644,BIMM 101,B01,850876,Day; Christopher D,23,0,24,1
1739701529644,BIMM 101,B02,850877,Day; Christopher D,22,0,24,2
1739701529644,BIMM 101,C01,850880,Cooper; Andrew Michael,17,0,24,7
1739701529644,BIMM 101,C02,850887,Cooper; Andrew Michael,22,0,24,2
1739701529644,BIMM 101,D01,850890,Grossman; Emily N,19,0,24,5
1739701529644,BIMM 101,D02,850894,Grossman; Emily N,20,0,24,4
1739701529644,BIMM 101,E01,850897,Grossman; Emily N,19,0,24,5
1739701529644,BIMM 101,E02,850900,Grossman; Emily N,22,0,24,2
1739701529644,BIMM 101,F01,850906,Rusert; Jessica Marie,21,0,24,3
1739701529644,BIMM 101,F02,850910,Rusert; Jessica Marie,24,0,24,0
1739701529644,BIMM 101,G01,850920,Rusert; Jessica Marie,20,0,24,4
1739701529644,BIMM 101,G02,850921,Rusert; Jessica Marie,24,0,24,0
1739701530668,BIMM 118,A01,850923,David; Michael,26,0,29,3
1739701530668,BIMM 118,A02,850926,David; Michael,27,0,29,2
1739701530668,BIMM 118,A03,850927,David; Michael,25,0,29,4
1739701530668,BIMM 118,A04,850928,David; Michael,27,0,28,1
1739701531693,BIMM 120,A01,850932,Saier; Milton H.,78,0,87,9
1739701531693,BIMM 120,A02,850934,Saier; Milton H.,71,0,87,16
1739701531693,BIMM 120,A03,850986,Saier; Milton H.,81,0,87,6
1739701531693,BIMM 120,A04,851000,Saier; Milton H.,84,0,87,3
1739701532723,BIMM 121,A01,851020,Gustafson-Brown; Cindy,18,0,24,6
1739701532723,BIMM 121,A02,851023,Gustafson-Brown; Cindy,23,0,24,1
1739701532723,BIMM 121,B01,851032,Gustafson-Brown; Cindy,15,0,24,9
1739701532723,BIMM 121,B02,851058,Gustafson-Brown; Cindy,19,0,24,5
1739701532723,BIMM 121,C01,851077,Staff,2,0,24,22
1739701532723,BIMM 121,C02,851081,Staff,19,0,24,5
1739701532723,BIMM 121,D01,851152,Staff,15,0,24,9
1739701532723,BIMM 121,D02,851169,Staff,23,0,24,1
1739701533749,BIMM 134,A01,851210,Burg; Michael,94,0,103,9
1739701533749,BIMM 134,A02,851211,Burg; Michael,93,0,103,10
1739701533749,BIMM 134,A03,851212,Burg; Michael,93,0,103,10
1739701533749,BIMM 134,A04,851213,Burg; Michael,96,0,101,5
1739701534777,BIMM 143,A01,851215,Grant; Barry J,28,0,40,12
1739701534777,BIMM 143,B01,851218,Bozinovic; Goran,38,0,40,2
1739701534777,BIMM 143,C01,851220,Bozinovic; Goran,40,0,40,0
1739701535803,BIMM 182,A01,851597,Bafna; Vineet,31,0,50,19
1739701536828,BIMM 194,A00,851222,Russell; Alistair B,23,0,32,9
1739701537855,BIOM 202,A01,806511,Sheikh; Farah,21,0,40,19
1739701538880,BIOM 218,A00,806606,Gagneux; Pascal,10,0,12,2
1739701539907,BIOM 219,A00,806612,Ross; Camille,1,0,1,0
1739701540935,BIOM 222,A00,872553,Esko; Jeffrey D.,0,0,0,0
1739701541961,BIOM 229,A00,806613,Gagneux; Pascal,12,0,12,0
1739701542987,BIOM 231,A00,881485,Daneman; Richard & Newton; Alexandra C.,0,0,0,0
1739701542987,BIOM 231,B00,881487,Staff,0,0,0,0
1739701542987,BIOM 231,C00,881488,Schoeneberg; Johannes,0,0,0,0
1739701544066,BIOM 234,A00,881480,Newton; Alexandra C.,0,0,0,0
1739701545093,BIOM 242,A00,806624,Hamilton; Bruce Alan,0,0,0,0
1739701546118,BIOM 246,A00,872559,Gordts; Philip & Lewis; Amanda Lark & Godula; Kamil & Gagneux; Pascal & Esko; Jeffrey D. & Bode; Lars,0,0,0,0
1739701547143,BIOM 252,A00,806625,Ayyagari; Radha,7,0,20,13
1739701548170,BIOM 283,A00,806628,Ghassemian; Majid,0,0,0,0
1739701549194,BIOM 295,A00,806638,Joiner; William J.,0,0,0,0
1739701550223,BIPN 100,A01,860405,Augustine; Vineet,32,0,36,4
1739701550223,BIPN 100,A02,860406,Augustine; Vineet,35,0,36,1
1739701550223,BIPN 100,A03,860407,Augustine; Vineet,35,0,36,1
1739701550223,BIPN 100,A04,860408,Augustine; Vineet,36,0,37,1
1739701550223,BIPN 100,B01,860409,George; Monique Leana,27,0,36,9
1739701550223,BIPN 100,B02,860410,George; Monique Leana,33,0,36,3
1739701550223,BIPN 100,B03,860411,George; Monique Leana,31,0,36,5
1739701550223,BIPN 100,B04,860412,George; Monique Leana,31,0,37,6
1739701550223,BIPN 100,C01,860413,Maita; Isabella Vincenza,36,0,36,0
1739701550223,BIPN 100,C02,860414,Maita; Isabella Vincenza,35,0,36,1
1739701550223,BIPN 100,C03,860415,Maita; Isabella Vincenza,33,0,36,3
1739701550223,BIPN 100,C04,860416,Maita; Isabella Vincenza,36,0,37,1
1739701550223,BIPN 100,D01,860417,Marino; Marc J,47,0,50,3
1739701550223,BIPN 100,D02,860418,Marino; Marc J,48,0,50,2
1739701550223,BIPN 100,D03,860419,Marino; Marc J,48,0,50,2
1739701550223,BIPN 100,D04,860420,Marino; Marc J,50,0,50,0
1739701550223,BIPN 100,E01,860421,Yang; Mingyu,36,0,36,0
1739701550223,BIPN 100,E02,860422,Yang; Mingyu,34,0,36,2
1739701550223,BIPN 100,E03,860423,Yang; Mingyu,36,0,36,0
1739701550223,BIPN 100,E04,860424,Yang; Mingyu,37,0,37,0
1739701551251,BIPN 102,A01,851476,Reyes Gonzalez; Catalina,45,0,54,9
1739701551251,BIPN 102,A02,851477,Reyes Gonzalez; Catalina,48,0,54,6
1739701551251,BIPN 102,A03,851478,Reyes Gonzalez; Catalina,53,0,54,1
1739701551251,BIPN 102,A04,851479,Reyes Gonzalez; Catalina,51,0,54,3
1739701552277,BIPN 105,A01,851482,Armour; Jon Christopher,13,0,21,8
1739701552277,BIPN 105,A02,851483,Armour; Jon Christopher,20,0,21,1
1739701552277,BIPN 105,B01,851487,Armour; Jon Christopher,10,0,21,11
1739701552277,BIPN 105,B02,851488,Armour; Jon Christopher,20,0,21,1
1739701553303,BIPN 140,A01,851492,Owens; Melinda Tsao-Ying,37,0,40,3
1739701553303,BIPN 140,A02,851493,Owens; Melinda Tsao-Ying,38,0,40,2
1739701553303,BIPN 140,A03,851494,Owens; Melinda Tsao-Ying,39,0,40,1
1739701553303,BIPN 140,A04,851495,Owens; Melinda Tsao-Ying,32,0,38,6
1739701554333,BIPN 144,A01,851498,Zou; Yimin,35,0,40,5
1739701554333,BIPN 144,A02,851499,Zou; Yimin,35,0,40,5
1739701554333,BIPN 144,A03,851500,Zou; Yimin,40,0,40,0
1739701554333,BIPN 144,A04,851501,Zou; Yimin,37,0,38,1
1739701555360,BIPN 145,A01,851505,Maita; Isabella Vincenza,33,0,42,9
1739701555360,BIPN 145,B01,851507,Juavinett; Ashley Lauren,36,0,42,6
1739701555360,BIPN 145,C01,851512,Marino; Marc J,34,0,42,8
1739701556390,BIPN 147,A01,851516,Sejnowski; Terrence J,5,0,16,11
1739701556390,BIPN 147,A02,851517,Sejnowski; Terrence J,16,0,16,0
1739701556390,BIPN 147,A03,851520,Sejnowski; Terrence J,13,0,16,3
1739701556390,BIPN 147,A04,851521,Sejnowski; Terrence J,14,0,16,2
1739701557417,BIPN 152,A01,860841,Halpain; Shelley,32,0,44,12
1739701557417,BIPN 152,A02,860842,Halpain; Shelley,43,0,44,1
1739701557417,BIPN 152,A03,860843,Halpain; Shelley,42,0,44,2
1739701557417,BIPN 152,A04,860844,Halpain; Shelley,40,0,43,3
1739701558446,BIPN 162,A01,851524,Aoi; Mikio C,7,0,8,1
1739701558446,BIPN 162,A02,851525,Aoi; Mikio C,7,0,8,1
1739701558446,BIPN 162,A03,851527,Aoi; Mikio C,6,0,8,2
1739701558446,BIPN 162,A04,851529,Aoi; Mikio C,6,0,6,0
1739701559475,BIPN 164,A01,851531,Benna; Marcus K & Aljadeff; Johnatan,13,0,14,1
1739701559475,BIPN 164,A02,851532,Benna; Marcus K & Aljadeff; Johnatan,13,0,14,1
1739701559475,BIPN 164,A03,851533,Benna; Marcus K & Aljadeff; Johnatan,13,0,14,1
1739701559475,BIPN 164,A04,851535,Benna; Marcus K & Aljadeff; Johnatan,12,0,12,0
1739701560503,BIPN 194,A00,851536,Glasgow; Stacey Marie,29,0,32,3
1739701560503,BIPN 194,B00,851537,Augustine; Vineet,28,0,32,4
1739701560503,BIPN 194,C00,851539,Reinagel; Pam,31,0,32,1
1739701561527,BISP 170,A00,851540,French; Kathleen Ann,28,0,30,2
1739701562555,BISP 182,A00,869152,Pogliano; Joseph,9999,0,9999,0
1739701563581,BISP 194,A00,851542,Greenspan; Ralph J.,10,0,32,22
1739701563581,BISP 194,B00,851543,Nguyen; Vu Quang,25,0,32,7
1739701563581,BISP 194,C00,869153,Patrick; Gentry,23,0,32,9
1739701564606,BNFO 281,A00,805637,Gaasterland; Theresa,94,0,100,6
1739701565632,BNFO 283,A00,805640,Chavez; Alejandro & D'Antonio; Matteo,48,0,50,2
1739701565632,BNFO 283,B00,805642,Carter; Hannah Kathryn & Sanchez Roige; Alexandra,47,0,50,3
1739701566657,BNFO 285,A00,805666,Alexandrov; Ludmil B,6,0,8,2
1739701567683,BNFO 294,A01,805680,Ross; Camille,49,0,50,1
1739701568723,CAT 3,A01,813335,Marchisotto; Jennifer Anne,16,0,16,0
1739701568723,CAT 3,A02,813336,Marchisotto; Jennifer Anne,16,0,16,0
1739701568723,CAT 3,A03,813341,Marchisotto; Jennifer Anne,8,0,16,8
1739701568723,CAT 3,A04,813343,Marchisotto; Jennifer Anne,12,0,16,4
1739701568723,CAT 3,A05,813345,Marchisotto; Jennifer Anne,16,0,16,0
1739701568723,CAT 3,A06,813346,Marchisotto; Jennifer Anne,12,0,16,4
1739701568723,CAT 3,A07,813347,Marchisotto; Jennifer Anne,15,0,16,1
1739701568723,CAT 3,A08,813349,Marchisotto; Jennifer Anne,15,0,16,1
1739701568723,CAT 3,A09,813350,Marchisotto; Jennifer Anne,16,0,16,0
1739701568723,CAT 3,A10,813365,Marchisotto; Jennifer Anne,15,0,16,1
1739701568723,CAT 3,A11,813366,Marchisotto; Jennifer Anne,5,0,16,11
1739701568723,CAT 3,A12,813384,Marchisotto; Jennifer Anne,16,0,16,0
1739701568723,CAT 3,A13,813385,Marchisotto; Jennifer Anne,16,0,16,0
1739701568723,CAT 3,A14,813434,Marchisotto; Jennifer Anne,15,0,16,1
1739701568723,CAT 3,B01,813444,Popko; Elizabeth Ashley,16,0,16,0
1739701568723,CAT 3,B02,813445,Popko; Elizabeth Ashley,12,0,16,4
1739701568723,CAT 3,B03,813464,Popko; Elizabeth Ashley,14,0,16,2
1739701568723,CAT 3,B04,813465,Popko; Elizabeth Ashley,7,0,16,9
1739701568723,CAT 3,B05,813466,Popko; Elizabeth Ashley,12,0,16,4
1739701568723,CAT 3,B06,813475,Popko; Elizabeth Ashley,13,0,16,3
1739701568723,CAT 3,B07,813531,Popko; Elizabeth Ashley,15,0,16,1
1739701568723,CAT 3,B08,813538,Popko; Elizabeth Ashley,15,0,16,1
1739701568723,CAT 3,B09,813539,Popko; Elizabeth Ashley,11,0,16,5
1739701568723,CAT 3,B10,813543,Popko; Elizabeth Ashley,12,0,16,4
1739701568723,CAT 3,B11,813545,Popko; Elizabeth Ashley,16,0,16,0
1739701568723,CAT 3,B12,813551,Popko; Elizabeth Ashley,16,0,16,0
1739701568723,CAT 3,B13,813552,Popko; Elizabeth Ashley,15,0,16,1
1739701568723,CAT 3,B14,813554,Popko; Elizabeth Ashley,16,0,16,0
1739701568723,CAT 3,B15,813556,Popko; Elizabeth Ashley,16,0,16,0
1739701568723,CAT 3,B16,813558,Popko; Elizabeth Ashley,16,0,16,0
1739701568723,CAT 3,C01,813564,Glaser; Amelia,15,0,16,1
1739701568723,CAT 3,C02,813578,Glaser; Amelia,13,0,16,3
1739701568723,CAT 3,C03,813602,Glaser; Amelia,4,0,16,12
1739701568723,CAT 3,C04,813604,Glaser; Amelia,3,0,16,13
1739701568723,CAT 3,C05,813606,Glaser; Amelia,14,0,16,2
1739701568723,CAT 3,C06,813607,Glaser; Amelia,14,0,16,2
1739701568723,CAT 3,C07,813609,Glaser; Amelia,14,0,16,2
1739701568723,CAT 3,C08,813611,Glaser; Amelia,16,0,16,0
1739701568723,CAT 3,C09,813613,Glaser; Amelia,15,0,16,1
1739701568723,CAT 3,C10,813614,Glaser; Amelia,13,0,16,3
1739701568723,CAT 3,C11,813617,Glaser; Amelia,14,0,16,2
1739701568723,CAT 3,C12,813618,Glaser; Amelia,16,0,16,0
1739701568723,CAT 3,C13,813622,Glaser; Amelia,15,0,16,1
1739701568723,CAT 3,C14,813623,Glaser; Amelia,15,0,16,1
1739701568723,CAT 3,D01,813625,Bigham; David Joseph,11,0,16,5
1739701568723,CAT 3,D02,813627,Bigham; David Joseph,8,0,16,8
1739701568723,CAT 3,D03,813632,Bigham; David Joseph,15,0,16,1
1739701568723,CAT 3,D04,813637,Bigham; David Joseph,15,0,16,1
1739701568723,CAT 3,D05,813641,Bigham; David Joseph,16,0,16,0
1739701568723,CAT 3,D06,813642,Bigham; David Joseph,15,0,16,1
1739701568723,CAT 3,D07,813644,Bigham; David Joseph,15,0,16,1
1739701568723,CAT 3,D08,813645,Bigham; David Joseph,15,0,16,1
1739701568723,CAT 3,D09,813648,Bigham; David Joseph,15,0,16,1
1739701568723,CAT 3,D10,813651,Bigham; David Joseph,16,0,16,0
1739701568723,CAT 3,D11,813654,Bigham; David Joseph,16,0,16,0
1739701568723,CAT 3,D12,813656,Bigham; David Joseph,16,0,16,0
1739701568723,CAT 3,D13,813657,Bigham; David Joseph,16,0,16,0
1739701568723,CAT 3,D14,813658,Bigham; David Joseph,16,0,16,0
1739701568723,CAT 3,D15,813662,Bigham; David Joseph,15,0,16,1
1739701568723,CAT 3,D16,813663,Bigham; David Joseph,16,0,16,0
1739701569749,CAT 3CE,A01,813665,Bronstein; Phoebe Malan,25,0,25,0
1739701570774,CAT 87,A00,813667,Bronstein; Phoebe Malan,20,0,20,0
1739701570774,CAT 87,B00,886854,Geibel; William,20,0,20,0
1739701571801,CAT 98,001,881482,Geibel; William,20,0,20,0
1739701572829,CAT 124,A01,813672,Geibel; William,20,0,20,0
1739701572829,CAT 124,B01,813675,Rose; Becca Rae,20,0,20,0
1739701573856,CAT 125,A00,813692,Marchisotto; Jennifer Anne,17,0,20,3
1739701573856,CAT 125,B00,813696,Bigham; David Joseph,18,0,20,2
1739701573856,CAT 125,C00,813698,Vanderschuit; Maya Alysia,20,0,20,0
1739701573856,CAT 125,D00,813700,Vanderschuit; Maya Alysia,20,0,20,0
1739701573856,CAT 125,E00,813703,Vanderschuit; Maya Alysia,20,0,20,0
1739701573856,CAT 125,F00,813711,Morales; Celeste Georgianna,19,0,20,1
1739701573856,CAT 125,G00,813714,Morales; Celeste Georgianna,18,0,20,2
1739701573856,CAT 125,H00,813717,Morales; Celeste Georgianna,20,0,20,0
1739701573856,CAT 125,I00,813720,Rose; Becca Rae,20,0,20,0
1739701573856,CAT 125,J00,813744,Rose; Becca Rae,19,0,20,1
1739701573856,CAT 125,K00,813761,Tosun; Adriana,18,0,20,2
1739701573856,CAT 125,L00,813762,Tosun; Adriana,19,0,20,1
1739701573856,CAT 125,M00,872512,Delaville; Romain,19,0,20,1
1739701573856,CAT 125,N00,872514,Irwin; Matthew Joseph,18,0,20,2
1739701573856,CAT 125,O00,872516,Irwin; Matthew Joseph,20,0,20,0
1739701573856,CAT 125,P00,872517,Irwin; Matthew Joseph,19,0,20,1
1739701574882,CAT 125R,A00,813763,Smith; Lauryn Alissa,17,0,20,3
1739701574882,CAT 125R,B00,813764,Smith; Lauryn Alissa,18,0,20,2
1739701574882,CAT 125R,C00,813765,Smith; Lauryn Alissa,20,0,20,0
1739701574882,CAT 125R,D00,813766,Hyland; Tina Mae,16,0,20,4
1739701574882,CAT 125R,E00,813767,Hyland; Tina Mae,15,0,20,5
1739701574882,CAT 125R,F00,813768,Hyland; Tina Mae,19,0,20,1
1739701574882,CAT 125R,G00,813769,Tosun; Adriana,17,0,20,3
1739701575916,CCE 1,A00,815913,Merryman; Ashley,39,0,40,1
1739701575916,CCE 1,D00,815916,Garcia; Kathryn Mary,39,0,40,1
1739701575916,CCE 1,E00,815918,Labat Ii; Michael Luis,36,0,40,4
1739701575916,CCE 1,F00,815919,Bigley; Michele Heather,39,0,40,1
1739701575916,CCE 1,G00,815921,Santos; Vabianna Daria,40,0,40,0
1739701575916,CCE 1,H00,815922,Lee; Kassandra,39,0,40,1
1739701576952,CCE 3,001,815923,Kenley; Nicole,15,0,20,5
1739701576952,CCE 3,002,815924,Quijada; David,19,0,20,1
1739701576952,CCE 3,003,815926,Crawford; James,20,0,20,0
1739701576952,CCE 3,004,815963,Williams; Danielle,20,0,20,0
1739701576952,CCE 3,005,815964,Merryman; Ashley,20,0,20,0
1739701576952,CCE 3,006,815965,Merryman; Ashley,20,0,20,0
1739701576952,CCE 3,007,815966,Lee; Kassandra,19,0,20,1
1739701576952,CCE 3,008,815967,Lee; Kassandra,20,0,20,0
1739701576952,CCE 3,009,816009,Garcia; Kathryn Mary,19,0,20,1
1739701576952,CCE 3,010,816011,Garcia; Kathryn Mary,19,0,20,1
1739701576952,CCE 3,011,816012,Labat Ii; Michael Luis,18,0,20,2
1739701576952,CCE 3,012,816013,Labat Ii; Michael Luis,20,0,20,0
1739701576952,CCE 3,013,816014,Bigley; Michele Heather,18,0,20,2
1739701576952,CCE 3,014,816015,Santos; Vabianna Daria,20,0,20,0
1739701576952,CCE 3,015,816016,Santos; Vabianna Daria,20,0,20,0
1739701576952,CCE 3,016,889148,Crawford; James,39,0,40,1
1739701577978,CENG 101B,A00,808970,Chen; Shaochen,50,0,50,0
1739701579004,CENG 101C,A00,808971,Li; Yanran,144,0,146,2
1739701580035,CENG 113,A00,808993,Li; Wan-Lu,67,0,70,3
1739701580035,CENG 113,B00,808994,Chen; Zheng,70,0,70,0
1739701581061,CENG 124B,A00,808995,Drews; Aaron,46,0,60,14
1739701581061,CENG 124B,B00,809012,Powell; Alyssa,51,0,60,9
1739701582086,CENG 160,A00,809013,Powell; Alyssa,65,0,70,5
1739701583111,CENG 170,A01,809059,Drews; Aaron,28,0,30,2
1739701584135,CENG 176B,A01,809097,Opatkiewicz; Justin Paul,55,0,60,5
1739701584135,CENG 176B,B01,809104,Shah; Nisarg,47,0,48,1
1739701585160,CENG 205,A00,809106,Jahed Motlagh; Zeinab,41,0,60,19
1739701586184,CENG 260,A00,809107,Powell; Alyssa,30,0,30,0
1739701587209,CENG 273,A00,809114,Shah; Nisarg,23,0,30,7
1739701588237,CGS 2B,A01,812749,Whitley; Leila Marie,23,0,25,2
1739701588237,CGS 2B,A02,812761,Whitley; Leila Marie,24,0,24,0
1739701589264,CGS 87,A00,812765,Wesling; Megan E.,20,0,20,0
1739701590289,CGS 100B,A00,812766,Whitley; Leila Marie,30,0,33,3
1739701591316,CGS 105,A01,812868,Wesling; Megan E.,22,0,23,1
1739701591316,CGS 105,A02,812869,Wesling; Megan E.,22,0,23,1
1739701591316,CGS 105,A03,812872,Wesling; Megan E.,23,0,23,0
1739701592341,CGS 106,A00,812873,Whitley; Leila Marie,46,0,50,4
1739701593370,CGS 112,A00,812902,Cuong; Marisol,30,0,30,0
1739701594395,CGS 114,A00,812906,Cuong; Marisol,20,0,22,2
1739701595420,CGS 117,A00,812907,Martin Sandino; Amanda Maria Yoland,13,0,16,3
1739701596447,CGS 120,A00,812908,Hankins; Joseph D.,21,0,22,1
1739701597470,CGS 121,A00,812916,Martin Sandino; Amanda Maria Yoland,20,0,20,0
1739701598496,CGS 122,A00,812917,Martin Sandino; Amanda Maria Yoland,19,0,20,1
1739701599522,CGS 147,A00,872913,Staff,20,0,20,0
1739701600551,CGS 196B,A00,812923,Taylor-Garcia; Daphne,0,0,0,0
1739701600551,CGS 196B,B00,812971,Hankins; Joseph D.,0,0,0,0
1739701600551,CGS 196B,C00,812978,Perez; Roy,0,0,0,0
1739701601579,CGS 198,001,812980,Anderson; Patrick W.,0,0,0,0
1739701601579,CGS 198,002,813054,Anderson; Patrick W.,0,0,0,0
1739701601579,CGS 198,003,813102,Anderson; Patrick W.,0,0,0,0
1739701601579,CGS 198,004,813257,Anderson; Patrick W.,0,0,0,0
1739701602604,CGS 200,A00,813286,Okonkwo; Holly,0,0,0,0
1739701603634,CHEM 6A,A01,860027,Lam; Tin Yiu,40,0,40,0
1739701603634,CHEM 6A,A02,860042,Lam; Tin Yiu,37,0,40,3
1739701603634,CHEM 6A,A03,860049,Lam; Tin Yiu,35,0,40,5
1739701603634,CHEM 6A,A04,860050,Lam; Tin Yiu,37,0,40,3
1739701603634,CHEM 6A,A05,860051,Lam; Tin Yiu,35,0,40,5
1739701603634,CHEM 6A,A06,860052,Lam; Tin Yiu,40,0,40,0
1739701603634,CHEM 6A,A07,860065,Lam; Tin Yiu,40,0,40,0
1739701603634,CHEM 6A,A08,860068,Lam; Tin Yiu,39,0,40,1
1739701604664,CHEM 6B,A01,859962,Lam; Tin Yiu,39,0,40,1
1739701604664,CHEM 6B,A02,859975,Lam; Tin Yiu,40,0,40,0
1739701604664,CHEM 6B,A03,859990,Lam; Tin Yiu,36,0,40,4
1739701604664,CHEM 6B,A04,859994,Lam; Tin Yiu,39,0,40,1
1739701604664,CHEM 6B,A05,859999,Lam; Tin Yiu,40,0,40,0
1739701604664,CHEM 6B,A06,860019,Lam; Tin Yiu,40,0,40,0
1739701604664,CHEM 6B,A07,860024,Lam; Tin Yiu,40,0,40,0
1739701604664,CHEM 6B,B01,861221,Zajac; Eva L,34,0,40,6
1739701604664,CHEM 6B,B02,861224,Zajac; Eva L,36,0,40,4
1739701604664,CHEM 6B,B03,861229,Zajac; Eva L,39,0,40,1
1739701604664,CHEM 6B,B04,861232,Zajac; Eva L,38,0,40,2
1739701604664,CHEM 6B,B05,861239,Zajac; Eva L,37,0,40,3
1739701604664,CHEM 6B,B06,861240,Zajac; Eva L,36,0,40,4
1739701604664,CHEM 6B,B07,861242,Zajac; Eva L,40,0,40,0
1739701605692,CHEM 6C,A01,861431,Hopkins; Patrycja Anna,35,0,40,5
1739701605692,CHEM 6C,A02,861466,Hopkins; Patrycja Anna,38,0,40,2
1739701605692,CHEM 6C,A03,861467,Hopkins; Patrycja Anna,40,0,40,0
1739701605692,CHEM 6C,A04,861530,Hopkins; Patrycja Anna,40,0,40,0
1739701605692,CHEM 6C,A05,861531,Hopkins; Patrycja Anna,38,0,40,2
1739701605692,CHEM 6C,A06,861622,Hopkins; Patrycja Anna,40,0,40,0
1739701605692,CHEM 6C,A07,861649,Hopkins; Patrycja Anna,39,0,40,1
1739701605692,CHEM 6C,A08,861650,Hopkins; Patrycja Anna,0,0,0,0
1739701605692,CHEM 6C,B01,861651,Zajac; Eva L,31,0,40,9
1739701605692,CHEM 6C,B02,861763,Zajac; Eva L,37,0,40,3
1739701605692,CHEM 6C,B03,861768,Zajac; Eva L,38,0,40,2
1739701605692,CHEM 6C,B04,861770,Zajac; Eva L,38,0,40,2
1739701605692,CHEM 6C,B05,861771,Zajac; Eva L,35,0,40,5
1739701605692,CHEM 6C,B06,861773,Zajac; Eva L,39,0,40,1
1739701605692,CHEM 6C,B07,861777,Zajac; Eva L,40,0,40,0
1739701605692,CHEM 6C,B08,861781,Zajac; Eva L,0,0,0,0
1739701605692,CHEM 6C,D01,859938,Stallings; Dontarie M,39,0,40,1
1739701605692,CHEM 6C,D02,859942,Stallings; Dontarie M,32,0,40,8
1739701605692,CHEM 6C,D03,859943,Stallings; Dontarie M,38,0,40,2
1739701605692,CHEM 6C,D04,859952,Stallings; Dontarie M,38,0,40,2
1739701605692,CHEM 6C,D05,859953,Stallings; Dontarie M,19,0,40,21
1739701605692,CHEM 6C,D06,859959,Stallings; Dontarie M,37,0,40,3
1739701605692,CHEM 6C,D07,859960,Stallings; Dontarie M,37,0,40,3
1739701605692,CHEM 6C,D08,859961,Stallings; Dontarie M,0,0,0,0
1739701605692,CHEM 6C,E01,861810,Debelouchina; Galia T,40,0,40,0
1739701605692,CHEM 6C,E02,861860,Debelouchina; Galia T,40,0,40,0
1739701605692,CHEM 6C,E03,861879,Debelouchina; Galia T,39,0,40,1
1739701605692,CHEM 6C,E04,861880,Debelouchina; Galia T,39,0,40,1
1739701605692,CHEM 6C,E05,861890,Debelouchina; Galia T,39,0,40,1
1739701605692,CHEM 6C,E06,861908,Debelouchina; Galia T,40,0,40,0
1739701605692,CHEM 6C,E07,861910,Debelouchina; Galia T,40,0,40,0
1739701605692,CHEM 6C,E08,861911,Debelouchina; Galia T,0,0,0,0
1739701606719,CHEM 6CH,A01,859928,Tezcan; Faik,39,0,40,1
1739701607748,CHEM 7L,A01,844470,Piercy; Marc Anthony,17,0,24,7
1739701607748,CHEM 7L,A02,844472,Piercy; Marc Anthony,21,0,24,3
1739701607748,CHEM 7L,A03,844473,Piercy; Marc Anthony,22,0,24,2
1739701607748,CHEM 7L,A04,844475,Piercy; Marc Anthony,24,0,24,0
1739701607748,CHEM 7L,A05,844476,Piercy; Marc Anthony,23,0,24,1
1739701607748,CHEM 7L,A06,844482,Piercy; Marc Anthony,22,0,24,2
1739701607748,CHEM 7L,A07,844490,Piercy; Marc Anthony,20,0,24,4
1739701607748,CHEM 7L,A08,844493,Piercy; Marc Anthony,24,0,24,0
1739701607748,CHEM 7L,A09,844496,Piercy; Marc Anthony,23,0,24,1
1739701607748,CHEM 7L,A10,844503,Piercy; Marc Anthony,24,0,24,0
1739701607748,CHEM 7L,B01,844506,Piercy; Marc Anthony,2,0,24,22
1739701607748,CHEM 7L,B02,844508,Piercy; Marc Anthony,23,0,24,1
1739701607748,CHEM 7L,B03,844661,Piercy; Marc Anthony,22,0,24,2
1739701607748,CHEM 7L,B04,844716,Piercy; Marc Anthony,24,0,24,0
1739701607748,CHEM 7L,B05,844717,Piercy; Marc Anthony,21,0,24,3
1739701607748,CHEM 7L,B06,844719,Piercy; Marc Anthony,22,0,24,2
1739701607748,CHEM 7L,B07,844841,Piercy; Marc Anthony,24,0,24,0
1739701607748,CHEM 7L,B08,845021,Piercy; Marc Anthony,23,0,24,1
1739701607748,CHEM 7L,B09,845022,Piercy; Marc Anthony,23,0,24,1
1739701607748,CHEM 7L,B10,845184,Piercy; Marc Anthony,24,0,24,0
1739701608779,CHEM 7LM,A01,845187,Leigh; Brian,24,0,24,0
1739701608779,CHEM 7LM,A02,845321,Leigh; Brian,21,0,21,0
1739701608779,CHEM 7LM,A03,845322,Leigh; Brian,24,0,24,0
1739701608779,CHEM 7LM,A04,845340,Leigh; Brian,19,0,21,2
1739701608779,CHEM 7LM,A05,845350,Leigh; Brian,23,0,24,1
1739701608779,CHEM 7LM,A06,845398,Leigh; Brian,21,0,21,0
1739701608779,CHEM 7LM,A07,845399,Leigh; Brian,18,0,24,6
1739701608779,CHEM 7LM,A08,845406,Leigh; Brian,20,0,21,1
1739701609804,CHEM 11,A01,861914,Albizati; Kim F.,37,0,40,3
1739701609804,CHEM 11,A02,861934,Albizati; Kim F.,38,0,40,2
1739701609804,CHEM 11,A03,861939,Albizati; Kim F.,40,0,40,0
1739701609804,CHEM 11,A04,861940,Albizati; Kim F.,40,0,40,0
1739701609804,CHEM 11,A05,861951,Albizati; Kim F.,36,0,40,4
1739701609804,CHEM 11,A06,861975,Albizati; Kim F.,40,0,40,0
1739701610832,CHEM 40A,A01,861976,Hopkins; Patrycja Anna,32,0,40,8
1739701610832,CHEM 40A,A02,861977,Hopkins; Patrycja Anna,36,0,40,4
1739701610832,CHEM 40A,A03,861978,Hopkins; Patrycja Anna,37,0,40,3
1739701610832,CHEM 40A,A04,862061,Hopkins; Patrycja Anna,38,0,40,2
1739701610832,CHEM 40A,A05,862062,Hopkins; Patrycja Anna,38,0,40,2
1739701610832,CHEM 40A,A06,862063,Hopkins; Patrycja Anna,37,0,40,3
1739701610832,CHEM 40A,A07,862064,Hopkins; Patrycja Anna,39,0,40,1
1739701610832,CHEM 40A,A08,862065,Hopkins; Patrycja Anna,37,0,40,3
1739701611862,CHEM 40B,A01,862066,Weizman; Haim,29,0,40,11
1739701611862,CHEM 40B,A02,862067,Weizman; Haim,38,0,40,2
1739701611862,CHEM 40B,A03,862077,Weizman; Haim,40,0,40,0
1739701611862,CHEM 40B,A04,862085,Weizman; Haim,37,0,40,3
1739701611862,CHEM 40B,A05,862086,Weizman; Haim,34,0,40,6
1739701611862,CHEM 40B,A06,862087,Weizman; Haim,40,0,40,0
1739701611862,CHEM 40B,A07,862088,Weizman; Haim,39,0,40,1
1739701611862,CHEM 40B,A08,862089,Weizman; Haim,0,0,0,0
1739701612890,CHEM 41B,A01,860069,Klosterman; Jeremy K,32,0,40,8
1739701612890,CHEM 41B,A02,860074,Klosterman; Jeremy K,38,0,40,2
1739701612890,CHEM 41B,A03,860081,Klosterman; Jeremy K,39,0,40,1
1739701613917,CHEM 41C,A01,862090,Romero; Nathan A,39,0,40,1
1739701613917,CHEM 41C,A02,862091,Romero; Nathan A,40,0,40,0
1739701613917,CHEM 41C,A03,862092,Romero; Nathan A,39,0,40,1
1739701613917,CHEM 41C,A04,862213,Romero; Nathan A,39,0,40,1
1739701613917,CHEM 41C,A05,862214,Romero; Nathan A,38,0,40,2
1739701613917,CHEM 41C,A06,862215,Romero; Nathan A,40,0,40,0
1739701613917,CHEM 41C,A07,862216,Romero; Nathan A,38,0,40,2
1739701614946,CHEM 43A,A01,845450,Ternansky; Robert J.,15,0,24,9
1739701614946,CHEM 43A,A02,845676,Ternansky; Robert J.,21,0,24,3
1739701614946,CHEM 43A,A03,845679,Ternansky; Robert J.,21,0,24,3
1739701614946,CHEM 43A,A04,845682,Ternansky; Robert J.,23,0,24,1
1739701614946,CHEM 43A,A05,845684,Ternansky; Robert J.,22,0,24,2
1739701614946,CHEM 43A,A06,845686,Ternansky; Robert J.,19,0,24,5
1739701614946,CHEM 43A,A07,845692,Ternansky; Robert J.,22,0,24,2
1739701614946,CHEM 43A,A08,845694,Ternansky; Robert J.,17,0,24,7
1739701614946,CHEM 43A,A09,845697,Ternansky; Robert J.,24,0,24,0
1739701614946,CHEM 43A,A10,845698,Ternansky; Robert J.,23,0,24,1
1739701614946,CHEM 43A,A11,845700,Ternansky; Robert J.,23,0,24,1
1739701614946,CHEM 43A,A12,845702,Ternansky; Robert J.,24,0,24,0
1739701614946,CHEM 43A,A13,845704,Ternansky; Robert J.,22,0,24,2
1739701614946,CHEM 43A,B01,845707,Ternansky; Robert J.,23,0,24,1
1739701614946,CHEM 43A,B02,845712,Ternansky; Robert J.,22,0,24,2
1739701614946,CHEM 43A,B03,845794,Ternansky; Robert J.,14,0,24,10
1739701614946,CHEM 43A,B04,845797,Ternansky; Robert J.,20,0,24,4
1739701614946,CHEM 43A,B05,845800,Ternansky; Robert J.,22,0,24,2
1739701614946,CHEM 43A,B06,845801,Ternansky; Robert J.,20,0,24,4
1739701614946,CHEM 43A,B07,845816,Ternansky; Robert J.,21,0,24,3
1739701614946,CHEM 43A,B08,845817,Ternansky; Robert J.,19,0,24,5
1739701614946,CHEM 43A,B09,845827,Ternansky; Robert J.,23,0,24,1
1739701614946,CHEM 43A,B10,845832,Ternansky; Robert J.,22,0,24,2
1739701614946,CHEM 43A,B11,845866,Ternansky; Robert J.,22,0,24,2
1739701614946,CHEM 43A,B12,845867,Ternansky; Robert J.,21,0,24,3
1739701615970,CHEM 96,A00,845868,Brydges; Stacey,18,0,20,2
1739701616995,CHEM 100A,A01,845921,Staff,0,0,0,0
1739701616995,CHEM 100A,A02,845922,Staff,0,0,0,0
1739701616995,CHEM 100A,A03,845983,Staff,0,0,0,0
1739701616995,CHEM 100A,A04,845984,Staff,0,0,0,0
1739701616995,CHEM 100A,A05,845985,Staff,0,0,0,0
1739701616995,CHEM 100A,A06,845986,Staff,0,0,0,0
1739701618022,CHEM 100B,A01,845988,Pomeroy; Robert S.,27,0,30,3
1739701619047,CHEM 105A,A01,845991,Young; Mark,33,0,40,7
1739701620073,CHEM 108,A01,845993,Mrse; Anthony Adrian,18,0,20,2
1739701620073,CHEM 108,A02,845994,Mrse; Anthony Adrian,18,0,24,6
1739701620073,CHEM 108,B01,845996,Mrse; Anthony Adrian,16,0,20,4
1739701620073,CHEM 108,B02,845997,Mrse; Anthony Adrian,23,0,24,1
1739701621099,CHEM 109,A01,845999,McHugh; Colleen A,11,0,20,9
1739701621099,CHEM 109,A02,846000,McHugh; Colleen A,24,0,24,0
1739701621099,CHEM 109,B01,846002,McHugh; Colleen A,18,0,20,2
1739701621099,CHEM 109,B02,846003,McHugh; Colleen A,23,0,24,1
1739701622125,CHEM 114B,A01,862223,Mishanina; Tatiana V,37,0,40,3
1739701622125,CHEM 114B,A02,862224,Mishanina; Tatiana V,40,0,40,0
1739701622125,CHEM 114B,A03,862225,Mishanina; Tatiana V,40,0,40,0
1739701623149,CHEM 114C,A01,859769,Joseph; Simpson,35,0,40,5
1739701623149,CHEM 114C,A02,859782,Joseph; Simpson,29,0,40,11
1739701623149,CHEM 114C,A03,859790,Joseph; Simpson,25,0,40,15
1739701623149,CHEM 114C,A04,859791,Joseph; Simpson,40,0,40,0
1739701623149,CHEM 114C,A05,859793,Joseph; Simpson,37,0,40,3
1739701623149,CHEM 114C,A06,859804,Joseph; Simpson,37,0,40,3
1739701623149,CHEM 114C,A07,859805,Joseph; Simpson,0,0,0,0
1739701623149,CHEM 114C,A08,859810,Joseph; Simpson,0,0,0,0
1739701624174,CHEM 114D,A00,846006,Ghosh; Gourisankar,19,0,25,6
1739701625200,CHEM 118,A01,862235,Donoghue; Daniel J.,28,0,40,12
1739701625200,CHEM 118,A02,862236,Donoghue; Daniel J.,38,0,40,2
1739701625200,CHEM 118,A03,862238,Donoghue; Daniel J.,28,0,40,12
1739701625200,CHEM 118,A04,862240,Donoghue; Daniel J.,39,0,40,1
1739701625200,CHEM 118,A05,862242,Donoghue; Daniel J.,39,0,40,1
1739701625200,CHEM 118,A06,862243,Donoghue; Daniel J.,39,0,40,1
1739701626224,CHEM 120B,A01,859811,Staff,32,0,40,8
1739701626224,CHEM 120B,A02,859812,Staff,39,0,40,1
1739701626224,CHEM 120B,A03,859813,Staff,0,0,0,0
1739701627250,CHEM 123,A00,846009,Schimpf; Alina M,0,0,0,2
1739701628274,CHEM 125,A00,846010,Tezcan; Faik,17,0,20,3
1739701629298,CHEM 126B,A01,859888,Tauber; Michael,27,0,40,13
1739701629298,CHEM 126B,A02,859927,Tauber; Michael,0,0,0,0
1739701630324,CHEM 132,A01,862270,Tauber; Michael,39,0,40,1
1739701630324,CHEM 132,A02,862271,Tauber; Michael,36,0,40,4
1739701631349,CHEM 135,A01,860846,Xiong; Wei,14,0,15,1
1739701632374,CHEM 143B,A01,846015,Klosterman; Jeremy K,20,0,24,4
1739701632374,CHEM 143B,A02,846016,Klosterman; Jeremy K,15,0,24,9
1739701633403,CHEM 156,A00,846017,Romero; Erik Anthony,29,0,30,1
1739701634428,CHEM 157,A00,846018,Tor; Yitzhak,74,0,80,6
1739701635453,CHEM 158,A00,846020,Molinski; Tadeusz,9,0,10,1
1739701636478,CHEM 167,A01,862285,Deshmukh; Lalit,36,0,40,4
1739701636478,CHEM 167,A02,862286,Deshmukh; Lalit,39,0,40,1
1739701636478,CHEM 167,A03,862287,Deshmukh; Lalit,37,0,40,3
1739701636478,CHEM 167,A04,862288,Deshmukh; Lalit,39,0,40,1
1739701637503,CHEM 173,A00,846023,Young; Mark,36,0,40,4
1739701638527,CHEM 174,A01,851594,Pomeroy; Robert S.,58,0,60,2
1739701639551,CHEM 185,A00,846025,Paesani; Francesco,21,0,26,5
1739701640576,CHEM 188,A00,846026,Brydges; Stacey,20,0,20,0
1739701641603,CHEM 207,A00,846088,Deshmukh; Lalit,23,0,30,7
1739701642628,CHEM 214,A00,846089,Ghosh; Gourisankar,5,0,15,10
1739701643655,CHEM 217,A00,846092,Joseph; Simpson,15,0,30,15
1739701644682,CHEM 225,A00,846095,Tezcan; Faik,6,0,10,4
1739701645710,CHEM 227,A00,846097,Schimpf; Alina M,30,0,30,0
1739701646735,CHEM 229,A00,846100,Stauber; Julia Megan,19,0,20,1
1739701647814,CHEM 235,A01,860847,Xiong; Wei,17,0,20,3
1739701648838,CHEM 236,A00,846106,Kummel; Andrew C,5,0,15,10
1739701649864,CHEM 237,A00,872555,Esko; Jeffrey D.,7,0,7,0
1739701650888,CHEM 250,A00,846107,Weizman; Haim,0,0,0,0
1739701651914,CHEM 256,A00,846108,Romero; Erik Anthony,20,0,20,0
1739701652943,CHEM 257,A00,846109,Tor; Yitzhak,28,0,30,2
1739701653972,CHEM 258,A00,846110,Molinski; Tadeusz,14,0,15,1
1739701655000,CHEM 262,A00,846111,Kubiak; Clifford Paul,26,0,30,4
1739701656024,CHEM 273,A00,846118,Young; Mark,15,0,20,5
1739701657052,CHEM 276,A00,846119,Mc Culloch; Andrew Douglas,4,0,5,1
1739701658079,CHEM 283,A00,846120,Ghassemian; Majid,10,0,10,0
1739701659104,CHEM 285,A00,846121,Paesani; Francesco,19,0,20,1
1739701660129,CHEM 291,A00,846122,Debelouchina; Galia T,20,0,20,0
1739701661154,CHEM 294,A00,846123,Pun; Andrew Brian,48,0,50,2
1739701662179,CHIN 10CD,A01,809156,Liu; Mingming,17,0,17,0
1739701662179,CHIN 10CD,A02,809192,Liu; Mingming,18,0,18,0
1739701663203,CHIN 10CM,A01,809196,Chen; Pei-Chia,15,0,15,0
1739701663203,CHIN 10CM,A02,809197,Chen; Pei-Chia,19,0,20,1
1739701664230,CHIN 10CN,A01,809203,Xu; Li,12,0,14,2
1739701664230,CHIN 10CN,A03,809218,Xu; Li,14,0,14,0
1739701664230,CHIN 10CN,B01,809296,Xu; Li,13,0,14,1
1739701664230,CHIN 10CN,B02,809307,Xu; Li,10,0,14,4
1739701664230,CHIN 10CN,B03,809361,Xu; Li,14,0,14,0
1739701665259,CHIN 20CM,A01,809437,Wang; Xiao,10,0,10,0
1739701665259,CHIN 20CM,A02,809458,Wang; Xiao,10,0,10,0
1739701666290,CHIN 20CN,A01,809462,Anderson; Qin-Hong,12,0,12,0
1739701666290,CHIN 20CN,A02,809463,Anderson; Qin-Hong,12,0,12,0
1739701666290,CHIN 20CN,A03,871383,Anderson; Qin-Hong,12,0,12,0
1739701666290,CHIN 20CN,B01,809488,Anderson; Qin-Hong,12,0,12,0
1739701667318,CHIN 100CM,A00,809489,Anderson; Qin-Hong,23,0,24,1
1739701668343,CHIN 100CN,A00,809490,Chen; Pei-Chia,24,0,24,0
1739701669367,CHIN 169B,A00,809720,Wang; Xiao,20,0,20,0
1739701670392,CHIN 182B,A00,809728,Liu; Mingming,17,0,20,3
1739701671416,CLAS 196B,A00,869154,Myerston Santana; Jacobo,1,0,1,0
1739701672442,CLIN 294C,A00,870690,Wierenga; Christina E & Banks; Sarah Jane,20,0,20,0
1739701673471,CLIN 296,001,870694,Brookman; Lauren Irene,100,0,100,0
1739701673471,CLIN 296,002,870695,Brookman; Lauren Irene,10,0,10,0
1739701673471,CLIN 296,003,870696,Wall; Tamara Lynn,100,0,100,0
1739701674497,CLRE 238R,A00,809924,Mehta; Ravindra L.,9999,0,9999,0
1739701675522,CLRE 254,A00,809952,Vaida; Florin,9999,0,9999,0
1739701676549,CLRE 255,A01,809989,Cuomo; Raphael Eduardo,9999,0,9999,0
1739701677578,CLRE 256,A01,810211,Morris; Sheldon,9999,0,9999,0
1739701678603,CLRE 257,A00,810214,Mehta; Ravindra L.,9999,0,9999,0
1739701679631,CLRE 258,A00,810216,Mehta; Ravindra L.,9999,0,9999,0
1739701680659,CLRE 260,A00,810217,Cuomo; Raphael Eduardo,9999,0,9999,0
1739701681686,CLRE 265,A00,810220,Vaida; Florin,9999,0,9999,0
1739701682712,CLRE 297,001,810222,Cuomo; Raphael Eduardo,9999,0,9999,0
1739701683737,CLX 87,A00,809115,Castro; Robert Jess,20,0,20,0
1739701684760,CMM 225,A00,872556,Esko; Jeffrey D.,7,0,7,0
1739701685785,CMM 246,A00,872560,Gordts; Philip & Lewis; Amanda Lark & Godula; Kamil & Gagneux; Pascal & Esko; Jeffrey D. & Bode; Lars,10,0,10,0
1739701686813,CMM 250,A00,884466,Willert; Karl Heinrich,60,0,60,0
1739701687840,COGR 201D,A00,808201,Serlin; David,10,0,10,0
1739701688868,COGR 219,A00,808207,Harb; Anthony Joseph,5,0,10,5
1739701689895,COGR 225B,A00,808212,Gere; Catherina M.,10,0,10,0
1739701690920,COGR 225C,A00,808214,McKenzie; Kerry V.,10,0,10,0
1739701691946,COGR 275,A00,808219,Jack; Caroline Sarah,8,0,10,2
1739701692971,COGR 296,A00,808221,Ybarra; Megan,5,0,5,0
1739701693996,COGS 1,A01,810294,Deak; Gedeon O.,58,0,60,2
1739701693996,COGS 1,A02,810296,Deak; Gedeon O.,57,0,60,3
1739701693996,COGS 1,A03,810298,Deak; Gedeon O.,56,0,60,4
1739701693996,COGS 1,A04,810299,Deak; Gedeon O.,57,0,60,3
1739701693996,COGS 1,A05,810300,Deak; Gedeon O.,60,0,60,0
1739701693996,COGS 1,A06,810301,Deak; Gedeon O.,59,0,60,1
1739701693996,COGS 1,A07,810302,Deak; Gedeon O.,57,0,57,0
1739701695023,COGS 2,A01,810304,Boyle; Mary E. T.,54,0,56,2
1739701695023,COGS 2,A02,810305,Boyle; Mary E. T.,56,0,56,0
1739701695023,COGS 2,A03,810307,Boyle; Mary E. T.,54,0,56,2
1739701695023,COGS 2,A04,810309,Boyle; Mary E. T.,57,0,60,3
1739701695023,COGS 2,A05,810310,Boyle; Mary E. T.,67,0,67,0
1739701696048,COGS 9,A01,810312,Shannon; Kyle Michael,49,0,50,1
1739701696048,COGS 9,A02,810313,Shannon; Kyle Michael,49,0,50,1
1739701696048,COGS 9,A03,810314,Shannon; Kyle Michael,49,0,50,1
1739701696048,COGS 9,A04,810316,Shannon; Kyle Michael,50,0,50,0
1739701696048,COGS 9,A05,810320,Shannon; Kyle Michael,50,0,50,0
1739701696048,COGS 9,A06,810321,Shannon; Kyle Michael,49,0,50,1
1739701697076,COGS 11,A01,810324,Boroditsky; Lera,134,0,140,6
1739701698106,COGS 13,A01,810328,Rossano; Federico,42,0,50,8
1739701698106,COGS 13,A02,810329,Rossano; Federico,48,0,49,1
1739701698106,COGS 13,A03,810330,Rossano; Federico,48,0,50,2
1739701698106,COGS 13,A04,810331,Rossano; Federico,48,0,49,1
1739701698106,COGS 13,A05,810332,Rossano; Federico,48,0,49,1
1739701698106,COGS 13,A06,810333,Rossano; Federico,49,0,49,0
1739701699132,COGS 14A,A01,810335,Barrera; Steven James,45,0,50,5
1739701699132,COGS 14A,A02,810336,Barrera; Steven James,47,0,50,3
1739701699132,COGS 14A,A03,810338,Barrera; Steven James,49,0,50,1
1739701699132,COGS 14A,A04,810339,Barrera; Steven James,56,0,60,4
1739701699132,COGS 14A,A05,810340,Barrera; Steven James,50,0,50,0
1739701699132,COGS 14A,A06,810341,Barrera; Steven James,50,0,50,0
1739701699132,COGS 14A,A07,810343,Barrera; Steven James,54,0,56,2
1739701700164,COGS 14B,A01,810346,Hoffman; Drew Ellen,54,0,57,3
1739701700164,COGS 14B,A02,810347,Hoffman; Drew Ellen,55,0,55,0
1739701700164,COGS 14B,A03,810348,Hoffman; Drew Ellen,52,0,55,3
1739701700164,COGS 14B,A04,810350,Hoffman; Drew Ellen,54,0,55,1
1739701700164,COGS 14B,A05,810351,Hoffman; Drew Ellen,53,0,55,2
1739701701194,COGS 17,A01,810353,Johnson; Christine M.,49,0,50,1
1739701701194,COGS 17,A02,810354,Johnson; Christine M.,48,0,50,2
1739701701194,COGS 17,A03,810356,Johnson; Christine M.,48,0,50,2
1739701701194,COGS 17,A04,810357,Johnson; Christine M.,47,0,50,3
1739701701194,COGS 17,A05,810359,Johnson; Christine M.,49,0,50,1
1739701701194,COGS 17,A06,810360,Johnson; Christine M.,50,0,50,0
1739701701194,COGS 17,A07,810361,Johnson; Christine M.,52,0,55,3
1739701701194,COGS 17,A08,810362,Johnson; Christine M.,54,0,55,1
1739701702222,COGS 18,A01,810366,Ellis; Shannon Elizabeth,31,0,35,4
1739701702222,COGS 18,A02,810367,Ellis; Shannon Elizabeth,31,0,35,4
1739701702222,COGS 18,A03,810371,Ellis; Shannon Elizabeth,30,0,35,5
1739701702222,COGS 18,A04,810372,Ellis; Shannon Elizabeth,34,0,35,1
1739701702222,COGS 18,A05,810373,Ellis; Shannon Elizabeth,32,0,35,3
1739701702222,COGS 18,A06,810374,Ellis; Shannon Elizabeth,35,0,35,0
1739701702222,COGS 18,A07,810375,Ellis; Shannon Elizabeth,35,0,35,0
1739701702222,COGS 18,A08,810376,Ellis; Shannon Elizabeth,34,0,35,1
1739701702222,COGS 18,A09,810377,Ellis; Shannon Elizabeth,35,0,35,0
1739701702222,COGS 18,B01,810379,Ellis; Shannon Elizabeth,33,0,35,2
1739701702222,COGS 18,B02,810384,Ellis; Shannon Elizabeth,34,0,35,1
1739701702222,COGS 18,B03,810385,Ellis; Shannon Elizabeth,34,0,35,1
1739701702222,COGS 18,B04,810388,Ellis; Shannon Elizabeth,34,0,35,1
1739701702222,COGS 18,B05,810389,Ellis; Shannon Elizabeth,31,0,35,4
1739701702222,COGS 18,B06,810390,Ellis; Shannon Elizabeth,31,0,35,4
1739701702222,COGS 18,B07,810392,Ellis; Shannon Elizabeth,34,0,35,1
1739701702222,COGS 18,B08,810393,Ellis; Shannon Elizabeth,34,0,35,1
1739701702222,COGS 18,B09,810395,Ellis; Shannon Elizabeth,32,0,35,3
1739701703247,COGS 87,A00,810426,Deak; Gedeon O.,20,0,20,0
1739701704271,COGS 100,A01,810564,Morgan; Eric,49,0,56,7
1739701704271,COGS 100,A02,810582,Morgan; Eric,54,0,56,2
1739701704271,COGS 100,A03,810589,Morgan; Eric,55,0,56,1
1739701704271,COGS 100,A04,810651,Morgan; Eric,54,0,56,2
1739701704271,COGS 100,A05,810684,Morgan; Eric,56,0,56,0
1739701704271,COGS 100,A06,810690,Morgan; Eric,54,0,56,2
1739701705297,COGS 101A,A01,810697,Morgan; Eric,49,0,50,1
1739701705297,COGS 101A,A02,810701,Morgan; Eric,49,0,50,1
1739701705297,COGS 101A,A03,810707,Morgan; Eric,49,0,50,1
1739701705297,COGS 101A,A04,810708,Morgan; Eric,50,0,50,0
1739701706322,COGS 101B,A01,810716,Barrera; Steven James,49,0,50,1
1739701706322,COGS 101B,A02,810718,Barrera; Steven James,45,0,50,5
1739701706322,COGS 101B,A03,810719,Barrera; Steven James,47,0,50,3
1739701706322,COGS 101B,A04,810730,Barrera; Steven James,38,0,50,12
1739701707350,COGS 101C,A01,810737,Cooperrider; Kensy A,50,0,50,0
1739701707350,COGS 101C,A02,810742,Cooperrider; Kensy A,43,0,50,7
1739701707350,COGS 101C,A03,810743,Cooperrider; Kensy A,48,0,50,2
1739701708376,COGS 102A,A01,810750,Allen; Michael Gordon,49,0,50,1
1739701708376,COGS 102A,A02,810751,Allen; Michael Gordon,50,0,50,0
1739701708376,COGS 102A,A03,810754,Allen; Michael Gordon,44,0,49,5
1739701709405,COGS 107A,A01,810756,Boyle; Mary E. T.,54,0,56,2
1739701709405,COGS 107A,A02,810757,Boyle; Mary E. T.,52,0,56,4
1739701709405,COGS 107A,A03,810760,Boyle; Mary E. T.,55,0,56,1
1739701709405,COGS 107A,A04,810767,Boyle; Mary E. T.,54,0,56,2
1739701709405,COGS 107A,A05,810769,Boyle; Mary E. T.,54,0,56,2
1739701709405,COGS 107A,A06,810777,Boyle; Mary E. T.,55,0,56,1
1739701710435,COGS 107B,A03,810800,Mooshagian; Eric Frederick,41,0,50,9
1739701710435,COGS 107B,A04,810810,Mooshagian; Eric Frederick,33,0,50,17
1739701710435,COGS 107B,A05,810811,Mooshagian; Eric Frederick,44,0,50,6
1739701711461,COGS 107C,A01,810815,Chiba; Andrea,41,0,47,6
1739701711461,COGS 107C,A02,810816,Chiba; Andrea,35,0,50,15
1739701711461,COGS 107C,A03,810853,Chiba; Andrea,44,0,49,5
1739701712489,COGS 108,A01,810862,Fleischer; Jason G,42,0,50,8
1739701712489,COGS 108,A02,810870,Fleischer; Jason G,42,0,50,8
1739701712489,COGS 108,A03,810871,Fleischer; Jason G,50,0,50,0
1739701712489,COGS 108,A04,810874,Fleischer; Jason G,49,0,50,1
1739701712489,COGS 108,A05,810876,Fleischer; Jason G,47,0,50,3
1739701712489,COGS 108,A06,810879,Fleischer; Jason G,48,0,50,2
1739701712489,COGS 108,A07,810896,Fleischer; Jason G,50,0,50,0
1739701712489,COGS 108,B01,810950,Fleischer; Jason G,54,0,56,2
1739701712489,COGS 108,B02,810960,Fleischer; Jason G,54,0,56,2
1739701712489,COGS 108,B03,810961,Fleischer; Jason G,52,0,56,4
1739701712489,COGS 108,B04,810962,Fleischer; Jason G,43,0,60,17
1739701712489,COGS 108,B05,810963,Fleischer; Jason G,58,0,60,2
1739701712489,COGS 108,B06,810964,Fleischer; Jason G,58,0,60,2
1739701712489,COGS 108,B07,810965,Fleischer; Jason G,62,0,62,0
1739701714542,COGS 112,A01,811001,Hoffman; Drew Ellen,33,0,50,17
1739701714542,COGS 112,A02,811020,Hoffman; Drew Ellen,42,0,50,8
1739701714542,COGS 112,A03,811045,Hoffman; Drew Ellen,44,0,50,6
1739701714542,COGS 112,A04,811047,Hoffman; Drew Ellen,49,0,50,1
1739701715568,COGS 124,A00,811065,Guo; Philip J,1,0,25,24
1739701716596,COGS 125,A00,811079,Klemmer; Scott R,43,0,50,7
1739701717620,COGS 142,A01,811081,Rossano; Federico,50,0,50,0
1739701718644,COGS 143,A01,811108,Staff,46,0,50,4
1739701719671,COGS 150,A01,811185,Trott; Sean Thomas,35,0,50,15
1739701719671,COGS 150,A02,811319,Trott; Sean Thomas,50,0,50,0
1739701719671,COGS 150,A03,811360,Trott; Sean Thomas,41,0,49,8
1739701720696,COGS 157,A00,811371,Creel; Sarah,66,0,75,9
1739701721723,COGS 160,A00,872440,Saygin; Ayse P,29,0,30,1
1739701721723,COGS 160,B00,872441,Saygin; Ayse P,30,0,30,0
1739701721723,COGS 160,C00,872442,Kirsh; David Joel,30,0,30,0
1739701722752,COGS 172,A01,811389,Greene; Deanna Jacquelyn,46,0,50,4
1739701722752,COGS 172,A02,811390,Greene; Deanna Jacquelyn,48,0,50,2
1739701722752,COGS 172,A03,811391,Greene; Deanna Jacquelyn,45,0,50,5
1739701722752,COGS 172,A04,811392,Greene; Deanna Jacquelyn,47,0,50,3
1739701724804,COGS 179,A01,811401,Staff,43,0,50,7
1739701725830,COGS 184,A01,811403,Johnson; Christine M.,46,0,50,4
1739701726856,COGS 185,A01,811514,Tu; Zhuowen,38,0,50,12
1739701726856,COGS 185,A02,811580,Tu; Zhuowen,46,0,50,4
1739701727883,COGS 187A,A01,811589,Allen; Michael Gordon,45,0,50,5
1739701727883,COGS 187A,A02,811590,Allen; Michael Gordon,46,0,50,4
1739701727883,COGS 187A,A03,811591,Allen; Michael Gordon,44,0,49,5
1739701728910,COGS 190C,001,811592,Chiba; Andrea,9999,0,9999,0
1739701728910,COGS 190C,002,811601,Fleischer; Jason G,9999,0,9999,0
1739701728910,COGS 190C,003,811602,Boyle; Mary E. T.,9999,0,9999,0
1739701728910,COGS 190C,004,811604,Nitz; Douglas A.,9999,0,9999,0
1739701728910,COGS 190C,005,811605,Rangel; Lara M,9999,0,9999,0
1739701728910,COGS 190C,006,811609,Hoffman; Drew Ellen,9999,0,9999,0
1739701728910,COGS 190C,007,811610,Deak; Gedeon O.,9999,0,9999,0
1739701728910,COGS 190C,008,811613,Kiyonaga; Anastasia,9999,0,9999,0
1739701728910,COGS 190C,009,811716,Creel; Sarah,9999,0,9999,0
1739701728910,COGS 190C,010,811733,Voytek; Bradley Thomas,9999,0,9999,0
1739701728910,COGS 190C,011,811836,Beatty-Martinez; Anne,9999,0,9999,0
1739701728910,COGS 190C,012,811838,De Sa; Virginia,9999,0,9999,0
1739701728910,COGS 190C,013,811839,Kirsh; David Joel,9999,0,9999,0
1739701728910,COGS 190C,014,811843,Jernigan; Terry Lynne,9999,0,9999,0
1739701728910,COGS 190C,015,811844,Tu; Zhuowen,9999,0,9999,0
1739701729935,COGS 190D,A00,811922,Voytek; Bradley Thomas,25,0,25,0
1739701730963,COGS 194,A00,811949,Hill; Seth J,9999,0,9999,0
1739701731989,COGS 202,A00,872444,Khosla; Meenakshi,12,0,25,13
1739701733015,COGS 205,A00,812100,Chiba; Andrea,20,0,20,0
1739701734041,COGS 209,A00,812101,Mukamel; Eran A,25,0,46,21
1739701735072,COGS 210C,A00,812186,Kirsh; David Joel,9999,0,9999,0
1739701735072,COGS 210C,B00,812192,Greene; Deanna Jacquelyn,9999,0,9999,0
1739701735072,COGS 210C,C00,812199,Xia; Haijun,9999,0,9999,0
1739701735072,COGS 210C,D00,812206,Nitz; Douglas A.,9999,0,9999,0
1739701735072,COGS 210C,E00,812207,Hollan; James D.,9999,0,9999,0
1739701735072,COGS 210C,F00,812260,De Sa; Virginia,9999,0,9999,0
1739701735072,COGS 210C,G00,812261,Rossano; Federico,9999,0,9999,0
1739701735072,COGS 210C,H00,812262,Kiyonaga; Anastasia,9999,0,9999,0
1739701735072,COGS 210C,I00,812263,Guo; Philip J,9999,0,9999,0
1739701735072,COGS 210C,J00,812264,Dow; Steven P,9999,0,9999,0
1739701735072,COGS 210C,K00,812265,Bergen; Benjamin,9998,0,9999,1
1739701735072,COGS 210C,L00,812266,Coulson; Seana M,9999,0,9999,0
1739701735072,COGS 210C,M00,812267,Rangel; Lara M,9999,0,9999,0
1739701736097,COGS 211C,A00,812268,Boroditsky; Lera,19,0,20,1
1739701737124,COGS 229,A00,812269,Irani; Lilly C & Shvartzberg Carrio; Manuel,10,0,10,0
1739701738153,COGS 231,A00,812270,Guo; Philip J,0,0,20,20
1739701739180,COGS 238,A00,812271,Bergen; Benjamin,18,0,20,2
1739701740210,COMM 10,A01,807316,Whitworth-Smith; Andrew C,22,0,23,1
1739701740210,COMM 10,A02,807320,Whitworth-Smith; Andrew C,23,0,23,0
1739701740210,COMM 10,A03,807321,Whitworth-Smith; Andrew C,23,0,23,0
1739701740210,COMM 10,A04,807324,Whitworth-Smith; Andrew C,23,0,23,0
1739701740210,COMM 10,A05,807328,Whitworth-Smith; Andrew C,17,0,23,6
1739701740210,COMM 10,A06,807329,Whitworth-Smith; Andrew C,21,0,23,2
1739701740210,COMM 10,A07,807330,Whitworth-Smith; Andrew C,21,0,23,2
1739701740210,COMM 10,A08,807333,Whitworth-Smith; Andrew C,21,0,22,1
1739701740210,COMM 10,A09,807334,Whitworth-Smith; Andrew C,23,0,23,0
1739701740210,COMM 10,A11,807363,Whitworth-Smith; Andrew C,0,0,0,0
1739701740210,COMM 10,A12,807364,Whitworth-Smith; Andrew C,0,0,0,0
1739701740210,COMM 10,A13,807366,Whitworth-Smith; Andrew C,23,0,23,0
1739701740210,COMM 10,A15,807374,Whitworth-Smith; Andrew C,0,0,0,0
1739701740210,COMM 10,A16,807427,Whitworth-Smith; Andrew C,23,0,23,0
1739701740210,COMM 10,A17,807428,Whitworth-Smith; Andrew C,23,0,23,0
1739701740210,COMM 10,A18,807429,Whitworth-Smith; Andrew C,0,0,0,0
1739701741236,COMM 20,A01,807435,Hill; Erin Truesdell,72,0,75,3
1739701742262,COMM 30,A00,807436,Metcalf; Kathryne Young,73,0,75,2
1739701743290,COMM 50,A00,807438,Armenta; John E,22,0,25,3
1739701744315,COMM 80,A01,807440,Campbell; Robert Harold,0,0,0,0
1739701745341,COMM 100B,A01,807446,Serlin; David,20,0,25,5
1739701745341,COMM 100B,A02,807447,Serlin; David,23,0,25,2
1739701745341,COMM 100B,A03,807450,Serlin; David,25,0,25,0
1739701745341,COMM 100B,A05,807453,Serlin; David,23,0,25,2
1739701745341,COMM 100B,A06,807454,Serlin; David,25,0,25,0
1739701745341,COMM 100B,A07,807455,Serlin; David,18,0,25,7
1739701745341,COMM 100B,A08,807458,Serlin; David,22,0,25,3
1739701745341,COMM 100B,A09,807459,Serlin; David,21,0,25,4
1739701745341,COMM 100B,A10,807462,Serlin; David,25,0,25,0
1739701745341,COMM 100B,A11,807464,Serlin; David,25,0,25,0
1739701746367,COMM 101,A01,807470,Davis; Zeinabu I.,15,0,15,0
1739701746367,COMM 101,A02,807513,Davis; Zeinabu I.,15,0,15,0
1739701746367,COMM 101,A03,807516,Davis; Zeinabu I.,15,0,15,0
1739701746367,COMM 101,A04,807517,Davis; Zeinabu I.,14,0,15,1
1739701747393,COMM 101D,A00,807570,Halm; Gavin Patrick,18,0,18,0
1739701748419,COMM 101K,A00,807571,Martinico; Daniel J,16,0,16,0
1739701749446,COMM 101N,A00,807572,Martinico; Daniel J,16,0,16,0
1739701750475,COMM 101T,A00,807573,Halm; Gavin Patrick,17,0,18,1
1739701750475,COMM 101T,B00,807588,Dewey; Matthew D,10,0,10,0
1739701750475,COMM 101T,C00,807592,Dewey; Matthew D,9,0,10,1
1739701751554,COMM 102C,A01,807604,Campion; Camille E,6,0,6,0
1739701751554,COMM 102C,A02,807605,Campion; Camille E,6,0,6,0
1739701751554,COMM 102C,A03,807612,Campion; Camille E,3,0,6,3
1739701752580,COMM 102M,A01,807638,Ahn; Patricia Jeehyun,9,0,9,0
1739701752580,COMM 102M,A02,807639,Ahn; Patricia Jeehyun,7,0,9,2
1739701753608,COMM 106F,A00,807672,McKenna; Denise,69,0,75,6
1739701754634,COMM 106I,A00,807926,Irani; Lilly C,71,0,75,4
1739701755659,COMM 109P,A00,807927,Jack; Caroline Sarah,39,0,40,1
1739701756685,COMM 110M,A00,807928,Abuelhiga; Soraya Jill,40,0,40,0
1739701757710,COMM 113T,A00,807929,Dominguez Rubio; Fernando,39,0,40,1
1739701758736,COMM 114A,A00,807930,Zilberg; Elana,37,0,40,3
1739701759761,COMM 114F,A00,808016,Rojo Solis; Juan Jose,38,0,40,2
1739701760785,COMM 114P,A00,808034,Abuelhiga; Soraya Jill,38,0,40,2
1739701761811,COMM 114W,A00,808035,Walkover; Lillian B,17,0,20,3
1739701762837,COMM 115,A00,808037,Alac; Morana,33,0,35,2
1739701763863,COMM 132,A00,808058,McKenna; Denise,37,0,40,3
1739701764889,COMM 139,A00,808063,Davis; Zeinabu I.,23,0,30,7
1739701765915,COMM 143,A00,808064,Rojo Solis; Juan Jose,38,0,40,2
1739701766940,COMM 146,A00,808068,Ahn; Patricia Jeehyun,34,0,35,1
1739701767966,COMM 155,A00,808072,Pavon Aramburu; Maria Laur,39,0,40,1
1739701768994,COMM 158,A00,808073,Fields; Gary,40,0,40,0
1739701770020,COMM 171,A00,808082,Zilberg; Elana,24,0,25,1
1739701771047,COMM 172,A00,808083,Staff,23,0,25,2
1739701772072,COMM 173,A00,808091,Alac; Morana,25,0,25,0
1739701773097,COMM 180,A00,808162,Leuning; Grant Maurstad,25,0,25,0
1739701774124,COMM 190,A00,808168,Dominguez Rubio; Fernando,22,0,23,1
1739701774124,COMM 190,B00,808169,Harb; Anthony Joseph,22,0,23,1
1739701774124,COMM 190,C00,808170,Rojo Solis; Juan Jose,22,0,23,1
1739701774124,COMM 190,D00,870218,Boateng; Boatema,22,0,23,1
1739701775149,COMM 194,A00,851599,Staff,0,0,0,0
1739701776174,CSE 6R,A01,842851,Moshiri; Niema,142,0,149,7
1739701776174,CSE 6R,B01,876602,Moshiri; Niema,50,0,50,0
1739701777199,CSE 8A,A50,842974,Porter; Leonard Emerson,38,0,38,0
1739701777199,CSE 8A,A51,843001,Porter; Leonard Emerson,37,0,38,1
1739701777199,CSE 8A,A52,843011,Porter; Leonard Emerson,38,0,38,0
1739701777199,CSE 8A,A53,843012,Porter; Leonard Emerson,37,0,38,1
1739701777199,CSE 8A,A54,874345,Porter; Leonard Emerson,38,0,38,0
1739701777199,CSE 8A,A55,874414,Porter; Leonard Emerson,35,0,38,3
1739701777199,CSE 8A,A56,874418,Porter; Leonard Emerson,38,0,38,0
1739701778225,CSE 11,A01,860850,Ochoa; Benjamin Lawrence,300,0,320,20
1739701779249,CSE 12,A01,860851,Cao; Yingjun,117,0,120,3
1739701779249,CSE 12,B01,865865,Cao; Yingjun,109,0,120,11
1739701780274,CSE 20,A01,865892,Jones; Miles E,97,0,100,3
1739701780274,CSE 20,A02,865908,Jones; Miles E,97,0,100,3
1739701781302,CSE 21,A01,865911,Jones; Miles E,97,0,100,3
1739701781302,CSE 21,A02,865914,Jones; Miles E,94,0,100,6
1739701782327,CSE 29,A50,843454,Solares; Edwin A,9,0,10,1
1739701782327,CSE 29,A51,843459,Solares; Edwin A,10,0,10,0
1739701782327,CSE 29,A52,843460,Solares; Edwin A,8,0,10,2
1739701782327,CSE 29,A53,843549,Solares; Edwin A,5,0,5,0
1739701782327,CSE 29,B50,843559,Soosai Raj; Adalbert Geral,5,0,10,5
1739701782327,CSE 29,B51,843750,Soosai Raj; Adalbert Geral,4,0,10,6
1739701782327,CSE 29,B52,843757,Soosai Raj; Adalbert Geral,8,0,10,2
1739701782327,CSE 29,B53,843758,Soosai Raj; Adalbert Geral,4,0,5,1
1739701783352,CSE 30,A01,864415,Chin; Bryan W.,120,0,125,5
1739701783352,CSE 30,B01,864419,Chin; Bryan W.,99,0,100,1
1739701784380,CSE 87,A00,875925,Moshiri; Niema,20,0,20,0
1739701785407,CSE 89,A00,872519,Minnes Kemp; Mor Mia,100,0,100,0
1739701785407,CSE 89,B00,872520,Minnes Kemp; Mor Mia,100,0,100,0
1739701786433,CSE 95,A00,843802,Cao; Yingjun,100,0,100,0
1739701787460,CSE 100,A01,864420,Sahoo; Debashis,100,0,120,20
1739701788485,CSE 101,A01,860868,Impagliazzo; Russell,0,0,10,10
1739701788485,CSE 101,A02,860869,Impagliazzo; Russell,0,0,10,10
1739701788485,CSE 101,A03,860870,Impagliazzo; Russell,6,0,10,4
1739701789509,CSE 105,A01,864426,Lovett; Shachar,222,0,250,28
1739701790536,CSE 107,A01,864427,Bellare; Mihir,92,0,96,4
1739701791562,CSE 110,A50,843823,Powell; Thomas Allan,111,0,116,5
1739701791562,CSE 110,A51,843827,Powell; Thomas Allan,93,0,116,23
1739701791562,CSE 110,A52,843828,Powell; Thomas Allan,106,0,116,10
1739701792591,CSE 120,A01,860871,Ousterhout; Amy,300,0,328,28
1739701793625,CSE 124,A01,864431,Porter; George M,138,0,196,58
1739701794654,CSE 125,A00,843848,Voelker; Geoffrey M.,30,0,30,0
1739701795679,CSE 127,A01,865915,Fernandes; Earlence T,173,0,192,19
1739701796708,CSE 130,A01,865928,Polikarpova; Nadezhda,176,0,192,16
1739701797734,CSE 131,A01,865936,Ding; Yufei,65,0,75,10
1739701798762,CSE 140,A01,865937,Eldon; John,184,0,196,12
1739701799787,CSE 140L,A01,843892,Eldon; John,173,0,196,23
1739701800812,CSE 141,A01,865939,Pannuto; Patrick William,165,0,192,27
1739701801838,CSE 141L,A01,843910,Eldon; John,158,0,196,38
1739701802864,CSE 145,A00,843915,Kastner; Ryan Charles,25,0,25,0
1739701803891,CSE 150A,A01,860873,Bonjour; Trevor,181,0,196,15
1739701804917,CSE 150B,A01,864429,Gao; Sicun,330,0,362,32
1739701805942,CSE 151A,A01,860874,Dasgupta; Sanjoy,297,0,325,28
1739701806967,CSE 151B,A01,864435,Yu; Qi,164,0,192,28
1739701807991,CSE 152B,A01,874283,Chandraker; Manmohan Krishna,57,0,70,13
1739701809016,CSE 153,A01,872732,McAuley; Julian John,181,0,196,15
1739701810040,CSE 153R,A01,872798,McAuley; Julian John,215,0,250,35
1739701810040,CSE 153R,B01,877492,Staff,50,0,50,0
1739701811067,CSE 165,A01,844081,Weibel; Nadir,23,0,35,12
1739701812091,CSE 168,A01,860875,Ramamoorthi; Ravi,23,0,28,5
1739701812091,CSE 168,A02,860876,Ramamoorthi; Ravi,26,0,28,2
1739701813119,CSE 175,A01,865941,Kumar; Rakesh,50,0,50,0
1739701815169,CSE 182,A01,851596,Bafna; Vineet,44,0,49,5
1739701816198,CSE 185,A01,844113,Moshiri; Niema,25,0,45,20
1739701816198,CSE 185,A02,844118,Moshiri; Niema,38,0,45,7
1739701817228,CSE 190,A00,844121,Grier; Daniel T,52,0,52,0
1739701817228,CSE 190,B00,844124,Soosai Raj; Adalbert Geral,81,0,100,19
1739701817228,CSE 190,C00,881308,Prithviraj; Ammanabrolu,45,0,50,5
1739701817228,CSE 190,D00,844127,Stefan; Deian,50,0,50,0
1739701818263,CSE 191,A00,844133,Minnes Kemp; Mor Mia,9999,0,9999,0
1739701819287,CSE 205A,A00,844166,Vianu; Victor Dan,0,0,0,0
1739701820312,CSE 209A,A00,844205,Impagliazzo; Russell,0,0,0,0
1739701821337,CSE 209B,A00,844216,Bellare; Mihir,0,0,0,0
1739701822364,CSE 217,A01,844235,Weibel; Nadir,0,0,0,0
1739701823389,CSE 219,A00,844246,Irani; Lilly C & Shvartzberg Carrio; Manuel,0,0,0,0
1739701824417,CSE 223B,A00,844249,Snoeren; Alex C.,0,0,0,0
1739701825444,CSE 224,A01,864433,Porter; George M,0,0,0,0
1739701826469,CSE 227,A00,844270,Stefan; Deian,0,0,0,0
1739701827493,CSE 229A,A00,844274,Ousterhout; Amy,0,0,0,0
1739701828518,CSE 229C,A00,844280,Fernandes; Earlence T,0,0,0,0
1739701829544,CSE 230,A00,844311,D'Antoni; Loris,0,0,0,0
1739701830580,CSE 237D,A00,844312,Kastner; Ryan Charles,0,0,0,0
1739701831605,CSE 239A,A00,844313,Vianu; Victor Dan,0,0,0,0
1739701832628,CSE 239B,A00,844314,Coblenz; Michael J,0,0,0,0
1739701833654,CSE 240A,A00,844315,Zhao; Jishen,0,0,0,0
1739701834679,CSE 241A,A00,844316,Kahng; Andrew Byun,0,0,0,0
1739701835704,CSE 250A,A00,844317,Bonjour; Trevor,0,0,0,0
1739701836731,CSE 251B,A01,864438,Yu; Qi,0,0,0,0
1739701837757,CSE 252D,A00,844320,Chandraker; Manmohan Krishna,0,0,0,0
1739701838785,CSE 253,A01,872796,McAuley; Julian John,0,0,0,0
1739701839810,CSE 253R,A01,872838,McAuley; Julian John,0,0,0,0
1739701841863,CSE 276F,A01,872476,Su; Hao,0,0,0,0
1739701842892,CSE 283,A00,844332,Bafna; Vineet & Zhong; Sheng,0,0,0,0
1739701843920,CSE 290,A00,844338,Gao; Sicun,0,0,0,0
1739701843920,CSE 290,B00,844366,Pannuto; Patrick William,0,0,0,0
1739701843920,CSE 290,C00,844379,Stefan; Deian,0,0,0,0
1739701843920,CSE 290,D00,881470,Yu; Qi,0,0,0,0
1739701843920,CSE 290,E00,844387,Chern; Albert Ren-Haur,0,0,0,0
1739701843920,CSE 290,F00,891163,Ding; Yufei,0,0,0,0
1739701844952,CSE 291,A00,844398,Bandeira; Nuno Filipe Cabrita,0,0,0,0
1739701844952,CSE 291,B00,844401,Li; Tzumao,0,0,0,0
1739701844952,CSE 291,C00,844402,Heninger; Nadia A,0,0,0,0
1739701844952,CSE 291,D00,844407,Chern; Albert Ren-Haur,0,0,0,0
1739701844952,CSE 291,E00,844409,Savage; Stefan,0,0,0,0
1739701844952,CSE 291,F00,881310,Niethammer; Marc S,0,0,0,0
1739701844952,CSE 291,H00,844419,Kahng; Andrew Byun,0,0,0,0
1739701845992,CSE 293,001,877922,Bafna; Vineet,9999,0,9999,0
1739701845992,CSE 293,002,877923,Bellare; Mihir,9999,0,9999,0
1739701845992,CSE 293,003,877942,Berg-Kirkpatrick; Taylor D,9999,0,9999,0
1739701845992,CSE 293,004,877943,Chandraker; Manmohan Krishna,9999,0,9999,0
1739701845992,CSE 293,005,877945,Cheng; Chung Kuan,9999,0,9999,0
1739701845992,CSE 293,006,877947,Christensen; Henrik I,9999,0,9999,0
1739701845992,CSE 293,007,877950,Coblenz; Michael J,9999,0,9999,0
1739701845992,CSE 293,008,877951,Cottrell; Garrison W,9999,0,9999,0
1739701845992,CSE 293,009,877952,Deutsch; Alin Bernard,9999,0,9999,0
1739701845992,CSE 293,010,877954,Esmaeilzadeh; Hadi,9999,0,9999,0
1739701845992,CSE 293,011,878049,Freund; Yoav,9999,0,9999,0
1739701845992,CSE 293,012,878145,Griswold; William G.,9999,0,9999,0
1739701845992,CSE 293,013,878152,Gymrek; Melissa Ann,9999,0,9999,0
1739701845992,CSE 293,014,878207,Heninger; Nadia A,9999,0,9999,0
1739701845992,CSE 293,015,878221,Impagliazzo; Russell,9999,0,9999,0
1739701845992,CSE 293,016,878223,Jhala; Ranjit,9999,0,9999,0
1739701845992,CSE 293,017,878262,Kahng; Andrew Byun,9999,0,9999,0
1739701845992,CSE 293,018,878267,Kane; Daniel Mertz,9999,0,9999,0
1739701845992,CSE 293,019,878270,Kriegman; David J,9999,0,9999,0
1739701845992,CSE 293,020,878273,Kumar; Arun Kumar,9999,0,9999,0
1739701845992,CSE 293,021,878275,Lerner; Sorin,9999,0,9999,0
1739701845992,CSE 293,022,878276,Lovett; Shachar,9999,0,9999,0
1739701845992,CSE 293,023,878311,McAuley; Julian John,9999,0,9999,0
1739701845992,CSE 293,024,878312,Micciancio; Daniele,9999,0,9999,0
1739701845992,CSE 293,025,878313,Orailoglu; Alex,9999,0,9999,0
1739701845992,CSE 293,026,878314,Pannuto; Patrick William,9999,0,9999,0
1739701845992,CSE 293,027,878315,Paturi; Ramamohan,9999,0,9999,0
1739701845992,CSE 293,028,878330,Polikarpova; Nadezhda,9999,0,9999,0
1739701845992,CSE 293,029,878358,Politz; Joseph Gibbs,9999,0,9999,0
1739701845992,CSE 293,030,878392,Porter; George M,9999,0,9999,0
1739701845992,CSE 293,031,878399,Porter; Leonard Emerson,9999,0,9999,0
1739701845992,CSE 293,032,878415,Ramamoorthi; Ravi,9999,0,9999,0
1739701845992,CSE 293,033,878416,Riek; Laurel D,9999,0,9999,0
1739701845992,CSE 293,034,878417,Sahoo; Debashis,9999,0,9999,0
1739701845992,CSE 293,035,878418,Saul; Lawrence,9999,0,9999,0
1739701845992,CSE 293,036,878419,Savage; Stefan,9999,0,9999,0
1739701845992,CSE 293,037,878420,Schulze; Jurgen P.,9999,0,9999,0
1739701845992,CSE 293,038,878421,Snoeren; Alex C.,9999,0,9999,0
1739701845992,CSE 293,039,878422,Shang; Jingbo,9999,0,9999,0
1739701845992,CSE 293,040,878423,Stefan; Deian,9999,0,9999,0
1739701845992,CSE 293,041,878424,Su; Hao,9999,0,9999,0
1739701845992,CSE 293,042,878425,Swanson; Steven James,9999,0,9999,0
1739701845992,CSE 293,043,878460,Tullsen; Dean Michael,9999,0,9999,0
1739701845992,CSE 293,044,878476,Vaccaro; Kristen Marie,9999,0,9999,0
1739701845992,CSE 293,045,878517,Voelker; Geoffrey M.,9999,0,9999,0
1739701845992,CSE 293,046,878541,Zhao; Jishen,9999,0,9999,0
1739701845992,CSE 293,047,878663,Zhou; Yuan-Yuan,9999,0,9999,0
1739701845992,CSE 293,048,878664,Gao; Sicun,9999,0,9999,0
1739701845992,CSE 293,049,878665,Weibel; Nadir,9999,0,9999,0
1739701845992,CSE 293,050,878666,Gupta; Rajesh K.,9999,0,9999,0
1739701845992,CSE 293,051,878667,Soosai Raj; Adalbert Geral,9999,0,9999,0
1739701845992,CSE 293,052,891170,Tu; Zhuowen,9999,0,9999,0
1739701847018,CSE 294,A00,844429,Voelker; Geoffrey M.,0,0,0,0
1739701848043,CSS 1,A01,864447,Staff,34,0,36,2
1739701848043,CSS 1,A02,864476,Staff,30,0,36,6
1739701848043,CSS 1,A03,864511,Staff,34,0,36,2
1739701848043,CSS 1,A04,864512,Staff,36,0,36,0
1739701849072,CSS 100,A01,864537,Trott; Sean Thomas,30,0,36,6
1739701849072,CSS 100,A02,864538,Trott; Sean Thomas,36,0,36,0
1739701850096,CSS 120,A01,864563,Mignozzetti; Umberto,28,0,28,0
1739701850096,CSS 120,A02,864564,Mignozzetti; Umberto,28,0,30,2
1739701851119,CSS 206,A00,812747,Mukamel; Eran A,6,0,24,18
1739701852145,CSS 209,A00,864566,Mignozzetti; Umberto,27,0,45,18
1739701853171,CSS 296,001,864568,Mignozzetti; Umberto,0,0,0,4
1739701853171,CSS 296,002,864569,Mignozzetti; Umberto,0,0,0,3
1739701853171,CSS 296,003,864571,Leas; Eric Craig,0,0,0,1
1739701853171,CSS 296,004,864577,Okonkwo; Holly,0,0,0,1
1739701853171,CSS 296,005,864605,Fleischer; Jason G,0,0,0,1
1739701853171,CSS 296,006,864634,Creel; Sarah,0,0,0,1
1739701853171,CSS 296,007,864661,Patel; Hemal,0,0,0,1
1739701853171,CSS 296,008,864688,Martin; Isaac,0,0,0,0
1739701853171,CSS 296,009,864697,Styler; William Francis,0,0,0,1
1739701853171,CSS 296,010,864751,Grigoryan; Aram,0,0,0,1
1739701853171,CSS 296,011,864752,Bonjour; Trevor,0,0,0,1
1739701853171,CSS 296,012,864753,Martin; Isaac,0,0,0,2
1739701854198,DDPM 210,A00,814899,Ma; Joseph David,29,0,32,3
1739701855280,DDPM 211,A00,814901,Ma; Joseph David,29,0,32,3
1739701856307,DDPM 214,A00,814907,Ma; Joseph David,29,0,32,3
1739701857331,DERM 296,001,866221,Eichenfield; Dawn Zhang,4,0,5,1
1739701857331,DERM 296,002,866222,Staff,5,0,5,0
1739701857331,DERM 296,003,866229,Staff,5,0,5,0
1739701858364,DOC 3,A01,813868,Staff,0,0,0,0
1739701858364,DOC 3,A02,813884,Staff,0,0,0,0
1739701858364,DOC 3,A03,813885,Staff,0,0,0,0
1739701858364,DOC 3,A04,813886,Staff,0,0,0,0
1739701858364,DOC 3,A05,813887,Staff,0,0,0,0
1739701858364,DOC 3,A06,813888,Staff,0,0,0,0
1739701858364,DOC 3,A07,813889,Staff,0,0,0,0
1739701858364,DOC 3,A08,813890,Staff,0,0,0,0
1739701858364,DOC 3,A09,813891,Staff,0,0,0,0
1739701858364,DOC 3,A10,813892,Staff,0,0,0,0
1739701858364,DOC 3,A11,813893,Staff,0,0,0,0
1739701858364,DOC 3,A12,813894,Staff,0,0,0,0
1739701858364,DOC 3,A13,813895,Staff,0,0,0,0
1739701858364,DOC 3,A14,813896,Staff,0,0,0,0
1739701858364,DOC 3,A15,813897,Staff,0,0,0,0
1739701858364,DOC 3,A16,813898,Staff,0,0,0,0
1739701858364,DOC 3,B01,813900,Staff,0,0,0,0
1739701858364,DOC 3,B02,813901,Staff,0,0,0,0
1739701858364,DOC 3,B03,813902,Staff,0,0,0,0
1739701858364,DOC 3,B04,813903,Staff,0,0,0,0
1739701858364,DOC 3,B05,813904,Staff,0,0,0,0
1739701858364,DOC 3,B06,813905,Staff,0,0,0,0
1739701858364,DOC 3,B07,813906,Staff,0,0,0,0
1739701858364,DOC 3,B08,813907,Staff,0,0,0,0
1739701858364,DOC 3,B09,813908,Staff,0,0,0,0
1739701858364,DOC 3,B10,813910,Staff,0,0,0,0
1739701858364,DOC 3,B11,813911,Staff,0,0,0,0
1739701858364,DOC 3,B12,813913,Staff,0,0,0,0
1739701858364,DOC 3,B13,813914,Staff,0,0,0,0
1739701858364,DOC 3,B14,813915,Staff,0,0,0,0
1739701858364,DOC 3,B15,813916,Staff,0,0,0,0
1739701858364,DOC 3,B16,813917,Staff,0,0,0,0
1739701858364,DOC 3,C01,813919,Staff,0,0,0,0
1739701858364,DOC 3,C02,813920,Staff,0,0,0,0
1739701858364,DOC 3,C03,813921,Staff,0,0,0,0
1739701858364,DOC 3,C04,813922,Staff,0,0,0,0
1739701858364,DOC 3,C05,813923,Staff,0,0,0,0
1739701858364,DOC 3,C06,813926,Staff,0,0,0,0
1739701858364,DOC 3,C07,813927,Staff,0,0,0,0
1739701858364,DOC 3,C08,813928,Staff,0,0,0,0
1739701858364,DOC 3,C09,813929,Staff,0,0,0,0
1739701858364,DOC 3,C10,813931,Staff,0,0,0,0
1739701858364,DOC 3,C11,813932,Staff,0,0,0,0
1739701858364,DOC 3,C12,813933,Staff,0,0,0,0
1739701858364,DOC 3,C13,813936,Staff,0,0,0,0
1739701858364,DOC 3,C14,813937,Staff,0,0,0,0
1739701858364,DOC 3,C15,813938,Staff,0,0,0,0
1739701858364,DOC 3,C16,813939,Staff,0,0,0,0
1739701858364,DOC 3,D01,813942,Staff,0,0,0,0
1739701858364,DOC 3,D02,813943,Staff,0,0,0,0
1739701858364,DOC 3,D03,813944,Staff,0,0,0,0
1739701858364,DOC 3,D04,813945,Staff,0,0,0,0
1739701858364,DOC 3,D05,813979,Staff,0,0,0,0
1739701858364,DOC 3,D06,813981,Staff,0,0,0,0
1739701858364,DOC 3,D07,813985,Staff,0,0,0,0
1739701858364,DOC 3,D08,813986,Staff,0,0,0,0
1739701858364,DOC 3,D09,813988,Staff,0,0,0,0
1739701858364,DOC 3,D10,813991,Staff,0,0,0,0
1739701858364,DOC 3,D11,813993,Staff,0,0,0,0
1739701858364,DOC 3,D12,813994,Staff,0,0,0,0
1739701858364,DOC 3,D13,814000,Staff,0,0,0,0
1739701858364,DOC 3,D14,814002,Staff,0,0,0,0
1739701858364,DOC 3,D15,814003,Staff,0,0,0,0
1739701858364,DOC 3,D16,814012,Staff,0,0,0,0
1739701858364,DOC 3,D17,814014,Staff,0,0,0,0
1739701859394,DOC 100D,A00,814015,Pass; Natalye,24,0,25,1
1739701859394,DOC 100D,B00,814017,Pass; Natalye,24,0,25,1
1739701860421,DSC 10,A01,841644,Tiefenbruck; Janine LoBue,146,0,146,0
1739701860421,DSC 10,B01,870243,Tiefenbruck; Janine LoBue,143,0,146,3
1739701861446,DSC 20,A01,841647,Langlois; Marina,60,0,60,0
1739701861446,DSC 20,B01,841649,Langlois; Marina,60,0,60,0
1739701862471,DSC 30,A01,841651,Liao; Soohyun Nam,189,0,190,1
1739701862471,DSC 30,B01,841653,Liao; Soohyun Nam,188,0,190,2
1739701863496,DSC 40A,A01,841659,Shannon; Kyle Michael,143,0,146,3
1739701864524,DSC 40B,A01,841663,Eldridge; Justin Matthew,175,0,180,5
1739701865549,DSC 80,A01,841667,Rahman; Tauhidur,116,0,120,4
1739701866574,DSC 95,A01,841669,Tiefenbruck; Janine LoBue,40,0,40,0
1739701867602,DSC 100,A01,841671,Salimi; Babak,146,0,146,0
1739701868627,DSC 102,A01,841674,Staff,293,0,300,7
1739701869653,DSC 106,B01,841679,Lau; Samuel Ethan,98,0,100,2
1739701869653,DSC 106,C01,841681,Lau; Samuel Ethan,100,0,100,0
1739701870678,DSC 140A,A01,841683,Ustun; Tevfik Berk,150,0,150,0
1739701871704,DSC 140B,A01,841687,Weng; Tsui-Wei (lily),122,0,125,3
1739701872729,DSC 161,A00,841688,Roberts; Margaret Earling,40,0,40,0
1739701873759,DSC 190,A01,841690,Silberman; Jack,30,0,30,0
1739701873759,DSC 190,B01,841692,Langlois; Marina,99,0,100,1
1739701873759,DSC 190,C01,841694,Weng; Tsui-Wei (lily),28,0,30,2
1739701873759,DSC 190,D01,841696,Ustun; Tevfik Berk,30,0,30,0
1739701874785,DSC 197,001,841699,Eldridge; Justin Matthew,9999,0,9999,0
1739701875813,DSC 204A,A00,841700,Bellur; Umesh,0,0,0,0
1739701876838,DSC 208R,A01,841703,Jin; Haojian,34,0,40,6
1739701877865,DSC 212,A00,841705,Staff,78,0,90,12
1739701878891,DSC 214,A00,841706,Wang; Yusu,0,0,60,60
1739701879916,DSC 232R,A01,841708,Solares; Edwin A,49,0,80,31
1739701880942,DSC 240,A00,841710,Belkin; Mikhail,114,0,120,6
1739701881970,DSC 241,A00,841712,Schwartzman; Armin,20,0,90,70
1739701882994,DSC 255R,A01,841714,Staff,32,0,40,8
1739701884019,DSC 258R,A01,841716,Shang; Jingbo,35,0,60,25
1739701885043,DSC 267R,A01,841718,Danks; David J,53,0,60,7
1739701886078,DSC 291,A00,841719,Ustun; Tevfik Berk,0,0,30,30
1739701886078,DSC 291,B00,841723,Huang; Biwei,3,0,60,57
1739701886078,DSC 291,C00,841724,Weng; Tsui-Wei (lily),0,0,30,30
1739701886078,DSC 291,D00,841725,Hu; Zhiting,54,0,90,36
1739701886078,DSC 291,E00,841726,Warstadt; Alexander Scott,7,0,60,53
1739701887104,DSC 293,A00,841727,Ustun; Tevfik Berk,9995,0,9999,4
1739701888129,DSC 297,001,872917,Rahman; Tauhidur,9999,0,9999,0
1739701889154,DSE 210,A00,869159,Staff,20,0,20,0
1739701890180,DSE 230,A00,813774,Staff,25,0,25,0
1739701891206,DSE 260B,A00,813775,Staff,25,0,25,0
1739701892233,DSGN 1,A01,810429,Klemmer; Scott R,49,0,50,1
1739701892233,DSGN 1,A02,810431,Klemmer; Scott R,49,0,50,1
1739701892233,DSGN 1,A03,810434,Klemmer; Scott R,50,0,50,0
1739701892233,DSGN 1,A04,810436,Klemmer; Scott R,48,0,50,2
1739701892233,DSGN 1,A05,810438,Klemmer; Scott R,39,0,40,1
1739701893257,DSGN 2,A01,810443,Hollan; James D.,49,0,50,1
1739701894282,DSGN 100,A01,811981,Rill; Bryan,18,0,18,0
1739701894282,DSGN 100,A02,811982,Rill; Bryan,10,0,18,8
1739701894282,DSGN 100,A03,811983,Rill; Bryan,15,0,18,3
1739701894282,DSGN 100,A04,812053,Rill; Bryan,6,0,16,10
1739701895307,DSGN 119,A00,812054,Irani; Lilly C & Shvartzberg Carrio; Manuel,63,0,80,17
1739701897358,DSGN 219,A00,812273,Irani; Lilly C & Shvartzberg Carrio; Manuel,12,0,15,3
1739701898385,ECE 5,A01,816583,Morris; Karcher William,0,0,0,0
1739701898385,ECE 5,A02,816584,Morris; Karcher William,0,0,0,0
1739701898385,ECE 5,A03,816586,Morris; Karcher William,22,0,22,0
1739701898385,ECE 5,A04,816589,Morris; Karcher William,22,0,22,0
1739701899412,ECE 15,A01,816591,Sahay; Rajeev,114,0,120,6
1739701900437,ECE 16,A01,816594,Wang; Edward Jay,25,0,30,5
1739701901462,ECE 17,A01,816599,Sahay; Rajeev,67,0,75,8
1739701902491,ECE 25,A50,816722,Dey; Sujit,30,0,30,0
1739701902491,ECE 25,A51,816734,Dey; Sujit,29,0,30,1
1739701903516,ECE 30,A50,816809,Mir Arabbaygi; Siavash,25,0,30,5
1739701903516,ECE 30,A51,816811,Mir Arabbaygi; Siavash,25,0,30,5
1739701903516,ECE 30,A52,816812,Mir Arabbaygi; Siavash,30,0,30,0
1739701903516,ECE 30,A53,816814,Mir Arabbaygi; Siavash,30,0,30,0
1739701903516,ECE 30,A54,816817,Mir Arabbaygi; Siavash,27,0,27,0
1739701904547,ECE 35,A50,816821,Ndao; Abdoulaye,25,0,26,1
1739701904547,ECE 35,A51,816822,Ndao; Abdoulaye,24,0,26,2
1739701904547,ECE 35,A52,816825,Ndao; Abdoulaye,26,0,26,0
1739701904547,ECE 35,A53,816826,Ndao; Abdoulaye,26,0,26,0
1739701905575,ECE 45,A01,816828,Zeger; Kenneth A.,187,0,192,5
1739701906608,ECE 65,A50,816873,Baghdadchi; Saharnaz,28,0,30,2
1739701906608,ECE 65,A51,816874,Baghdadchi; Saharnaz,28,0,30,2
1739701906608,ECE 65,A52,816877,Baghdadchi; Saharnaz,30,0,30,0
1739701906608,ECE 65,A53,816880,Baghdadchi; Saharnaz,30,0,30,0
1739701906608,ECE 65,A54,816882,Baghdadchi; Saharnaz,30,0,30,0
1739701906608,ECE 65,A55,816883,Baghdadchi; Saharnaz,29,0,30,1
1739701906608,ECE 65,A56,816884,Baghdadchi; Saharnaz,30,0,30,0
1739701907635,ECE 100,A01,816926,Hsueh; Tzu-Chien,29,0,30,1
1739701907635,ECE 100,A02,816939,Hsueh; Tzu-Chien,26,0,30,4
1739701907635,ECE 100,A03,816945,Hsueh; Tzu-Chien,29,0,30,1
1739701907635,ECE 100,A04,816950,Hsueh; Tzu-Chien,29,0,30,1
1739701907635,ECE 100,A05,816962,Hsueh; Tzu-Chien,29,0,30,1
1739701908659,ECE 101,A01,816993,Siegel; Paul H.,57,0,60,3
1739701908659,ECE 101,A02,817165,Siegel; Paul H.,57,0,60,3
1739701909684,ECE 103,A01,817352,Nomura; Kenji,43,0,50,7
1739701910709,ECE 108,A01,817373,Kang; Mingu,99,0,120,21
1739701911737,ECE 109,A01,817418,Orlitsky; Alon,72,0,73,1
1739701911737,ECE 109,A02,817420,Orlitsky; Alon,73,0,73,0
1739701912764,ECE 111,A01,817426,Eldon; John,167,0,180,13
1739701913793,ECE 115,A01,817432,Yip; Michael,20,0,26,6
1739701914819,ECE 123,A01,817448,Sievenpiper; Daniel F.,28,0,37,9
1739701915848,ECE 125B,A50,817453,Esmaili; Gholamreza,18,0,24,6
1739701915848,ECE 125B,A51,817455,Esmaili; Gholamreza,23,0,24,1
1739701916872,ECE 134,A00,817457,Ng; Tse Nga,47,0,50,3
1739701917898,ECE 136L,A01,817459,Dayeh; Shadi Ahmad,5,0,5,0
1739701917898,ECE 136L,A02,817461,Dayeh; Shadi Ahmad,2,0,5,3
1739701917898,ECE 136L,A03,817462,Dayeh; Shadi Ahmad,3,0,5,2
1739701917898,ECE 136L,A04,817463,Dayeh; Shadi Ahmad,4,0,5,1
1739701918925,ECE 139,A00,817537,Nomura; Kenji,29,0,30,1
1739701919950,ECE 140B,A50,817654,Khoshabeh; Ramsin & Gessner; Richard K.,23,0,24,1
1739701919950,ECE 140B,A51,817662,Khoshabeh; Ramsin & Gessner; Richard K.,22,0,24,2
1739701919950,ECE 140B,A52,817663,Khoshabeh; Ramsin & Gessner; Richard K.,22,0,22,0
1739701920976,ECE 141B,A01,872372,Gessner; Richard K.,26,0,30,4
1739701922003,ECE 148,A01,817698,Silberman; Jack,22,0,26,4
1739701923029,ECE 153,A01,817703,Naghizadeh Ardabili; Parinaz,74,0,90,16
1739701924055,ECE 157A,A01,817708,Bharadia; Dinesh,21,0,25,4
1739701925081,ECE 161C,A00,817865,Harris; Frederick Joel,48,0,50,2
1739701926108,ECE 165,A51,817880,Mercier; Patrick Philip,26,0,30,4
1739701926108,ECE 165,A52,817882,Mercier; Patrick Philip,23,0,30,7
1739701926108,ECE 165,A53,817885,Mercier; Patrick Philip,27,0,30,3
1739701926108,ECE 165,A54,817888,Mercier; Patrick Philip,29,0,30,1
1739701927133,ECE 171A,A01,817892,Zheng; Yang,93,0,100,7
1739701928159,ECE 175B,A01,817899,Xie; Pengtao,47,0,50,3
1739701929185,ECE 183,A01,817903,Mookherjea; Shayan,26,0,30,4
1739701930214,ECE 185,A01,817907,Liu; Zhaowei,20,0,20,0
1739701931241,ECE 196,A00,817908,Morris; Karcher William,15,0,24,9
1739701931241,ECE 196,B00,817913,Morris; Karcher William,26,0,28,2
1739701932266,ECE 197,001,816579,Mercier; Patrick Philip,9999,0,9999,0
1739701933293,ECE 198,001,816580,Nguyen; Truong Quang,9999,0,9999,0
1739701934321,ECE 204,A00,817918,Alexandrov; Ludmil B,0,0,0,0
1739701935349,ECE 208,A00,817920,Mir Arabbaygi; Siavash,0,0,0,0
1739701936375,ECE 212CN,A00,817921,Liu; Zhaowei,0,0,0,0
1739701937399,ECE 222D,A00,817922,Sievenpiper; Daniel F.,0,0,0,0
1739701938426,ECE 227,A00,817926,Franceschetti; Massimo,0,0,0,0
1739701939452,ECE 228,A00,817928,Shi; Yuanyuan,0,0,0,0
1739701940477,ECE 236B,A00,817929,Lo; Yu-Hwa,0,0,0,0
1739701941504,ECE 238B,A00,817934,Garay; Javier,0,0,0,0
1739701942533,ECE 240C,A00,818013,Mookherjea; Shayan,0,0,0,0
1739701943558,ECE 241A,A00,818014,Rubin; Noah,0,0,0,0
1739701944586,ECE 251B,A00,818015,Vasconcelos; Manuela,0,0,0,0
1739701945611,ECE 258B,A00,818016,Milstein; Laurence B.,0,0,0,0
1739701946639,ECE 260C,A00,818017,Kahng; Andrew Byun,0,0,0,0
1739701947665,ECE 264B,A00,818018,Galton; Ian A,0,0,0,0
1739701948690,ECE 265B,A00,818019,Gudem; Prasad S.S.,0,0,0,0
1739701949718,ECE 266,A01,818021,Hall; Drew A.,0,0,0,0
1739701950745,ECE 268,A00,818022,Koushanfar; Farinaz,0,0,0,0
1739701951771,ECE 272A,A01,818064,Poveda Fonseca; Jorge,0,0,0,0
1739701952798,ECE 273,A00,818065,Wang; Jun-Kun,0,0,0,0
1739701953827,ECE 275A,A00,818066,Meyer; Florian,0,0,0,0
1739701954858,ECE 276B,A00,818067,Atanasov; Nikolay A.,0,0,0,0
1739701955885,ECE 284,A00,818068,Wang; Edward,0,0,0,0
1739701956915,ECE 285,A00,818069,Wang; Xiaolong,0,0,0,0
1739701956915,ECE 285,B00,818070,Antipa; Nicholas A,0,0,0,0
1739701956915,ECE 285,C00,818071,Xie; Pengtao,0,0,0,0
1739701957942,ECE 287,A00,872497,Gonzalez Prelcic; Nuria,0,0,0,0
1739701959025,ECON 1,A01,814026,Famulari; Melissa,118,0,120,2
1739701959025,ECON 1,A02,814028,Famulari; Melissa,114,0,115,1
1739701959025,ECON 1,A03,814029,Famulari; Melissa,115,0,115,0
1739701959025,ECON 1,B01,814039,Famulari; Melissa,46,0,50,4
1739701960057,ECON 2,A01,814045,Crane; Meredith Helen,95,0,96,1
1739701961087,ECON 3,A01,814154,Crane; Meredith Helen,91,0,95,4
1739701961087,ECON 3,A02,814155,Crane; Meredith Helen,93,0,95,2
1739701961087,ECON 3,B01,814188,Crane; Meredith Helen,95,0,95,0
1739701961087,ECON 3,B02,814195,Crane; Meredith Helen,91,0,95,4
1739701962115,ECON 4,A01,814197,Levkoff; Steven B.,50,0,54,4
1739701962115,ECON 4,A02,814210,Levkoff; Steven B.,54,0,54,0
1739701962115,ECON 4,A03,814224,Levkoff; Steven B.,54,0,54,0
1739701962115,ECON 4,B01,814273,Brooks; Marcus Raymond,3,0,3,0
1739701963143,ECON 5,A01,814495,Arnold; David Hall,66,0,72,6
1739701963143,ECON 5,A02,814507,Arnold; David Hall,72,0,72,0
1739701963143,ECON 5,A03,814508,Arnold; David Hall,71,0,72,1
1739701963143,ECON 5,A04,814509,Arnold; David Hall,71,0,72,1
1739701963143,ECON 5,A05,814510,Arnold; David Hall,72,0,72,0
1739701963143,ECON 5,B01,814513,Dai; Yinlin,44,0,45,1
1739701963143,ECON 5,B02,814514,Dai; Yinlin,39,0,45,6
1739701964169,ECON 100A,A01,814516,Newhouse; Herbert S,76,0,79,3
1739701964169,ECON 100A,A02,814517,Newhouse; Herbert S,79,0,79,0
1739701964169,ECON 100A,B01,814519,Newhouse; Herbert S,82,0,83,1
1739701964169,ECON 100A,B02,814520,Newhouse; Herbert S,73,0,75,2
1739701965194,ECON 100AH,A00,814521,Famulari; Melissa,20,0,20,0
1739701966225,ECON 100B,A01,814523,Boomhower; Judson P,74,0,85,11
1739701966225,ECON 100B,A02,814524,Boomhower; Judson P,82,0,85,3
1739701966225,ECON 100B,A03,814525,Boomhower; Judson P,78,0,80,2
1739701966225,ECON 100B,B01,814527,Boomhower; Judson P,0,0,0,0
1739701967250,ECON 100BH,A00,814528,Boomhower; Judson P,20,0,20,0
1739701968277,ECON 100C,A01,814530,Newhouse; Herbert S,95,0,98,3
1739701968277,ECON 100C,A02,814531,Newhouse; Herbert S,98,0,98,0
1739701969303,ECON 101,A00,814532,Esfahani; Sara,112,0,120,8
1739701970332,ECON 109T,A00,814533,Trevino; Isabel,20,0,20,0
1739701971358,ECON 110A,A01,814535,Candido; Maria Teresa,97,0,100,3
1739701972388,ECON 110B,A01,814537,Herreno Lopera; Juan,91,0,100,9
1739701972388,ECON 110B,A02,814538,Herreno Lopera; Juan,100,0,100,0
1739701972388,ECON 110B,A03,814539,Herreno Lopera; Juan,99,0,100,1
1739701972388,ECON 110B,A04,814540,Herreno Lopera; Juan,98,0,100,2
1739701973416,ECON 120A,A01,814542,Dai; Yinlin,90,0,95,5
1739701973416,ECON 120A,A02,814543,Dai; Yinlin,95,0,95,0
1739701973416,ECON 120A,B01,814545,Dai; Yinlin,93,0,95,2
1739701973416,ECON 120A,B02,814546,Dai; Yinlin,94,0,95,1
1739701974448,ECON 120B,A01,814548,Candido; Maria Teresa,91,0,95,4
1739701974448,ECON 120B,A02,814549,Candido; Maria Teresa,89,0,95,6
1739701974448,ECON 120B,B01,814551,Candido; Maria Teresa,91,0,95,4
1739701974448,ECON 120B,B02,814552,Candido; Maria Teresa,95,0,95,0
1739701975474,ECON 120C,A01,814554,Sun; Yixiao,38,0,40,2
1739701975474,ECON 120C,B01,814556,Sun; Yixiao,33,0,40,7
1739701975474,ECON 120C,C01,814585,Sun; Yixiao,39,0,40,1
1739701976499,ECON 125,A00,814588,Vogl; Tom Saul,96,0,100,4
1739701977523,ECON 129,A00,814589,Eckert; Fabian Paul,99,0,100,1
1739701978550,ECON 132,A00,814595,Carson; Richard T,72,0,75,3
1739701978550,ECON 132,B00,814599,Carson; Richard T,73,0,75,2
1739701979578,ECON 132T,A00,814600,Carson; Richard T,20,0,20,0
1739701980605,ECON 134,A00,814601,Gelber; Alexander Michael,47,0,50,3
1739701981629,ECON 137,A00,814602,Niehaus; Paul,20,0,20,0
1739701982654,ECON 140,A00,814630,Clemens; Jeffrey,44,0,49,5
1739701983680,ECON 142,A00,814647,Trevino; Isabel,50,0,50,0
1739701983680,ECON 142,B00,814656,Trevino; Isabel,46,0,50,4
1739701984705,ECON 147,A00,814683,Betts; Julian,100,0,100,0
1739701985734,ECON 164,A00,814684,Muralidharan; Karthik,219,0,220,1
1739701986760,ECON 168,A00,814691,Maron; Asa,74,0,80,6
1739701987785,ECON 173B,A01,814700,Levkoff; Steven B.,39,0,40,1
1739701987785,ECON 173B,B01,814734,Levkoff; Steven B.,40,0,40,0
1739701988812,ECON 191A,A00,814768,Cullen; Julie,20,0,20,0
1739701989838,ECON 200C,A00,814811,Grigoryan; Aram & Trevino; Isabel & Sobel; Joel,24,0,25,1
1739701990862,ECON 210C,A00,814815,Herreno Lopera; Juan,25,0,25,0
1739701991886,ECON 220C,A00,814816,Sun; Yixiao,23,0,25,2
1739701992911,ECON 220F,A00,814817,Carson; Richard T,28,0,30,2
1739701993939,ECON 221,A00,814818,Zhu; Ying,15,0,15,0
1739701994968,ECON 241,A00,814819,Muralidharan; Karthik,14,0,15,1
1739701995993,ECON 243,A00,814820,Niehaus; Paul & Adhvaryu; Achyuta Rasendra,15,0,15,0
1739701997019,ECON 248,A00,814821,Eckert; Fabian Paul & Trottner; Fabian Gunter We,13,0,15,2
1739701998044,ECON 250C,A00,814840,Arnold; David Hall & Betts; Julian,24,0,25,1
1739701999075,ECON 281,A00,814850,Wu; Pak Yeung & Herreno Lopera; Juan,14,0,15,1
1739702000102,ECON 285,A00,814851,Eckert; Fabian Paul,25,0,25,0
1739702001128,ECON 286,A00,814852,Hamilton; James D.,20,0,20,0
1739702001128,ECON 286,B00,814853,Shishkin; Denis,19,0,20,1
1739702002153,ECON 296,A00,814854,Eckert; Fabian Paul,24,0,25,1
1739702003177,EDS 31,A00,815023,Brydges; Stacey,17,0,20,3
1739702004203,EDS 39,A01,815025,Heinzman; Erica M.,25,0,25,0
1739702005230,EDS 102,A01,815042,Hopkins; Megan Beth,40,0,45,5
1739702007286,EDS 115,A00,815058,Jones; Gabrielle Anastasia,48,0,50,2
1739702008318,EDS 117,A01,851605,Jones; Makeba,33,0,37,4
1739702008318,EDS 117,A02,851607,Jones; Makeba,35,0,37,2
1739702008318,EDS 117,A03,851608,Jones; Makeba,38,0,38,0
1739702008318,EDS 117,A04,851610,Jones; Makeba,36,0,38,2
1739702008318,EDS 117,B01,870849,Staff,24,0,25,1
1739702008318,EDS 117,B02,870920,Staff,25,0,25,0
1739702008318,EDS 117,B03,870978,Staff,25,0,25,0
1739702008318,EDS 117,B04,870979,Staff,25,0,25,0
1739702009346,EDS 118,A00,815184,Staff,57,0,60,3
1739702010371,EDS 123,A00,815186,Brydges; Stacey,20,0,20,0
1739702011395,EDS 124AR,A00,815196,Simon; Elizabeth A,189,0,200,11
1739702011395,EDS 124AR,B00,815197,Simon; Elizabeth A,99,0,100,1
1739702011395,EDS 124AR,C00,872649,Simon; Elizabeth A,40,0,40,0
1739702012421,EDS 124BR,A00,815259,Eguchi; Emi,57,0,75,18
1739702012421,EDS 124BR,B00,872641,Eguchi; Emi,25,0,25,0
1739702013446,EDS 125,A00,815260,Aragon; Maria Jose,55,0,60,5
1739702014472,EDS 126,A01,851619,Jones; Makeba,25,0,33,8
1739702014472,EDS 126,A02,815283,Jones; Makeba,31,0,33,2
1739702014472,EDS 126,A03,815284,Jones; Makeba,33,0,34,1
1739702015498,EDS 128B,A01,815311,Pappas; Elizabeth,24,0,25,1
1739702015498,EDS 128B,A02,815312,Pappas; Elizabeth,25,0,25,0
1739702015498,EDS 128B,A03,870748,Pappas; Elizabeth,20,0,20,0
1739702016523,EDS 129C,A01,815314,Millstone; Rachel Diana,60,0,60,0
1739702017548,EDS 130,A01,815383,Mendez; Kathrina Mendoza,18,0,20,2
1739702017548,EDS 130,A02,815384,Mendez; Kathrina Mendoza,20,0,20,0
1739702017548,EDS 130,A03,815390,Mendez; Kathrina Mendoza,20,0,20,0
1739702018575,EDS 133,A01,815456,Bintliff; Amy S.V.,12,0,15,3
1739702018575,EDS 133,A02,815457,Bintliff; Amy S.V.,15,0,15,0
1739702018575,EDS 133,A03,815458,Bintliff; Amy S.V.,14,0,15,1
1739702018575,EDS 133,A04,815459,Bintliff; Amy S.V.,10,0,10,0
1739702019601,EDS 136,A01,815462,Hemans; Patricia Ann Benitez,17,0,20,3
1739702019601,EDS 136,A02,815463,Hemans; Patricia Ann Benitez,20,0,20,0
1739702019601,EDS 136,A03,815467,Hemans; Patricia Ann Benitez,20,0,20,0
1739702020627,EDS 139,A00,815469,Pappas; Elizabeth,47,0,50,3
1739702020627,EDS 139,B00,815470,Millstone; Rachel Diana,60,0,60,0
1739702020627,EDS 139,C00,815471,Mendez; Kathrina Mendoza,58,0,60,2
1739702020627,EDS 139,D00,815472,Bintliff; Amy S.V.,57,0,60,3
1739702020627,EDS 139,E00,815473,Hemans; Patricia Ann Benitez,57,0,60,3
1739702020627,EDS 139,F00,815474,Mamas; Christoforos,32,0,35,3
1739702020627,EDS 139,G00,815583,Choi; Bailey Miyeon,30,0,30,0
1739702020627,EDS 139,H00,815588,Bintliff; Amy S.V.,20,0,20,0
1739702021654,EDS 141,A00,815592,Mamas; Christoforos,34,0,35,1
1739702022682,EDS 145,A01,815629,Choi; Bailey Miyeon,13,0,15,2
1739702022682,EDS 145,A02,815630,Choi; Bailey Miyeon,15,0,15,0
1739702023710,EDS 164R,A01,815632,Staff,37,0,40,3
1739702023710,EDS 164R,B01,872639,Staff,20,0,20,0
1739702024735,EDS 165,A00,815635,Jones; Gabrielle Anastasia,29,0,30,1
1739702025760,EDS 180,A00,815642,Chapman; Thandeka K,24,0,25,1
1739702025760,EDS 180,B00,886111,Eguchi; Emi,30,0,30,0
1739702026787,EDS 190,A00,889678,Bintliff; Amy S.V.,4,0,5,1
1739702027813,EDS 205B,A00,815645,Halter; Christopher P.,48,0,50,2
1739702028836,EDS 253,A00,815646,Staff,14,0,15,1
1739702029860,EDS 266,A00,815647,Phuong; Andrew,11,0,12,1
1739702030885,EDS 282,A00,815649,Daly; Alan J.,15,0,15,0
1739702031910,EDS 287B,A00,815650,Daly; Alan J.,15,0,15,0
1739702032935,EDS 288A,A00,815651,Bjorklund; Peter,15,0,15,0
1739702033962,EDS 288B,A00,815694,Chapman; Thandeka K,19,0,20,1
1739702034989,EDS 288C,A00,815695,Staff,15,0,15,0
1739702036015,EDS 289B,A01,815710,Daly; Alan J.,15,0,15,0
1739702037040,EDS 290,A00,815711,Millstone; Rachel Diana,20,0,20,0
1739702037040,EDS 290,B00,815712,Heinzman; Erica M.,20,0,20,0
1739702037040,EDS 290,C00,815717,Choi; Bailey Miyeon,21,0,21,0
1739702037040,EDS 290,D00,815727,Black; Alison Michelle,20,0,20,0
1739702038065,EDS 293B,A01,815735,Burrell; Sade Renee,15,0,15,0
1739702039090,EDS 294B,A00,815745,Meyerott; Theresa Ann,15,0,15,0
1739702040125,EDS 296,001,814911,Ambo; Theresa Jean,10,0,10,0
1739702040125,EDS 296,002,814917,Aragon; Maria Jose,9,0,10,1
1739702040125,EDS 296,003,814918,Bintliff; Amy S.V.,10,0,10,0
1739702040125,EDS 296,004,814922,Chapman; Thandeka K,10,0,10,0
1739702040125,EDS 296,005,814927,Cohen; Shana R,10,0,10,0
1739702040125,EDS 296,006,814929,Daly; Alan J.,10,0,10,0
1739702040125,EDS 296,007,814930,Eguchi; Emi,10,0,10,0
1739702040125,EDS 296,008,814947,Datnow; Amanda Lee,10,0,10,0
1739702040125,EDS 296,009,814948,Halter; Christopher P.,10,0,10,0
1739702040125,EDS 296,010,814953,Hofstetter; Carolyn,10,0,10,0
1739702040125,EDS 296,011,814954,Hopkins; Megan Beth,10,0,10,0
1739702040125,EDS 296,012,814955,Jones; Gabrielle Anastasia,10,0,10,0
1739702040125,EDS 296,013,814958,Jones; Makeba,10,0,10,0
1739702040125,EDS 296,014,814961,Mamas; Christoforos,10,0,10,0
1739702040125,EDS 296,015,814962,Museus; Samuel David,10,0,10,0
1739702040125,EDS 296,016,814966,Pollock; Mica,10,0,10,0
1739702040125,EDS 296,017,814967,Wishard Guerra; Alison G.,10,0,10,0
1739702040125,EDS 296,018,886234,Clarke; Sherice Nicole,10,0,10,0
1739702040125,EDS 296,019,886235,Cohen; Shana R,10,0,10,0
1739702040125,EDS 296,020,886236,Fine; Sarah,10,0,10,0
1739702041153,EMED 296,001,866359,Daniel; Michelle Marie,4,0,5,1
1739702041153,EMED 296,002,866361,Staff,5,0,5,0
1739702041153,EMED 296,003,866363,Staff,5,0,5,0
1739702042178,ENG 10,A00,813776,Evdokimenko; Ekaterina,60,0,60,0
1739702043203,ENG 30,A01,869879,Schurgers; Curt,30,0,30,0
1739702044228,ENG 100D,A00,813777,Ngo; Anh-Thu T.,43,0,50,7
1739702044228,ENG 100D,B00,887051,Ngo; Anh-Thu T.,48,0,50,2
1739702045257,ENG 100L,A00,813778,Kleissl; Jan,6,0,6,0
1739702045257,ENG 100L,B00,813780,Bratton; Maryann,8,0,8,0
1739702045257,ENG 100L,C00,813781,Yu; Paul K L,8,0,8,0
1739702045257,ENG 100L,D00,813782,Goldberg; Charles G.,6,0,6,0
1739702045257,ENG 100L,E00,813783,de Oliveira; Mauricio,8,0,8,0
1739702045257,ENG 100L,F00,813852,Bratton; Maryann,6,0,6,0
1739702045257,ENG 100L,G00,813856,Boyle; Mary E. T.,15,0,15,0
1739702045257,ENG 100L,H00,813860,Boyle; Mary E. T.,15,0,15,0
1739702046285,ENVR 102,A00,818253,Lin; Cindy Jih-Shing,23,0,25,2
1739702046285,ENVR 102,B00,818254,Montejo; Carolina,25,0,25,0
1739702046285,ENVR 102,C00,818255,Staff,24,0,25,1
1739702046285,ENVR 102,E00,818257,Daly; Heather Marie,18,0,20,2
1739702047312,ENVR 140,A01,818259,Siapno; Jacqueline A,13,0,15,2
1739702047312,ENVR 140,A02,818260,Siapno; Jacqueline A,13,0,15,2
1739702047312,ENVR 140,A03,818261,Siapno; Jacqueline A,13,0,15,2
1739702047312,ENVR 140,A04,818290,Siapno; Jacqueline A,14,0,15,1
1739702048339,ESYS 103,A01,818299,Lerner; Amy M,30,0,34,4
1739702048339,ESYS 103,A02,818300,Lerner; Amy M,33,0,34,1
1739702048339,ESYS 103,A03,818301,Lerner; Amy M,24,0,34,10
1739702048339,ESYS 103,A04,818302,Lerner; Amy M,32,0,34,2
1739702048339,ESYS 103,A05,818322,Lerner; Amy M,31,0,34,3
1739702048339,ESYS 103,A06,818385,Lerner; Amy M,30,0,30,0
1739702049365,ESYS 187C,A01,818387,Hetherington; Elizabeth Dorsey,32,0,40,8
1739702049365,ESYS 187C,A02,818388,Hetherington; Elizabeth Dorsey,39,0,40,1
1739702050395,ETHN 3R,A01,818390,Okonkwo; Holly,20,0,25,5
1739702050395,ETHN 3R,A02,818391,Okonkwo; Holly,24,0,25,1
1739702050395,ETHN 3R,A03,818392,Okonkwo; Holly,23,0,25,2
1739702050395,ETHN 3R,A04,818393,Okonkwo; Holly,23,0,25,2
1739702050395,ETHN 3R,A05,818394,Okonkwo; Holly,22,0,25,3
1739702050395,ETHN 3R,A06,818395,Okonkwo; Holly,22,0,25,3
1739702050395,ETHN 3R,A07,818396,Okonkwo; Holly,23,0,25,2
1739702050395,ETHN 3R,A08,818397,Okonkwo; Holly,25,0,25,0
1739702050395,ETHN 3R,A09,818398,Okonkwo; Holly,25,0,25,0
1739702050395,ETHN 3R,A10,818399,Okonkwo; Holly,23,0,25,2
1739702050395,ETHN 3R,A11,818400,Okonkwo; Holly,24,0,25,1
1739702050395,ETHN 3R,A12,818401,Okonkwo; Holly,24,0,25,1
1739702050395,ETHN 3R,A13,818402,Okonkwo; Holly,24,0,25,1
1739702050395,ETHN 3R,A14,818403,Okonkwo; Holly,23,0,25,2
1739702051421,ETHN 30,A01,818405,Fuste; Jose Ignacio,24,0,25,1
1739702051421,ETHN 30,A02,818406,Fuste; Jose Ignacio,22,0,25,3
1739702051421,ETHN 30,A03,818407,Fuste; Jose Ignacio,25,0,25,0
1739702051421,ETHN 30,A04,818408,Fuste; Jose Ignacio,25,0,25,0
1739702051421,ETHN 30,A05,818409,Fuste; Jose Ignacio,25,0,25,0
1739702051421,ETHN 30,A06,818410,Fuste; Jose Ignacio,25,0,25,0
1739702052444,ETHN 100C,A00,818411,Fuste; Jose Ignacio,32,0,36,4
1739702053468,ETHN 101,A01,818413,Marez; Curtis F.,23,0,25,2
1739702053468,ETHN 101,A02,818414,Marez; Curtis F.,24,0,25,1
1739702053468,ETHN 101,A03,818415,Marez; Curtis F.,25,0,25,0
1739702053468,ETHN 101,A04,818416,Marez; Curtis F.,23,0,25,2
1739702054493,ETHN 108,A00,818418,Hankins; Sarah E.,15,0,20,5
1739702055518,ETHN 110,A00,818419,Klann; Mary Cameron,23,0,30,7
1739702056542,ETHN 112C,A00,818420,Frank; Ross H.,28,0,30,2
1739702057567,ETHN 121R,A00,818422,Choi; Esther Min,35,0,45,10
1739702058592,ETHN 122B,A00,891172,Museus; Samuel David,50,0,50,0
1739702060642,ETHN 127,A00,818424,Cuong; Marisol,27,0,30,3
1739702061669,ETHN 140,A00,818426,Tran; Ly Thi Hai,30,0,30,0
1739702062750,ETHN 142,A00,818429,Wilson; Brenda K,27,0,30,3
1739702063780,ETHN 147,A00,872912,Staff,20,0,20,0
1739702064809,ETHN 171,A00,869845,Gallagher-Geurtsen; Tricia Meghan,29,0,30,1
1739702065834,ETHN 172,A00,818477,Childs; Dennis R.,20,0,20,0
1739702066864,ETHN 174,A00,818481,Childs; Dennis R.,20,0,20,0
1739702067889,ETHN 182,A00,818487,Streeby; Shelley,58,0,60,2
1739702068915,ETHN 183,A00,818489,Cuong; Marisol,21,0,22,1
1739702069943,ETHN 189,A00,818496,Museus; Samuel David,20,0,20,0
1739702070972,ETHN 196H,A00,885505,Fuste; Jose Ignacio,0,0,0,0
1739702070972,ETHN 196H,B00,885506,Klann; Mary Cameron,0,0,0,0
1739702070972,ETHN 196H,C00,885507,Museus; Samuel David,0,0,0,0
1739702070972,ETHN 196H,D00,885524,Taylor-Garcia; Daphne,0,0,0,0
1739702070972,ETHN 196H,E00,885706,Wilson; Brenda K,0,0,0,1
1739702072000,ETHN 200C,A00,818498,Frank; Ross H.,11,0,15,4
1739702073025,ETHN 230,A00,818501,Perreira; Christopher Michael,11,0,15,4
1739702074050,ETHN 291,A00,818504,Streeby; Shelley,15,0,15,0
1739702075079,ETIM 289,A00,818674,Marez; Curtis F.,11,0,15,4
1739702076107,EXPR 100,A00,871385,Staff,9999,0,9999,0
1739702077135,EXPR 105,A00,871455,Staff,9999,0,9999,0
1739702078163,EXPR 201,A00,871548,Staff,9999,0,9999,0
1739702079188,EXPR 205,A00,871602,Staff,9999,0,9999,0
1739702080216,FILM 71,A01,809813,Staff,9,0,10,1
1739702081242,FILM 72,A01,871143,Staff,9,0,10,1
1739702082270,FILM 73,A01,871145,Staff,8,0,10,2
1739702083298,FILM 87,A00,809816,Rahimi; Babak,20,0,20,0
1739702083298,FILM 87,B00,809859,Rahimi; Babak,20,0,20,0
1739702083298,FILM 87,C00,869076,Havis; Allan,19,0,20,1
1739702084325,FMPH 291,A00,818678,Boutelle; Kerri & Eichen; Dawn,13,0,15,2
1739702084325,FMPH 291,B00,818689,Lacroix; Andrea Zauderer,12,0,15,3
1739702084325,FMPH 291,C00,818694,Shadyab; Aladdin Hassan,15,0,15,0
1739702084325,FMPH 291,D00,818695,Salem; Rany Mansour,12,0,15,3
1739702084325,FMPH 291,E00,818704,Shadyab; Aladdin Hassan,14,0,15,1
1739702084325,FMPH 291,F00,872513,Araneta; Maria Rosario Gorrez,12,0,15,3
1739702084325,FMPH 291,G00,876306,Ross; Camille,13,0,15,2
1739702085350,FPM 276,A00,886086,Zhu; Shu-Hong,14,0,15,1
1739702086377,FPM 286,A00,866428,Johnson; Michelle Lee,0,0,0,0
1739702087402,FPM 296,001,866429,Johnson; Michelle Lee,4,0,5,1
1739702087402,FPM 296,002,866430,Araneta; Maria Rosario Gorrez,5,0,5,0
1739702087402,FPM 296,003,866433,Staff,5,0,5,0
1739702088432,FPM 297,001,881032,Strong; David R,9998,0,9999,1
1739702089458,GLBH 20,A00,818752,Elwardani; Nile Regina,143,0,146,3
1739702090486,GLBH 101,A00,818757,Sloane; Julia Kathryn,39,0,40,1
1739702091514,GLBH 107,A00,818758,Wilson; Brenda K,65,0,70,5
1739702092543,GLBH 108,A00,818759,Olivas Hernandez; Olga Lid,68,0,70,2
1739702093570,GLBH 111,A01,818761,Burgos; Jose L.,0,0,0,0
1739702093570,GLBH 111,B01,818763,Burgos; Jose L.,0,0,0,0
1739702094597,GLBH 114W,A00,818764,Walkover; Lillian B,16,0,17,1
1739702096648,GLBH 121,A00,870699,Villarino; Margarita,42,0,44,2
1739702097674,GLBH 130,A00,870701,Schonberg; Jeffrey,38,0,40,2
1739702098700,GLBH 131,A00,870812,Staff,43,0,44,1
1739702099725,GLBH 147,A00,818766,Stewart; Alexander B,38,0,40,2
1739702100750,GLBH 148,A00,818828,Schonberg; Jeffrey,95,0,100,5
1739702101778,GLBH 150B,A00,818838,Kaiser; Bronwyn Nicole,14,0,15,1
1739702102804,GLBH 181,A00,818842,Burgos; Jose L.,207,0,216,9
1739702103829,GLBH 190,A00,870700,Bhavsar; Radhika,44,0,44,0
1739702104853,GLBH 215,A00,818849,Walkover; Lillian B,7,0,16,9
1739702105878,GLBH 260,A00,818858,Elwardani; Nile Regina,16,0,16,0
1739702106903,GSS 20,A00,818859,Siapno; Jacqueline A,27,0,30,3
1739702107929,GSS 21,A00,818860,Gyamfi; Bright,29,0,30,1
1739702108953,HDS 1,A01,819050,Staff,29,0,30,1
1739702108953,HDS 1,A02,819053,Staff,28,0,30,2
1739702108953,HDS 1,A03,819074,Staff,29,0,30,1
1739702108953,HDS 1,A04,819075,Staff,30,0,30,0
1739702108953,HDS 1,A05,819076,Staff,29,0,30,1
1739702108953,HDS 1,A06,819077,Staff,30,0,30,0
1739702108953,HDS 1,A07,819078,Staff,29,0,30,1
1739702109978,HDS 60,A01,819095,Staff,32,0,35,3
1739702109978,HDS 60,A02,819096,Staff,35,0,35,0
1739702111006,HDS 95,A00,819097,Staff,36,0,40,4
1739702112031,HDS 120,A00,819098,Staff,91,0,100,9
1739702113055,HDS 122,A00,819099,Staff,96,0,100,4
1739702114080,HDS 150,A00,819100,Staff,12,0,12,0
1739702114080,HDS 150,B00,819122,Staff,12,0,12,0
1739702114080,HDS 150,C00,819123,Staff,12,0,12,0
1739702115105,HDS 175,A00,819142,Staff,32,0,35,3
1739702116133,HDS 181,A01,819144,Staff,35,0,35,0
1739702117160,HDS 191,A01,819146,Staff,20,0,20,0
1739702117160,HDS 191,B01,819223,Staff,20,0,20,0
1739702118183,HIAF 112,A00,841742,Gyamfi; Bright,45,0,46,1
1739702119208,HIEA 114,A00,841743,Matsumura; Wendy Y,36,0,50,14
1739702120235,HIEA 131,A00,841744,Muscolino; Micah S,41,0,44,3
1739702121260,HIEA 138,A00,841747,Lu; Weijing,30,0,30,0
1739702122288,HIEA 144,A00,870811,Henry; Todd A.,24,0,25,1
1739702123313,HIEU 128,A00,841749,Hansen; Jan Eric,66,0,70,4
1739702124337,HIEU 138,A00,841750,Devereux; Andrew W,53,0,56,3
1739702125364,HIEU 146,A00,841751,Radcliff; Pamela B.,44,0,50,6
1739702126389,HIEU 148,A00,841753,Biess; Frank Peter,116,0,120,4
1739702127415,HIEU 160,A00,841754,Demetriou; Denise,11,0,15,4
1739702128439,HIEU 183,A00,870697,Gallant; Thomas W.,10,0,10,0
1739702129467,HIEU 184,A00,841757,Patterson; Patrick H.,15,0,15,0
1739702130492,HIEU 283,A00,870698,Gallant; Thomas W.,10,0,10,0
1739702131517,HIGL 126,A00,841758,Gerth; Karl G.,34,0,34,0
1739702132542,HIGR 209,A00,841771,Hanna; Mark G.,10,0,10,0
1739702133569,HIGR 210,A00,841772,Gerth; Karl G.,9,0,10,1
1739702134600,HIGR 220,A00,872411,Strasser; Ulrike,9,0,10,1
1739702135624,HIGR 239,A00,841774,Gere; Catherina M.,9,0,10,1
1739702136650,HIGR 240,A00,841777,McKenzie; Kerry V.,9,0,10,1
1739702137674,HIGR 248B,A00,841778,Vitz; Matthew,10,0,10,0
1739702138700,HIGR 280,A00,841779,Devereux; Andrew W,10,0,10,0
1739702139728,HIGR 282,A00,871856,Henry; Todd A.,10,0,10,0
1739702140754,HILA 132,A00,841759,Vitz; Matthew,141,0,146,5
1739702141782,HILA 144P,A00,869962,Murillo; Dana V.,49,0,50,1
1739702142807,HILD 2C,A01,862763,Hendrickson; Gerald M.,30,0,32,2
1739702142807,HILD 2C,A02,862769,Hendrickson; Gerald M.,30,0,32,2
1739702142807,HILD 2C,A03,862772,Hendrickson; Gerald M.,32,0,32,0
1739702142807,HILD 2C,A04,862774,Hendrickson; Gerald M.,32,0,32,0
1739702142807,HILD 2C,A05,862777,Hendrickson; Gerald M.,31,0,32,1
1739702142807,HILD 2C,A06,862778,Hendrickson; Gerald M.,32,0,32,0
1739702143833,HILD 7B,A01,862780,Martinez-Matsuda; Veronica,32,0,32,0
1739702143833,HILD 7B,A02,862781,Martinez-Matsuda; Veronica,32,0,32,0
1739702143833,HILD 7B,A03,862782,Martinez-Matsuda; Veronica,29,0,32,3
1739702143833,HILD 7B,A04,862783,Martinez-Matsuda; Veronica,31,0,32,1
1739702143833,HILD 7B,A05,862784,Martinez-Matsuda; Veronica,28,0,32,4
1739702143833,HILD 7B,A06,862788,Martinez-Matsuda; Veronica,31,0,32,1
1739702143833,HILD 7B,A07,862789,Martinez-Matsuda; Veronica,32,0,32,0
1739702143833,HILD 7B,A08,862797,Martinez-Matsuda; Veronica,32,0,32,0
1739702143833,HILD 7B,A09,862798,Martinez-Matsuda; Veronica,32,0,32,0
1739702143833,HILD 7B,A10,862799,Martinez-Matsuda; Veronica,30,0,32,2
1739702143833,HILD 7B,A11,862801,Martinez-Matsuda; Veronica,32,0,32,0
1739702143833,HILD 7B,A12,862802,Martinez-Matsuda; Veronica,32,0,32,0
1739702144861,HILD 12,A01,862804,Matsumura; Wendy Y,31,0,32,1
1739702144861,HILD 12,A02,862987,Matsumura; Wendy Y,31,0,32,1
1739702144861,HILD 12,A03,862989,Matsumura; Wendy Y,0,0,0,0
1739702144861,HILD 12,A04,862991,Matsumura; Wendy Y,0,0,0,0
1739702144861,HILD 12,A05,863014,Matsumura; Wendy Y,31,0,32,1
1739702144861,HILD 12,A06,863015,Matsumura; Wendy Y,32,0,32,0
1739702145885,HILD 42,A01,863016,Gere; Catherina M.,31,0,32,1
1739702145885,HILD 42,A02,863017,Gere; Catherina M.,32,0,32,0
1739702146910,HINE 115,A00,841762,Balberg; Mira,44,0,56,12
1739702147934,HINE 116,A00,869964,Gokatalay; Semih,35,0,35,0
1739702148959,HINE 120,A00,869963,Gokatalay; Semih,35,0,35,0
1739702149986,HISA 101,A00,871799,De; Aniket,35,0,35,0
1739702151011,HISA 120,A00,871840,De; Aniket,34,0,35,1
1739702152040,HITO 87,A00,841738,Patterson; Patrick H.,15,0,15,0
1739702152040,HITO 87,B00,841740,Patterson; Patrick H.,14,0,15,1
1739702153067,HITO 100,B00,841764,Kwak; Nancy,23,0,25,2
1739702154093,HITO 170,A00,841765,Watts; Edward J.,9,0,10,1
1739702155120,HITO 193,A00,851603,Staff,0,0,0,0
1739702156143,HIUS 104,A00,841766,Hanna; Mark G.,142,0,146,4
1739702157167,HIUS 114A,A00,841767,Lewandoski; Julia Mavis,48,0,50,2
1739702158192,HIUS 144,B00,841769,Daly; Heather Marie,39,0,40,1
1739702159238,HUM 2,A01,832551,Crum; Matthew Stephen,15,0,15,0
1739702159238,HUM 2,A02,832552,Crum; Matthew Stephen,14,0,15,1
1739702159238,HUM 2,A03,832553,Crum; Matthew Stephen,15,0,15,0
1739702159238,HUM 2,A04,832554,Crum; Matthew Stephen,14,0,15,1
1739702159238,HUM 2,A05,832555,Crum; Matthew Stephen,15,0,15,0
1739702159238,HUM 2,A06,832557,Crum; Matthew Stephen,14,0,15,1
1739702159238,HUM 2,A07,832600,Crum; Matthew Stephen,14,0,15,1
1739702159238,HUM 2,A08,832662,Crum; Matthew Stephen,15,0,15,0
1739702159238,HUM 2,A09,832667,Crum; Matthew Stephen,13,0,15,2
1739702159238,HUM 2,A10,832671,Crum; Matthew Stephen,15,0,15,0
1739702159238,HUM 2,A11,832673,Crum; Matthew Stephen,15,0,15,0
1739702159238,HUM 2,A12,832675,Crum; Matthew Stephen,15,0,15,0
1739702159238,HUM 2,A13,832680,Crum; Matthew Stephen,15,0,15,0
1739702159238,HUM 2,A14,832682,Crum; Matthew Stephen,15,0,15,0
1739702159238,HUM 2,B01,832686,Watts; Edward J.,7,0,15,8
1739702159238,HUM 2,B02,832688,Watts; Edward J.,14,0,15,1
1739702159238,HUM 2,B03,832693,Watts; Edward J.,15,0,15,0
1739702159238,HUM 2,B04,832694,Watts; Edward J.,15,0,15,0
1739702159238,HUM 2,B05,832739,Watts; Edward J.,15,0,15,0
1739702159238,HUM 2,B06,832742,Watts; Edward J.,14,0,15,1
1739702159238,HUM 2,B07,832756,Watts; Edward J.,15,0,15,0
1739702159238,HUM 2,B08,832760,Watts; Edward J.,13,0,15,2
1739702159238,HUM 2,B09,832762,Watts; Edward J.,15,0,15,0
1739702159238,HUM 2,B10,832764,Watts; Edward J.,13,0,15,2
1739702159238,HUM 2,B11,832767,Watts; Edward J.,15,0,15,0
1739702159238,HUM 2,B12,832770,Watts; Edward J.,14,0,15,1
1739702159238,HUM 2,B13,832775,Watts; Edward J.,13,0,15,2
1739702159238,HUM 2,B14,832776,Watts; Edward J.,12,0,15,3
1739702159238,HUM 2,C01,832784,Markman; Kristina,15,0,15,0
1739702159238,HUM 2,C02,832785,Markman; Kristina,15,0,15,0
1739702159238,HUM 2,C03,832787,Markman; Kristina,14,0,15,1
1739702159238,HUM 2,C04,832789,Markman; Kristina,6,0,15,9
1739702159238,HUM 2,C05,832790,Markman; Kristina,15,0,15,0
1739702159238,HUM 2,C06,832793,Markman; Kristina,15,0,15,0
1739702159238,HUM 2,C07,832794,Markman; Kristina,15,0,15,0
1739702159238,HUM 2,C08,832804,Markman; Kristina,15,0,15,0
1739702159238,HUM 2,C09,832805,Markman; Kristina,15,0,15,0
1739702159238,HUM 2,C10,832946,Markman; Kristina,14,0,15,1
1739702159238,HUM 2,C11,833014,Markman; Kristina,15,0,15,0
1739702159238,HUM 2,C12,833037,Markman; Kristina,15,0,15,0
1739702159238,HUM 2,C13,833075,Markman; Kristina,15,0,15,0
1739702159238,HUM 2,C14,833078,Markman; Kristina,13,0,15,2
1739702160264,HUM 5,A01,833083,Lyon; Antony J.,21,0,28,7
1739702160264,HUM 5,A02,833086,Lyon; Antony J.,28,0,28,0
1739702160264,HUM 5,A03,833090,Lyon; Antony J.,27,0,28,1
1739702160264,HUM 5,A04,833095,Lyon; Antony J.,26,0,28,2
1739702160264,HUM 5,A05,833096,Lyon; Antony J.,27,0,28,1
1739702160264,HUM 5,A06,833099,Lyon; Antony J.,26,0,28,2
1739702160264,HUM 5,A07,833110,Lyon; Antony J.,26,0,28,2
1739702160264,HUM 5,A08,833112,Lyon; Antony J.,27,0,28,1
1739702160264,HUM 5,B01,833118,Rodriguez; Bretton Sigfred,24,0,28,4
1739702160264,HUM 5,B02,833122,Rodriguez; Bretton Sigfred,25,0,28,3
1739702160264,HUM 5,B03,833128,Rodriguez; Bretton Sigfred,19,0,28,9
1739702160264,HUM 5,B04,833129,Rodriguez; Bretton Sigfred,24,0,28,4
1739702160264,HUM 5,B05,833133,Rodriguez; Bretton Sigfred,27,0,28,1
1739702160264,HUM 5,B06,833138,Rodriguez; Bretton Sigfred,27,0,28,1
1739702160264,HUM 5,B07,833140,Rodriguez; Bretton Sigfred,27,0,28,1
1739702160264,HUM 5,B08,833141,Rodriguez; Bretton Sigfred,28,0,28,0
1739702160264,HUM 5,C01,833158,West; Geoffrey Scott,20,0,28,8
1739702160264,HUM 5,C02,833159,West; Geoffrey Scott,23,0,28,5
1739702160264,HUM 5,C03,833163,West; Geoffrey Scott,28,0,28,0
1739702160264,HUM 5,C04,833165,West; Geoffrey Scott,27,0,28,1
1739702160264,HUM 5,C05,833168,West; Geoffrey Scott,26,0,28,2
1739702160264,HUM 5,C06,833171,West; Geoffrey Scott,23,0,28,5
1739702160264,HUM 5,C07,833172,West; Geoffrey Scott,26,0,28,2
1739702160264,HUM 5,C08,833176,West; Geoffrey Scott,24,0,28,4
1739702161290,HUM 100,A00,833179,Shenoy; Niyati,16,0,16,0
1739702161290,HUM 100,B00,833180,Shenoy; Niyati,16,0,16,0
1739702161290,HUM 100,C00,833187,Zavodny; Tatiana Sophia,15,0,16,1
1739702161290,HUM 100,D00,833190,Zavodny; Tatiana Sophia,15,0,16,1
1739702161290,HUM 100,E00,833196,West; Geoffrey Scott,15,0,16,1
1739702161290,HUM 100,F00,833199,West; Geoffrey Scott,15,0,16,1
1739702162325,INTL 100,A01,819235,Feuer; Anna Stagg,24,0,25,1
1739702162325,INTL 100,A02,819246,Feuer; Anna Stagg,24,0,25,1
1739702162325,INTL 100,A03,819251,Feuer; Anna Stagg,25,0,25,0
1739702162325,INTL 100,A04,819252,Feuer; Anna Stagg,21,0,25,4
1739702162325,INTL 100,A05,819256,Feuer; Anna Stagg,25,0,25,0
1739702162325,INTL 100,A06,819260,Feuer; Anna Stagg,25,0,25,0
1739702163352,INTL 101,A01,819264,McCord; Gordon Carlos,27,0,35,8
1739702163352,INTL 101,A02,819266,McCord; Gordon Carlos,32,0,35,3
1739702164378,INTL 102,A01,819271,Fisk; David Lee,29,0,35,6
1739702164378,INTL 102,A02,819279,Fisk; David Lee,27,0,35,8
1739702165407,INTL 190,A00,819281,Lettieri; Michael Joseph,0,0,0,2
1739702165407,INTL 190,B00,819301,Vos; Stacie N.,0,0,0,0
1739702165407,INTL 190,C00,819303,McIntosh; Justin,0,0,0,2
1739702165407,INTL 190,D00,819389,Segui; Alan S,0,0,0,2
1739702165407,INTL 190,E00,819393,Segui; Alan S,0,0,0,1
1739702165407,INTL 190,F00,819394,Auerbach; Bradford C,0,0,0,0
1739702165407,INTL 190,G00,819395,Samphantharak; Krislert,0,0,0,2
1739702166498,JAPN 10C,A01,819403,Maruyama; Rie,14,0,15,1
1739702166498,JAPN 10C,B01,819406,McKee; Mayumi Mochizuki,13,0,15,2
1739702166498,JAPN 10C,C01,819448,Ross; Kayoko F,14,0,15,1
1739702166498,JAPN 10C,D01,819450,Sato; Kyoko,15,0,15,0
1739702166498,JAPN 10C,E01,819454,Kamioka; Sachiko,13,0,15,2
1739702166498,JAPN 10C,F01,819457,McKee; Mayumi Mochizuki,10,0,15,5
1739702166498,JAPN 10C,G01,819459,Tipton; Yuko,12,0,15,3
1739702166498,JAPN 10C,H01,819466,Sato; Kyoko,15,0,15,0
1739702166498,JAPN 10C,I01,819486,Homma; Kunihiko,14,0,15,1
1739702166498,JAPN 10C,J01,819536,Tipton; Yuko,15,0,15,0
1739702166498,JAPN 10C,K01,819584,Kamioka; Sachiko,14,0,15,1
1739702167530,JAPN 10CR,A01,819684,Inada; Minori,12,0,12,0
1739702167530,JAPN 10CR,B01,819741,McKee; Mayumi Mochizuki,12,0,12,0
1739702168558,JAPN 20C,A01,819791,Iwamoto; Naoki,13,0,13,0
1739702168558,JAPN 20C,B01,819874,Homma; Kunihiko,12,0,13,1
1739702168558,JAPN 20C,C01,819904,Iwamoto; Naoki,12,0,13,1
1739702168558,JAPN 20C,D01,819934,Takeda; Izumi,12,0,13,1
1739702168558,JAPN 20C,E01,819936,Simpson; Junko Tokuda,13,0,13,0
1739702169586,JAPN 130C,A01,819938,Maruyama; Rie,12,0,12,0
1739702169586,JAPN 130C,B01,820148,Kamioka; Sachiko,9,0,12,3
1739702170610,JAPN 135C,A00,820169,Ross; Kayoko F,11,0,12,1
1739702170610,JAPN 135C,B00,820192,Iwamoto; Naoki,10,0,12,2
1739702171636,JAPN 137C,A00,820201,Simpson; Junko Tokuda,17,0,20,3
1739702172662,JAPN 140C,A00,820210,Takeda; Izumi,19,0,20,1
1739702173687,JWSP 3,A01,820218,Shuster; Alana,15,0,15,0
1739702174715,LATI 10,A01,820230,Kennemore; Amy Michelle,28,0,30,2
1739702174715,LATI 10,A02,820286,Kennemore; Amy Michelle,29,0,30,1
1739702174715,LATI 10,A03,820289,Kennemore; Amy Michelle,29,0,30,1
1739702174715,LATI 10,A04,820293,Kennemore; Amy Michelle,29,0,30,1
1739702174715,LATI 10,A05,820380,Kennemore; Amy Michelle,30,0,30,0
1739702174715,LATI 10,A06,820381,Kennemore; Amy Michelle,29,0,30,1
1739702175740,LATI 50,A01,820465,Kokinis; Troy Andreas,29,0,30,1
1739702175740,LATI 50,A02,820466,Kokinis; Troy Andreas,30,0,30,0
1739702175740,LATI 50,A03,820470,Kokinis; Troy Andreas,0,0,0,0
1739702175740,LATI 50,A04,820490,Kokinis; Troy Andreas,0,0,0,0
1739702175740,LATI 50,A05,872455,Kokinis; Troy Andreas,0,0,0,0
1739702176765,LATI 130,A00,820527,Alvarez; Camila Huerta,46,0,46,0
1739702177790,LATI 131,A00,869142,Villafuerte Vazquez; Nadia,30,0,30,0
1739702179845,LATI 166,A00,886084,Kokinis; Troy Andreas,42,0,42,0
1739702180870,LATI 180,A00,820555,Kennemore; Amy Michelle,40,0,44,4
1739702181895,LIAB 1C,B00,820742,Saab; Dima,12,0,14,2
1739702181895,LIAB 1C,C00,820744,Saab; Dima,12,0,14,2
1739702182918,LIAB 1CX,A00,820745,El Cheddadi; Youniss,25,0,28,3
1739702183943,LIAB 1F,A00,872423,El Cheddadi; Youniss,15,0,15,0
1739702184970,LIDS 19,001,886201,Goodall; Grant Todd,9999,0,9999,0
1739702184970,LIDS 19,002,886202,Goodall; Grant Todd,9999,0,9999,0
1739702184970,LIDS 19,003,886204,Goodall; Grant Todd,9999,0,9999,0
1739702184970,LIDS 19,004,886207,Goodall; Grant Todd,9999,0,9999,0
1739702184970,LIDS 19,005,886208,Goodall; Grant Todd,9999,0,9999,0
1739702184970,LIDS 19,006,886209,Goodall; Grant Todd,9999,0,9999,0
1739702184970,LIDS 19,007,886210,Goodall; Grant Todd,9999,0,9999,0
1739702184970,LIDS 19,008,886211,Goodall; Grant Todd,9999,0,9999,0
1739702184970,LIDS 19,009,886213,Goodall; Grant Todd,9999,0,9999,0
1739702184970,LIDS 19,010,886214,Goodall; Grant Todd,9999,0,9999,0
1739702184970,LIDS 19,011,886215,Goodall; Grant Todd,9999,0,9999,0
1739702184970,LIDS 19,012,886216,Goodall; Grant Todd,9999,0,9999,0
1739702185995,LIFR 1A,C00,820857,Van Moer; Vinciane G,12,0,14,2
1739702185995,LIFR 1A,D00,820858,Van Moer; Vinciane G,14,0,14,0
1739702187022,LIFR 1AX,B00,820861,Van Moer; Vinciane G,27,0,28,1
1739702188047,LIFR 1C,A00,820862,Van Moer; Vinciane G,12,0,14,2
1739702188047,LIFR 1C,B00,820916,Van Moer; Vinciane G,12,0,14,2
1739702188047,LIFR 1C,C00,820970,Van Moer; Vinciane G,14,0,14,0
1739702188047,LIFR 1C,D00,820971,Van Moer; Vinciane G,13,0,14,1
1739702189072,LIFR 1CX,A00,820972,Van Moer; Vinciane G,26,0,28,2
1739702189072,LIFR 1CX,B00,820973,Van Moer; Vinciane G,26,0,28,2
1739702190102,LIFR 1D,A00,820974,Van Moer; Vinciane G,13,0,14,1
1739702190102,LIFR 1D,B00,820975,Van Moer; Vinciane G,11,0,14,3
1739702190102,LIFR 1D,C00,820976,Van Moer; Vinciane G,14,0,14,0
1739702190102,LIFR 1D,D00,820977,Van Moer; Vinciane G,14,0,14,0
1739702191127,LIFR 1DX,A00,820978,Van Moer; Vinciane G,25,0,28,3
1739702191127,LIFR 1DX,B00,820979,Van Moer; Vinciane G,28,0,28,0
1739702192155,LIFR 11,001,820980,Goodall; Grant Todd,9999,0,9999,0
1739702193180,LIGM 1C,A00,820981,Fischer-Grunski; Eva K,14,0,14,0
1739702193180,LIGM 1C,B00,820982,Fischer-Grunski; Eva K,11,0,14,3
1739702194206,LIGM 1CX,A00,820985,Fischer-Grunski; Eva K,13,0,14,1
1739702194206,LIGM 1CX,B00,820986,Fischer-Grunski; Eva K,13,0,14,1
1739702195229,LIGM 11,001,820987,Goodall; Grant Todd,9999,0,9999,0
1739702196256,LIGN 8,A00,821976,McIntosh; Justin,238,0,250,12
1739702197281,LIGN 17,A00,821977,Kehler; Andrew Scott,247,0,250,3
1739702198307,LIGN 101,A01,821980,Staff,35,0,35,0
1739702198307,LIGN 101,A02,821982,Staff,35,0,35,0
1739702198307,LIGN 101,A03,821983,Staff,35,0,35,0
1739702198307,LIGN 101,A04,821984,Staff,35,0,35,0
1739702199330,LIGN 113,A00,821985,Styler; William Francis,88,0,90,2
1739702200358,LIGN 117,A00,869927,Kehler; Andrew Scott,42,0,50,8
1739702201383,LIGN 120,A01,821987,Caballero; Gabriela Hernandez,23,0,25,2
1739702201383,LIGN 120,A02,821988,Caballero; Gabriela Hernandez,22,0,25,3
1739702201383,LIGN 120,A03,821990,Caballero; Gabriela Hernandez,20,0,25,5
1739702202409,LIGN 146,A00,821992,Lott; Margaret S.,27,0,30,3
1739702203435,LIGN 165,A00,821993,Bergen; Leon,51,0,70,19
1739702204463,LIGN 180,A00,821994,Kluender; Robert,63,0,70,7
1739702205490,LIGN 188R,A00,821996,Clem; Emily,40,0,40,0
1739702206516,LIGN 200,A00,821997,Warstadt; Alexander Scott,35,0,35,0
1739702207541,LIGN 211,A00,821999,Bakovic; Eric John,20,0,20,0
1739702208566,LIGN 220,A00,822003,Caballero; Gabriela Hernandez,18,0,20,2
1739702209590,LIGN 225,A00,822004,Goodall; Grant Todd,20,0,20,0
1739702210615,LIGN 238,A00,822005,Bergen; Benjamin,20,0,20,0
1739702211643,LIGN 252,A00,822006,Bergen; Leon,14,0,15,1
1739702212668,LIGN 279,A00,822007,Dudley; Rachel,17,0,20,3
1739702213695,LIGN 296,001,821907,Ackerman; Farrell,5,0,5,0
1739702213695,LIGN 296,002,821908,Bakovic; Eric John,5,0,5,0
1739702213695,LIGN 296,003,821909,Bergen; Leon,5,0,5,0
1739702213695,LIGN 296,004,821910,Caballero; Gabriela Hernandez,5,0,5,0
1739702213695,LIGN 296,005,821912,Caponigro; Ivano,5,0,5,0
1739702213695,LIGN 296,006,821913,Clem; Emily,5,0,5,0
1739702213695,LIGN 296,007,821914,Dudley; Rachel,5,0,5,0
1739702213695,LIGN 296,008,821916,Garellek; Marc,5,0,5,0
1739702213695,LIGN 296,009,821917,Goodall; Grant Todd,5,0,5,0
1739702213695,LIGN 296,010,821918,Kehler; Andrew Scott,5,0,5,0
1739702213695,LIGN 296,011,821919,Kluender; Robert,5,0,5,0
1739702213695,LIGN 296,012,821920,Mayberry; Rachel,5,0,5,0
1739702213695,LIGN 296,013,821921,Rose; Sharon,5,0,5,0
1739702213695,LIGN 296,014,821924,Styler; William Francis,5,0,5,0
1739702213695,LIGN 296,015,821925,Warstadt; Alexander Scott,5,0,5,0
1739702214721,LIHL 112P,A00,820733,Pagkalinawan; Leticia Cant,29,0,30,1
1739702215753,LIHL 114P,A00,820734,Nguyen; Hoan Thi,29,0,30,1
1739702216778,LIHL 117P,A00,820735,Sadegholvad; Elham,28,0,28,0
1739702217802,LIHL 118,A00,820736,Chen; Areana Yen,30,0,30,0
1739702218826,LIHL 124P,A00,820737,Nguyen; Hoan Thi,26,0,28,2
1739702219854,LIHL 132P,A00,820738,Pagkalinawan; Leticia Cant,28,0,28,0
1739702220878,LIHL 134P,A00,820739,Nguyen; Hoan Thi,28,0,28,0
1739702221906,LIHL 138,A00,820740,Chen; Areana Yen,15,0,16,1
1739702222932,LIIT 1C,A00,820988,Carnelos; Chiara,13,0,14,1
1739702222932,LIIT 1C,B00,820989,Carnelos; Chiara,9,0,14,5
1739702223957,LIIT 1CX,A00,820990,Carnelos; Chiara,23,0,28,5
1739702224984,LIPO 1C,A00,820991,Paladini; Denise,14,0,14,0
1739702224984,LIPO 1C,B00,820992,Paladini; Denise,14,0,14,0
1739702226010,LIPO 1CX,A00,820993,De Abreu; Cassia,28,0,28,0
1739702227039,LISL 1A,A00,820994,Lott; Margaret S.,13,0,14,1
1739702227039,LISL 1A,B00,820995,Lott; Margaret S.,14,0,14,0
1739702227039,LISL 1A,C00,820996,Lott; Margaret S.,13,0,14,1
1739702227039,LISL 1A,D00,820997,Lott; Margaret S.,14,0,14,0
1739702227039,LISL 1A,E00,820998,Lott; Margaret S.,14,0,14,0
1739702227039,LISL 1A,F00,820999,Lott; Margaret S.,14,0,14,0
1739702228064,LISL 1AR,A00,821000,Lott; Margaret S.,12,0,15,3
1739702228064,LISL 1AR,B00,821001,Lott; Margaret S.,12,0,15,3
1739702228064,LISL 1AR,C00,885716,Lott; Margaret S.,3,0,3,0
1739702228064,LISL 1AR,D00,885778,Lott; Margaret S.,3,0,3,0
1739702229092,LISL 1AX,A00,821002,Lott; Margaret S.,27,0,28,1
1739702229092,LISL 1AX,B00,821003,Lott; Margaret S.,28,0,28,0
1739702229092,LISL 1AX,C00,821004,Lott; Margaret S.,27,0,28,1
1739702230119,LISL 1C,A00,821009,Lott; Margaret S.,12,0,14,2
1739702230119,LISL 1C,B00,821010,Lott; Margaret S.,14,0,14,0
1739702230119,LISL 1C,C00,821011,Lott; Margaret S.,13,0,14,1
1739702230119,LISL 1C,D00,821012,Lott; Margaret S.,14,0,14,0
1739702230119,LISL 1C,E00,821022,Lott; Margaret S.,12,0,14,2
1739702230119,LISL 1C,F00,821023,Lott; Margaret S.,14,0,14,0
1739702231144,LISL 1CX,A00,821024,Lott; Margaret S.,26,0,28,2
1739702231144,LISL 1CX,B00,821027,Lott; Margaret S.,23,0,28,5
1739702231144,LISL 1CX,C00,821029,Lott; Margaret S.,28,0,28,0
1739702232171,LISL 1D,A00,821030,Lott; Margaret S.,13,0,14,1
1739702232171,LISL 1D,B00,821083,Lott; Margaret S.,14,0,14,0
1739702232171,LISL 1D,C00,821084,Lott; Margaret S.,14,0,14,0
1739702232171,LISL 1D,D00,821148,Lott; Margaret S.,8,0,14,6
1739702233195,LISL 1DX,A00,821160,Lott; Margaret S.,23,0,28,5
1739702233195,LISL 1DX,B00,821165,Lott; Margaret S.,27,0,28,1
1739702234219,LISP 1A,001,821174,Munoz Sanchez; Alicia,12,0,14,2
1739702234219,LISP 1A,002,821175,Munoz Sanchez; Alicia,12,0,14,2
1739702234219,LISP 1A,003,821179,Munoz Sanchez; Alicia,12,0,14,2
1739702234219,LISP 1A,004,821180,Munoz Sanchez; Alicia,13,0,14,1
1739702235245,LISP 1AX,001,821196,Munoz Sanchez; Alicia,26,0,28,2
1739702235245,LISP 1AX,002,821204,Munoz Sanchez; Alicia,26,0,28,2
1739702236275,LISP 1C,001,821226,Munoz Sanchez; Alicia,14,0,14,0
1739702236275,LISP 1C,002,821250,Munoz Sanchez; Alicia,13,0,14,1
1739702236275,LISP 1C,003,821251,Munoz Sanchez; Alicia,12,0,14,2
1739702236275,LISP 1C,004,821259,Munoz Sanchez; Alicia,14,0,14,0
1739702236275,LISP 1C,005,821274,Munoz Sanchez; Alicia,12,0,14,2
1739702236275,LISP 1C,006,821280,Munoz Sanchez; Alicia,13,0,14,1
1739702236275,LISP 1C,007,821281,Munoz Sanchez; Alicia,13,0,14,1
1739702236275,LISP 1C,009,821299,Munoz Sanchez; Alicia,13,0,14,1
1739702236275,LISP 1C,010,821300,Munoz Sanchez; Alicia,14,0,14,0
1739702237300,LISP 1CX,001,821305,Munoz Sanchez; Alicia,30,0,32,2
1739702237300,LISP 1CX,002,821312,Munoz Sanchez; Alicia,31,0,32,1
1739702237300,LISP 1CX,004,821314,Munoz Sanchez; Alicia,28,0,32,4
1739702237300,LISP 1CX,005,821343,Munoz Sanchez; Alicia,28,0,32,4
1739702238331,LISP 1D,002,821390,Munoz Sanchez; Alicia,13,0,14,1
1739702238331,LISP 1D,003,821391,Munoz Sanchez; Alicia,14,0,14,0
1739702238331,LISP 1D,004,821392,Munoz Sanchez; Alicia,14,0,14,0
1739702238331,LISP 1D,005,821393,Munoz Sanchez; Alicia,13,0,14,1
1739702238331,LISP 1D,006,821395,Munoz Sanchez; Alicia,13,0,14,1
1739702238331,LISP 1D,007,821396,Munoz Sanchez; Alicia,14,0,14,0
1739702238331,LISP 1D,008,821397,Munoz Sanchez; Alicia,14,0,14,0
1739702238331,LISP 1D,009,821398,Munoz Sanchez; Alicia,14,0,14,0
1739702238331,LISP 1D,011,821400,Munoz Sanchez; Alicia,13,0,14,1
1739702238331,LISP 1D,012,821401,Munoz Sanchez; Alicia,12,0,14,2
1739702238331,LISP 1D,013,821402,Munoz Sanchez; Alicia,14,0,14,0
1739702238331,LISP 1D,014,821403,Munoz Sanchez; Alicia,14,0,14,0
1739702238331,LISP 1D,015,821404,Munoz Sanchez; Alicia,12,0,14,2
1739702238331,LISP 1D,016,821405,Munoz Sanchez; Alicia,11,0,14,3
1739702238331,LISP 1D,017,821406,Munoz Sanchez; Alicia,14,0,14,0
1739702238331,LISP 1D,018,821407,Munoz Sanchez; Alicia,14,0,14,0
1739702238331,LISP 1D,019,821408,Munoz Sanchez; Alicia,14,0,14,0
1739702238331,LISP 1D,020,821409,Munoz Sanchez; Alicia,14,0,14,0
1739702238331,LISP 1D,021,821410,Munoz Sanchez; Alicia,13,0,14,1
1739702238331,LISP 1D,022,821411,Munoz Sanchez; Alicia,14,0,14,0
1739702238331,LISP 1D,023,821412,Munoz Sanchez; Alicia,14,0,14,0
1739702238331,LISP 1D,024,821413,Munoz Sanchez; Alicia,14,0,14,0
1739702239357,LISP 1DX,001,821414,Munoz Sanchez; Alicia,27,0,28,1
1739702239357,LISP 1DX,002,821415,Munoz Sanchez; Alicia,28,0,28,0
1739702239357,LISP 1DX,003,821416,Munoz Sanchez; Alicia,27,0,28,1
1739702239357,LISP 1DX,004,821417,Munoz Sanchez; Alicia,24,0,28,4
1739702239357,LISP 1DX,005,821418,Munoz Sanchez; Alicia,28,0,28,0
1739702239357,LISP 1DX,006,821419,Munoz Sanchez; Alicia,24,0,28,4
1739702239357,LISP 1DX,007,821420,Munoz Sanchez; Alicia,28,0,28,0
1739702239357,LISP 1DX,008,821430,Munoz Sanchez; Alicia,26,0,28,2
1739702239357,LISP 1DX,009,821434,Munoz Sanchez; Alicia,28,0,28,0
1739702239357,LISP 1DX,010,821478,Munoz Sanchez; Alicia,27,0,28,1
1739702239357,LISP 1DX,011,821489,Munoz Sanchez; Alicia,28,0,28,0
1739702240380,LISP 17,001,821599,Munoz Sanchez; Alicia,17,0,20,3
1739702241407,LISP 18,001,821606,Munoz Sanchez; Alicia,18,0,20,2
1739702242432,LTAM 111,A00,822939,Johnson; Sara E.,39,0,40,1
1739702243458,LTCH 101,A00,822940,Liao; Ping H,119,0,120,1
1739702244482,LTCO 287,A00,823141,Vitkus; Daniel J.,14,0,15,1
1739702245510,LTCS 12,A00,822033,Staff,40,0,40,0
1739702246535,LTCS 87,A00,822034,Nguyen; Hoang Tan,19,0,20,1
1739702246535,LTCS 87,B00,822035,Nguyen; Hoang Tan,20,0,20,0
1739702247560,LTCS 111,A00,822941,Bessett; Ryan Matthew,39,0,40,1
1739702248585,LTCS 222,A00,823145,Nguyen; Hoang Tan,12,0,15,3
1739702249609,LTCS 250,A00,823151,Myerston Santana; Jacobo,13,0,15,2
1739702250637,LTEA 100B,A00,822944,Fiss; Geraldine Anna,37,0,40,3
1739702251662,LTEA 110C,A00,822945,Zhu; Ping,39,0,40,1
1739702252688,LTEA 120A,A00,822946,Zhu; Ping,297,0,300,3
1739702253716,LTEN 22,A01,822037,Lu; Lillian,28,0,28,0
1739702253716,LTEN 22,A02,822039,Lu; Lillian,28,0,28,0
1739702253716,LTEN 22,A03,822040,Lu; Lillian,26,0,28,2
1739702253716,LTEN 22,A04,822042,Lu; Lillian,27,0,28,1
1739702254742,LTEN 28,A01,822044,Suzuki; Erin M.,27,0,28,1
1739702254742,LTEN 28,A02,822045,Suzuki; Erin M.,28,0,28,0
1739702254742,LTEN 28,A03,822046,Suzuki; Erin M.,27,0,28,1
1739702254742,LTEN 28,A04,822047,Suzuki; Erin M.,28,0,28,0
1739702254742,LTEN 28,A05,822049,Suzuki; Erin M.,28,0,28,0
1739702254742,LTEN 28,A06,822054,Suzuki; Erin M.,27,0,28,1
1739702254742,LTEN 28,A07,822056,Suzuki; Erin M.,26,0,28,2
1739702254742,LTEN 28,A08,822057,Suzuki; Erin M.,28,0,28,0
1739702255768,LTEN 110,A00,822947,Dhar; Amrita,36,0,40,4
1739702256793,LTEN 127,A00,822948,Garofalo; Devin,36,0,40,4
1739702257818,LTEN 148,A00,822949,Suzuki; Erin M.,35,0,40,5
1739702258842,LTEN 149,A00,872375,Wesling; Megan E.,34,0,40,6
1739702259874,LTEN 181,A00,822950,Mukherjee; Silpa,56,0,60,4
1739702260899,LTEN 183,A00,822951,Childs; Dennis R.,18,0,20,2
1739702261924,LTEN 185,A00,822952,Childs; Dennis R.,19,0,20,1
1739702262950,LTEN 231,A00,823152,Lu; Lillian,13,0,15,2
1739702263975,LTEN 254,A00,823160,Ruiz; Ariana,15,0,15,0
1739702265000,LTEU 110,A00,822953,Kontje; Todd Curtis,38,0,40,2
1739702266025,LTEU 140,A00,872377,De Marchi Gherini; Adriana,38,0,40,2
1739702267053,LTEU 154,A00,872369,Morse; Ainsley,34,0,35,1
1739702268077,LTFR 2A,A01,822059,Ploye; Catherine,28,0,28,0
1739702269103,LTFR 2C,A00,822060,Ploye; Catherine,25,0,25,0
1739702270182,LTFR 141,A00,822955,Zhiri; Oumelbanine,25,0,25,0
1739702271209,LTGK 3,A00,822062,Murray; Kourtney Kristine,31,0,31,0
1739702272233,LTGM 2C,A00,822067,Fischer-Grunski; Eva K,23,0,25,2
1739702273258,LTIT 50,A00,822068,De Marchi Gherini; Adriana,25,0,25,0
1739702274284,LTKO 1C,A01,822071,Jung; Ji Yun,26,0,28,2
1739702274284,LTKO 1C,B01,822075,Jung; Ji Yun,27,0,28,1
1739702274284,LTKO 1C,C01,822078,Lim; Meeyoung,28,0,28,0
1739702274284,LTKO 1C,D01,822098,Yim; Nancy,27,0,28,1
1739702274284,LTKO 1C,E01,822104,Yim; Nancy,28,0,28,0
1739702275309,LTKO 2C,A01,822289,Yim; Nancy,26,0,28,2
1739702276334,LTKO 130P,A00,822956,Lee; Jeyseon,25,0,25,0
1739702277359,LTKO 135,A00,822992,Lee; Jeyseon,25,0,25,0
1739702278387,LTLA 3,A00,822472,Murray; Kourtney Kristine,45,0,45,0
1739702279415,LTRU 1C,A01,822476,Wells; Patricia Rebecca,27,0,28,1
1739702280441,LTRU 104A,A01,823009,Wells; Patricia Rebecca,27,0,28,1
1739702281466,LTRU 150,A00,872370,Morse; Ainsley,5,0,5,0
1739702282492,LTSP 2A,A01,822483,Lampell; Toni,27,0,28,1
1739702283519,LTSP 2B,A01,822508,Mastromartino; Alexandra L,27,0,28,1
1739702284547,LTSP 2C,A01,822534,Lampell; Toni,27,0,28,1
1739702284547,LTSP 2C,B01,822616,Lampell; Toni,28,0,28,0
1739702285574,LTSP 2F,A00,822619,Mastromartino; Alexandra L,25,0,25,0
1739702286598,LTSP 3F,A00,822629,Dominguez; Noelia,25,0,25,0
1739702286598,LTSP 3F,B00,822669,Dominguez; Noelia,25,0,25,0
1739702287624,LTSP 100A,A00,823023,Dominguez; Noelia,24,0,25,1
1739702288651,LTSP 100F,A00,823027,Bessett; Ryan Matthew,25,0,25,0
1739702288651,LTSP 100F,B00,823028,Martin-Cabrera; Luis,24,0,25,1
1739702289677,LTSP 134,A00,823035,Arcos Herrera; Carol,40,0,40,0
1739702290704,LTSP 155,A00,823036,Mendoza; Andrea,39,0,40,1
1739702291729,LTSP 169,A00,823037,Martin-Cabrera; Luis,38,0,40,2
1739702292755,LTSP 175,A00,823038,Arcos Herrera; Carol,39,0,40,1
1739702293782,LTSP 272,A00,823162,Chacon; Gloria Elizabeth,15,0,15,0
1739702294810,LTTH 210C,A00,823163,Glaser; Amelia,15,0,15,0
1739702295835,LTTH 250,A00,823180,Carroll; Amy Sara,12,0,15,3
1739702296861,LTTH 260,A00,823181,Mendoza; Andrea,29,0,30,1
1739702297885,LTWL 12,A00,822679,Villafuerte Vazquez; Nadia,40,0,40,0
1739702298913,LTWL 19C,A00,822710,Kelting; Edward William,37,0,40,3
1739702299938,LTWL 101,A00,823039,Kelting; Edward William,35,0,40,5
1739702300963,LTWL 114,A00,823040,Morse; Ainsley,40,0,40,0
1739702301988,LTWL 128,A00,823041,Cohen; Alain J. J.,39,0,40,1
1739702303014,LTWL 138,A00,823042,Fiss; Geraldine Anna,40,0,40,0
1739702304042,LTWL 180,A00,823045,Mukherjee; Silpa,39,0,40,1
1739702305068,LTWL 184,A00,823046,Cohen; Alain J. J.,40,0,40,0
1739702306095,LTWL 192,A00,823047,Blanco; John D,20,0,20,0
1739702307120,LTWL 194A,A00,823048,Suzuki; Erin M.,27,0,30,3
1739702308144,LTWR 8A,A01,822713,Jemc; Jaclyn,28,0,28,0
1739702308144,LTWR 8A,A02,822863,Jemc; Jaclyn,27,0,28,1
1739702308144,LTWR 8A,A03,822923,Jemc; Jaclyn,28,0,28,0
1739702308144,LTWR 8A,A04,822932,Jemc; Jaclyn,26,0,28,2
1739702309171,LTWR 8C,A01,822935,Wilkinson; Marco,26,0,28,2
1739702309171,LTWR 8C,A02,822936,Wilkinson; Marco,27,0,28,1
1739702309171,LTWR 8C,A03,822937,Wilkinson; Marco,27,0,28,1
1739702309171,LTWR 8C,A04,822938,Wilkinson; Marco,25,0,28,3
1739702310199,LTWR 100W,A00,854460,Terry; Christopher,6,0,15,9
1739702311226,LTWR 102W,A00,823049,Doller; Ben,12,0,15,3
1739702312252,LTWR 106C,A00,823050,Terry; Christopher,27,0,30,3
1739702313277,LTWR 109C,A00,823080,Doller; Ben,28,0,30,2
1739702314302,LTWR 113C,A00,823093,Som; Brandon D,29,0,30,1
1739702315331,LTWR 115W,A00,823096,Springer; Anna Joy,13,0,15,2
1739702316358,LTWR 119C,A00,823099,Copp; Corina,28,0,30,2
1739702317382,LTWR 124W,A00,823102,Copp; Corina,15,0,15,0
1739702318407,LTWR 126C,A00,823108,Terry; Christopher,29,0,30,1
1739702319431,LTWR 140,A00,823133,Carroll; Amy Sara,30,0,30,0
1739702320457,LTWR 148,A00,823136,Wilkinson; Marco,39,0,40,1
1739702321482,LTWR 215,A00,823218,Jemc; Jaclyn,18,0,20,2
1739702322512,MAE 3,A01,825269,Delson; Nathan Joseph,13,0,16,3
1739702322512,MAE 3,A02,825273,Delson; Nathan Joseph,13,0,16,3
1739702322512,MAE 3,A03,825278,Delson; Nathan Joseph,11,0,16,5
1739702322512,MAE 3,A04,825280,Delson; Nathan Joseph,14,0,16,2
1739702322512,MAE 3,B01,825301,Morimoto; Tania,12,0,16,4
1739702322512,MAE 3,B02,825303,Morimoto; Tania,6,0,16,10
1739702322512,MAE 3,B03,825312,Morimoto; Tania,16,0,16,0
1739702322512,MAE 3,B04,825343,Morimoto; Tania,16,0,16,0
1739702323540,MAE 8,A01,825350,Qian; Kai,93,0,100,7
1739702324569,MAE 30B,A00,825352,Lubarda; Marko,96,0,100,4
1739702324569,MAE 30B,B00,825362,Ghazinejad; Maziar,85,0,100,15
1739702325595,MAE 87,A00,872412,Mullin; Jennifer S & Twomey; Robert Daniel,10,0,10,0
1739702326619,MAE 101B,A00,825363,Nomura; Keiko K.,143,0,146,3
1739702327647,MAE 101C,A00,825364,Staff,0,0,0,0
1739702328672,MAE 101D,A00,825378,Coimbra; Carlos F.,16,0,25,9
1739702329700,MAE 104,A00,825379,Pham; Hieu Tan,91,0,100,9
1739702330729,MAE 105,A00,825380,Bandaru; Prabhakar,95,0,100,5
1739702331757,MAE 107,A00,825381,Lindsey; Stephanie,94,0,100,6
1739702332783,MAE 119,A00,825382,Hidalgo-Gonzalez; Patricia,123,0,146,23
1739702333812,MAE 131A,A00,825385,Qi; Huihui,84,0,100,16
1739702333812,MAE 131A,B00,825435,Luan; Haiwen,99,0,100,1
1739702334838,MAE 143B,A00,825498,Diagne; Mamadou Lamine,62,0,80,18
1739702334838,MAE 143B,B00,825499,Kramer; Boris,92,0,96,4
1739702335863,MAE 148,A01,825502,Silberman; Jack,17,0,26,9
1739702336892,MAE 150,A00,825505,Friend; James Robert,115,0,120,5
1739702337917,MAE 152,A00,886080,Llewellyn Smith; Stefan G.,16,0,16,0
1739702337917,MAE 152,B00,886081,Llewellyn Smith; Stefan G.,16,0,16,0
1739702337917,MAE 152,C00,886082,Llewellyn Smith; Stefan G.,14,0,16,2
1739702337917,MAE 152,D00,886083,Llewellyn Smith; Stefan G.,16,0,16,0
1739702338945,MAE 155B,A01,825508,Anderson; Mark Ronald,17,0,50,33
1739702338945,MAE 155B,B01,825515,Hwang; John T,36,0,50,14
1739702339977,MAE 156B,D01,825618,Tustaniwskyj; Jerry I,30,0,35,5
1739702339977,MAE 156B,A01,825549,Delson; Nathan Joseph,34,0,35,1
1739702339977,MAE 156B,B01,825595,Ghazinejad; Maziar,30,0,35,5
1739702339977,MAE 156B,C01,825604,Pawlak; Geno Ronald,32,0,35,3
1739702339977,MAE 156B,F01,825626,Saha; Abhishek,34,0,35,1
1739702339977,MAE 156B,G01,825631,Qi; Huihui,32,0,35,3
1739702341005,MAE 170,A01,825636,Lubarda; Marko,27,0,32,5
1739702341005,MAE 170,A02,825638,Lubarda; Marko,31,0,32,1
1739702341005,MAE 170,A03,825639,Lubarda; Marko,31,0,32,1
1739702341005,MAE 170,B04,825643,Evdokimenko; Ekaterina,28,0,32,4
1739702341005,MAE 170,B05,825645,Evdokimenko; Ekaterina,21,0,32,11
1739702341005,MAE 170,B06,825648,Evdokimenko; Ekaterina,26,0,32,6
1739702342032,MAE 171A,A01,825655,Tynan; George Robert,22,0,30,8
1739702342032,MAE 171A,A02,825657,Tynan; George Robert,29,0,30,1
1739702343057,MAE 175A,A01,825661,de Callafon; Raymond A,20,0,20,0
1739702343057,MAE 175A,A02,825662,de Callafon; Raymond A,14,0,20,6
1739702344083,MAE 184,A00,825714,Anderson; Mark Ronald,23,0,60,37
1739702345109,MAE 185,A00,825715,Schmidt; Oliver,28,0,60,32
1739702346134,MAE 190,A00,825719,Beg; Farhat N.,34,0,40,6
1739702346134,MAE 190,B00,825720,Tynan; George Robert & Mullin; Jennifer S,57,0,60,3
1739702346134,MAE 190,C00,869044,Gerardo; Hortense Flotilde,13,0,14,1
1739702347161,MAE 205,A00,825721,Herbert; Sylvia Lee & Pawlak; Geno Ronald & Mullin; Jennifer S & Lindsey; Stephanie & Cai; Shengqiang & Beg; Farhat N.,9995,0,9999,4
1739702348184,MAE 207,A00,825722,Beg; Farhat N.,7,0,10,3
1739702348184,MAE 207,B00,869156,Gerardo; Hortense Flotilde,24,0,30,6
1739702349209,MAE 209,A00,825723,Scholtes Acevedo; Claire,18,0,30,12
1739702350238,MAE 210C,A00,869158,Sanchez; Antonio Luis,9,0,15,6
1739702351262,MAE 214A,A00,825724,Sarkar; Sutanu,0,0,20,20
1739702352290,MAE 217C,A00,825725,Marinoni; Alessandro,12,0,15,3
1739702353315,MAE 221D,A00,825726,Poulikakos; Lisa Voula,0,0,15,15
1739702354340,MAE 223,A01,825729,Lucas; Andrew J.,0,0,32,32
1739702355364,MAE 224A,A00,825731,Pawlak; Geno Ronald,0,0,10,10
1739702356393,MAE 227,A00,825732,Hidalgo-Gonzalez; Patricia,0,0,15,15
1739702357418,MAE 231B,A00,825733,Boechler; Nicholas Sebastia,28,0,30,2
1739702358443,MAE 240,A00,825734,Rosengren; Aaron,22,0,40,18
1739702359471,MAE 242,A00,825735,Martinez; Sonia,0,0,40,40
1739702360496,MAE 243,A00,869161,Davidson; Michael R,11,0,20,9
1739702361522,MAE 254,A00,825736,Chen; Renkun,0,0,15,15
1739702362551,MAE 256,A00,825740,Coimbra; Carlos F.,7,0,15,8
1739702363576,MAE 266,A00,825741,Evdokimenko; Ekaterina,0,0,20,20
1739702364601,MAE 269,A00,825837,Gravish; Nicholas G,0,0,35,35
1739702365628,MAE 271B,A00,825838,Garay; Javier,5,0,5,0
1739702366653,MAE 272,A00,825839,Meyers; Marc,4,0,15,11
1739702367685,MAE 280B,A00,825840,de Callafon; Raymond A,11,0,40,29
1739702368713,MAE 281B,A00,825842,Cortes; Jorge,7,0,20,13
1739702369741,MAE 289C,A00,825843,McEneaney; William Michael,8,0,10,2
1739702370767,MAE 290C,A00,825846,Schmidt; Oliver,27,0,30,3
1739702371795,MAE 294C,A01,825850,Young; William Roy,10,0,10,0
1739702372821,MATH 2,A01,848213,Cheng; Hsiao-Bing,187,0,190,3
1739702373905,MATH 3B,A01,848358,Ohm; Ko Woon,28,0,30,2
1739702373905,MATH 3B,A02,848359,Ohm; Ko Woon,30,0,30,0
1739702373905,MATH 3B,A03,848368,Ohm; Ko Woon,18,0,30,12
1739702373905,MATH 3B,A04,848369,Ohm; Ko Woon,30,0,30,0
1739702374936,MATH 3C,A01,848397,Anzaldo; Leesa B,20,0,28,8
1739702374936,MATH 3C,A02,848398,Anzaldo; Leesa B,28,0,28,0
1739702374936,MATH 3C,A03,848399,Anzaldo; Leesa B,28,0,28,0
1739702374936,MATH 3C,A04,848400,Anzaldo; Leesa B,28,0,28,0
1739702374936,MATH 3C,B01,848423,Nandi; Achinta Kumar,24,0,30,6
1739702374936,MATH 3C,B02,848439,Nandi; Achinta Kumar,30,0,30,0
1739702374936,MATH 3C,B03,848458,Nandi; Achinta Kumar,29,0,30,1
1739702374936,MATH 3C,B04,848459,Nandi; Achinta Kumar,30,0,30,0
1739702375962,MATH 4C,A01,848474,Briones; Jor-el Thomas Caparas,31,0,35,4
1739702375962,MATH 4C,A02,848476,Briones; Jor-el Thomas Caparas,35,0,36,1
1739702375962,MATH 4C,A03,848479,Briones; Jor-el Thomas Caparas,36,0,36,0
1739702375962,MATH 4C,A04,848481,Briones; Jor-el Thomas Caparas,36,0,36,0
1739702376990,MATH 10A,A01,848484,Briones; Jor-el Thomas Caparas,31,0,33,2
1739702376990,MATH 10A,A02,848490,Briones; Jor-el Thomas Caparas,32,0,33,1
1739702376990,MATH 10A,A03,848495,Briones; Jor-el Thomas Caparas,21,0,33,12
1739702376990,MATH 10A,A04,848508,Briones; Jor-el Thomas Caparas,19,0,33,14
1739702376990,MATH 10A,A05,848517,Briones; Jor-el Thomas Caparas,30,0,33,3
1739702376990,MATH 10A,A06,848518,Briones; Jor-el Thomas Caparas,33,0,33,0
1739702376990,MATH 10A,B01,848521,Bach; Quang Tran,30,0,31,1
1739702376990,MATH 10A,B02,848523,Bach; Quang Tran,31,0,32,1
1739702376990,MATH 10A,B03,848542,Bach; Quang Tran,33,0,33,0
1739702376990,MATH 10A,B04,848543,Bach; Quang Tran,33,0,33,0
1739702376990,MATH 10A,B05,848544,Bach; Quang Tran,28,0,33,5
1739702376990,MATH 10A,B06,848545,Bach; Quang Tran,33,0,33,0
1739702378018,MATH 10B,A01,848547,Zhao; Yizhen,33,0,33,0
1739702378018,MATH 10B,A02,848548,Zhao; Yizhen,33,0,33,0
1739702378018,MATH 10B,A03,848557,Zhao; Yizhen,32,0,33,1
1739702378018,MATH 10B,A04,848558,Zhao; Yizhen,32,0,33,1
1739702378018,MATH 10B,B01,848583,Zhao; Yizhen,55,0,60,5
1739702378018,MATH 10B,B02,848585,Zhao; Yizhen,59,0,60,1
1739702378018,MATH 10B,B03,848586,Zhao; Yizhen,31,0,33,2
1739702378018,MATH 10B,B04,848588,Zhao; Yizhen,32,0,33,1
1739702378018,MATH 10B,C01,848591,Ophir; Amit,30,0,30,0
1739702378018,MATH 10B,C02,848592,Ophir; Amit,29,0,30,1
1739702378018,MATH 10B,C03,848593,Ophir; Amit,30,0,30,0
1739702378018,MATH 10B,C04,848595,Ophir; Amit,30,0,30,0
1739702378018,MATH 10B,D01,848651,Buzaglo; Lucas,8,0,30,22
1739702378018,MATH 10B,D02,848653,Buzaglo; Lucas,26,0,32,6
1739702378018,MATH 10B,D03,848672,Buzaglo; Lucas,31,0,33,2
1739702378018,MATH 10B,D04,848691,Buzaglo; Lucas,33,0,33,0
1739702378018,MATH 10B,D05,848700,Buzaglo; Lucas,28,0,33,5
1739702378018,MATH 10B,D06,848702,Buzaglo; Lucas,27,0,33,6
1739702379049,MATH 10C,A01,848704,Ho; Ching Wei,12,0,27,15
1739702379049,MATH 10C,A02,848706,Ho; Ching Wei,28,0,33,5
1739702379049,MATH 10C,A03,848708,Ho; Ching Wei,29,0,33,4
1739702379049,MATH 10C,A04,848709,Ho; Ching Wei,33,0,33,0
1739702379049,MATH 10C,A05,848711,Ho; Ching Wei,32,0,33,1
1739702379049,MATH 10C,A06,848712,Ho; Ching Wei,32,0,33,1
1739702379049,MATH 10C,B01,848716,Staff,28,0,35,7
1739702379049,MATH 10C,B02,848766,Staff,33,0,35,2
1739702379049,MATH 10C,B03,848767,Staff,33,0,35,2
1739702379049,MATH 10C,B04,848772,Staff,35,0,35,0
1739702379049,MATH 10C,C01,848775,Cheng; Hsiao-Bing,28,0,35,7
1739702379049,MATH 10C,C02,848779,Cheng; Hsiao-Bing,35,0,35,0
1739702379049,MATH 10C,C03,848780,Cheng; Hsiao-Bing,35,0,35,0
1739702379049,MATH 10C,C04,848781,Cheng; Hsiao-Bing,35,0,35,0
1739702380081,MATH 11,A01,848784,Peca-Medlin; John Michael,18,0,28,10
1739702380081,MATH 11,A02,848786,Peca-Medlin; John Michael,28,0,33,5
1739702380081,MATH 11,A03,848788,Peca-Medlin; John Michael,33,0,33,0
1739702380081,MATH 11,A04,848791,Peca-Medlin; John Michael,33,0,33,0
1739702380081,MATH 11,A05,848793,Peca-Medlin; John Michael,55,0,55,0
1739702380081,MATH 11,A06,848794,Peca-Medlin; John Michael,55,0,55,0
1739702380081,MATH 11,B01,848798,Peca-Medlin; John Michael,54,0,55,1
1739702380081,MATH 11,B02,848799,Peca-Medlin; John Michael,55,0,55,0
1739702380081,MATH 11,B03,848800,Peca-Medlin; John Michael,26,0,33,7
1739702380081,MATH 11,B04,848801,Peca-Medlin; John Michael,31,0,33,2
1739702380081,MATH 11,B05,848843,Peca-Medlin; John Michael,33,0,33,0
1739702380081,MATH 11,B06,848844,Peca-Medlin; John Michael,33,0,33,0
1739702381117,MATH 18,A01,848854,Hiatt; Patrick John,32,0,35,3
1739702381117,MATH 18,A02,848859,Hiatt; Patrick John,35,0,35,0
1739702381117,MATH 18,A03,848860,Hiatt; Patrick John,34,0,35,1
1739702381117,MATH 18,A04,848861,Hiatt; Patrick John,35,0,35,0
1739702381117,MATH 18,A05,872522,Hiatt; Patrick John,33,0,35,2
1739702381117,MATH 18,A06,872523,Hiatt; Patrick John,35,0,35,0
1739702381117,MATH 18,B01,848869,Anzaldo; Leesa B,35,0,40,5
1739702381117,MATH 18,B02,848873,Anzaldo; Leesa B,20,0,35,15
1739702381117,MATH 18,B03,848877,Anzaldo; Leesa B,37,0,40,3
1739702381117,MATH 18,B04,848880,Anzaldo; Leesa B,38,0,40,2
1739702381117,MATH 18,B05,848882,Anzaldo; Leesa B,40,0,40,0
1739702381117,MATH 18,B06,848883,Anzaldo; Leesa B,35,0,40,5
1739702381117,MATH 18,B07,848884,Anzaldo; Leesa B,38,0,40,2
1739702381117,MATH 18,B08,848924,Anzaldo; Leesa B,38,0,40,2
1739702381117,MATH 18,C01,849043,Hiatt; Patrick John,34,0,35,1
1739702381117,MATH 18,C02,849044,Hiatt; Patrick John,35,0,35,0
1739702381117,MATH 18,C03,849045,Hiatt; Patrick John,35,0,35,0
1739702381117,MATH 18,C04,849047,Hiatt; Patrick John,33,0,35,2
1739702381117,MATH 18,C05,872524,Hiatt; Patrick John,34,0,35,1
1739702381117,MATH 18,C06,872525,Hiatt; Patrick John,35,0,35,0
1739702381117,MATH 18,D01,849050,Staff,35,0,35,0
1739702381117,MATH 18,D02,849053,Staff,35,0,35,0
1739702381117,MATH 18,D03,849054,Staff,35,0,35,0
1739702381117,MATH 18,D04,849055,Staff,35,0,35,0
1739702381117,MATH 18,D05,872526,Staff,34,0,35,1
1739702381117,MATH 18,D06,872528,Staff,35,0,35,0
1739702382144,MATH 20A,A01,849061,Ho; Ching Wei,28,0,32,4
1739702382144,MATH 20A,A02,849062,Ho; Ching Wei,34,0,35,1
1739702382144,MATH 20A,A03,849064,Ho; Ching Wei,35,0,35,0
1739702382144,MATH 20A,A04,849065,Ho; Ching Wei,35,0,35,0
1739702382144,MATH 20A,B01,849087,Bowers; Adam R.,28,0,35,7
1739702382144,MATH 20A,B02,849100,Bowers; Adam R.,35,0,35,0
1739702382144,MATH 20A,B03,849110,Bowers; Adam R.,34,0,35,1
1739702382144,MATH 20A,B04,849111,Bowers; Adam R.,34,0,35,1
1739702383172,MATH 20B,A01,849131,Staff,58,0,60,2
1739702383172,MATH 20B,A02,849242,Staff,60,0,60,0
1739702383172,MATH 20B,A03,849315,Staff,58,0,60,2
1739702383172,MATH 20B,A04,849319,Staff,60,0,60,0
1739702383172,MATH 20B,B01,849438,Xu; Fengmin,60,0,60,0
1739702383172,MATH 20B,B02,849447,Xu; Fengmin,57,0,60,3
1739702383172,MATH 20B,B03,849463,Xu; Fengmin,14,0,34,20
1739702383172,MATH 20B,B04,849465,Xu; Fengmin,36,0,37,1
1739702384202,MATH 20C,A01,849482,Shakeel; Asif,27,0,32,5
1739702384202,MATH 20C,A02,849484,Shakeel; Asif,31,0,32,1
1739702384202,MATH 20C,A03,849485,Shakeel; Asif,32,0,32,0
1739702384202,MATH 20C,A04,849511,Shakeel; Asif,32,0,32,0
1739702384202,MATH 20C,A05,849512,Shakeel; Asif,32,0,32,0
1739702384202,MATH 20C,A06,849513,Shakeel; Asif,32,0,32,0
1739702384202,MATH 20C,B01,849515,Yin; Wei,28,0,40,12
1739702384202,MATH 20C,B02,849516,Yin; Wei,41,0,45,4
1739702384202,MATH 20C,B03,849628,Yin; Wei,45,0,45,0
1739702384202,MATH 20C,B04,849636,Yin; Wei,43,0,45,2
1739702384202,MATH 20C,C01,849642,Ohm; Ko Woon,51,0,60,9
1739702384202,MATH 20C,C02,849654,Ohm; Ko Woon,60,0,60,0
1739702384202,MATH 20C,C03,849655,Ohm; Ko Woon,59,0,60,1
1739702384202,MATH 20C,C04,849663,Ohm; Ko Woon,60,0,60,0
1739702384202,MATH 20C,D01,849673,Yin; Wei,43,0,45,2
1739702384202,MATH 20C,D02,849677,Yin; Wei,43,0,45,2
1739702384202,MATH 20C,D03,849683,Yin; Wei,45,0,45,0
1739702384202,MATH 20C,D04,849686,Yin; Wei,45,0,45,0
1739702385227,MATH 20D,A01,849688,Hammock; Frances H,22,0,27,5
1739702385227,MATH 20D,A02,849695,Hammock; Frances H,32,0,32,0
1739702385227,MATH 20D,A03,849697,Hammock; Frances H,32,0,32,0
1739702385227,MATH 20D,A04,849734,Hammock; Frances H,31,0,32,1
1739702385227,MATH 20D,A05,849735,Hammock; Frances H,30,0,32,2
1739702385227,MATH 20D,A06,849736,Hammock; Frances H,32,0,32,0
1739702385227,MATH 20D,B01,849829,Hammock; Frances H,34,0,45,11
1739702385227,MATH 20D,B02,849852,Hammock; Frances H,45,0,45,0
1739702385227,MATH 20D,B03,849853,Hammock; Frances H,44,0,45,1
1739702385227,MATH 20D,B04,849857,Hammock; Frances H,45,0,45,0
1739702385227,MATH 20D,C01,849867,Staff,57,0,60,3
1739702385227,MATH 20D,C02,849888,Staff,59,0,60,1
1739702386262,MATH 20E,A01,850038,Sanchez; Anthony,20,0,31,11
1739702386262,MATH 20E,A02,850039,Sanchez; Anthony,33,0,35,2
1739702386262,MATH 20E,A03,850040,Sanchez; Anthony,34,0,35,1
1739702386262,MATH 20E,A04,850041,Sanchez; Anthony,35,0,35,0
1739702386262,MATH 20E,B01,850054,Sheng; Hongyi,27,0,35,8
1739702386262,MATH 20E,B02,850058,Sheng; Hongyi,34,0,35,1
1739702386262,MATH 20E,B03,850060,Sheng; Hongyi,35,0,35,0
1739702386262,MATH 20E,B04,850063,Sheng; Hongyi,35,0,35,0
1739702386262,MATH 20E,B05,872529,Sheng; Hongyi,35,0,35,0
1739702386262,MATH 20E,B06,872530,Sheng; Hongyi,35,0,35,0
1739702386262,MATH 20E,C01,850068,Sheng; Hongyi,29,0,30,1
1739702386262,MATH 20E,C02,850069,Sheng; Hongyi,30,0,30,0
1739702386262,MATH 20E,C03,850072,Sheng; Hongyi,29,0,30,1
1739702386262,MATH 20E,C04,850075,Sheng; Hongyi,29,0,30,1
1739702386262,MATH 20E,C05,850080,Sheng; Hongyi,30,0,30,0
1739702386262,MATH 20E,C06,850083,Sheng; Hongyi,30,0,30,0
1739702387291,MATH 31CH,A01,850090,De Vleming; Kristin Elizab,40,0,40,0
1739702388314,MATH 87,A00,872926,Bowers; Adam R.,20,0,20,0
1739702388314,MATH 87,B00,872927,Bowers; Adam R.,20,0,20,0
1739702389338,MATH 95,A00,850094,Stevens; Laura Jeanne,34,0,35,1
1739702390367,MATH 100B,A01,847038,Aycock; Jon Merrill,33,0,34,1
1739702390367,MATH 100B,A02,847048,Aycock; Jon Merrill,33,0,34,1
1739702391394,MATH 100C,A01,847050,Sorensen; Claus M,30,0,34,4
1739702391394,MATH 100C,A02,847051,Sorensen; Claus M,32,0,34,2
1739702392419,MATH 102,A01,847053,Aliabadi Sr.; Mohsen,25,0,30,5
1739702392419,MATH 102,A02,847101,Aliabadi Sr.; Mohsen,30,0,30,0
1739702392419,MATH 102,A03,847103,Aliabadi Sr.; Mohsen,28,0,30,2
1739702392419,MATH 102,A04,847106,Aliabadi Sr.; Mohsen,30,0,30,0
1739702392419,MATH 102,B01,847119,Aliabadi Sr.; Mohsen,27,0,30,3
1739702392419,MATH 102,B02,847120,Aliabadi Sr.; Mohsen,29,0,30,1
1739702392419,MATH 102,B03,847121,Aliabadi Sr.; Mohsen,29,0,30,1
1739702392419,MATH 102,B04,847123,Aliabadi Sr.; Mohsen,30,0,30,0
1739702393451,MATH 103B,A01,847125,Mohammadi; Amir,34,0,35,1
1739702393451,MATH 103B,A02,847126,Mohammadi; Amir,35,0,35,0
1739702393451,MATH 103B,B01,847128,Wenzl; Hans G,33,0,35,2
1739702393451,MATH 103B,B02,847129,Wenzl; Hans G,35,0,35,0
1739702393451,MATH 103B,C01,847131,Wenzl; Hans G,31,0,35,4
1739702393451,MATH 103B,C02,847132,Wenzl; Hans G,33,0,35,2
1739702394477,MATH 109,A01,847134,Ganesan; Priyanga,10,0,10,0
1739702394477,MATH 109,A02,847135,Ganesan; Priyanga,9,0,10,1
1739702394477,MATH 109,B01,847137,Ganesan; Priyanga,7,0,10,3
1739702394477,MATH 109,B02,847138,Ganesan; Priyanga,9,0,10,1
1739702394477,MATH 109,C01,847140,Upadrashta; Pranav Kumar,7,0,10,3
1739702394477,MATH 109,C02,847141,Upadrashta; Pranav Kumar,10,0,10,0
1739702394477,MATH 109,D01,847143,Sarkar; Pratyush,9,0,10,1
1739702394477,MATH 109,D02,847144,Sarkar; Pratyush,10,0,10,0
1739702394477,MATH 109,E01,847146,Sarkar; Pratyush,10,0,10,0
1739702394477,MATH 109,E02,847148,Sarkar; Pratyush,10,0,10,0
1739702395502,MATH 110,A01,847150,Pillai; Mohandas K,30,0,35,5
1739702395502,MATH 110,A02,847151,Pillai; Mohandas K,34,0,35,1
1739702395502,MATH 110,A03,847152,Pillai; Mohandas K,34,0,35,1
1739702396531,MATH 111A,A01,847154,Shakeel; Asif,23,0,30,7
1739702397557,MATH 112B,A01,847156,Komarova; Natalia,25,0,25,0
1739702398583,MATH 114,A01,847158,Li; Bo,21,0,30,9
1739702398583,MATH 114,A02,847159,Li; Bo,29,0,30,1
1739702399611,MATH 120B,A01,847161,Treuer; John N,32,0,35,3
1739702399611,MATH 120B,A02,847162,Treuer; John N,34,0,35,1
1739702400637,MATH 121B,A01,847164,Stevens; Laura Jeanne,33,0,35,2
1739702401668,MATH 140B,A01,847166,Lu; Yunze,35,0,35,0
1739702401668,MATH 140B,A02,847167,Lu; Yunze,34,0,35,1
1739702402694,MATH 140C,A01,847203,Zlatos; Andrej,33,0,35,2
1739702402694,MATH 140C,A02,847204,Zlatos; Andrej,34,0,35,1
1739702403721,MATH 142B,A01,847207,Parise; Davide,25,0,35,10
1739702403721,MATH 142B,A02,847208,Parise; Davide,31,0,35,4
1739702403721,MATH 142B,B01,847219,Mohammadi; Amir,33,0,35,2
1739702403721,MATH 142B,B02,847222,Mohammadi; Amir,35,0,35,0
1739702403721,MATH 142B,C01,847224,Kunnawalkam Elayavalli; Sr,34,0,35,1
1739702403721,MATH 142B,C02,847331,Kunnawalkam Elayavalli; Sr,34,0,35,1
1739702404749,MATH 146,A01,847333,Pillai; Mohandas K,35,0,35,0
1739702405776,MATH 150B,A01,847335,Chow; Bennett,33,0,35,2
1739702406802,MATH 152,A01,847337,Grier; Daniel T,32,0,50,18
1739702407832,MATH 154,A01,847340,Manners; Frederick,33,0,35,2
1739702407832,MATH 154,A02,847341,Manners; Frederick,35,0,35,0
1739702407832,MATH 154,A03,847342,Manners; Frederick,35,0,35,0
1739702407832,MATH 154,A04,847343,Manners; Frederick,35,0,35,0
1739702407832,MATH 154,B01,847345,Verstraete; Jacques Allan,30,0,35,5
1739702407832,MATH 154,B02,847346,Verstraete; Jacques Allan,35,0,35,0
1739702407832,MATH 154,B03,847347,Verstraete; Jacques Allan,34,0,35,1
1739702407832,MATH 154,B04,847348,Verstraete; Jacques Allan,33,0,35,2
1739702408860,MATH 160B,A01,847460,Manners; Frederick,34,0,35,1
1739702409885,MATH 163,A01,847462,Kunnawalkam Elayavalli; Sr,1,0,25,24
1739702410912,MATH 170A,A01,847464,Nag; Panchali,33,0,35,2
1739702410912,MATH 170A,A02,847465,Nag; Panchali,34,0,35,1
1739702410912,MATH 170A,A03,847466,Nag; Panchali,33,0,35,2
1739702410912,MATH 170A,A04,847467,Nag; Panchali,31,0,35,4
1739702411941,MATH 170B,A01,847530,Dixit; Rishabh,33,0,35,2
1739702411941,MATH 170B,A02,847531,Dixit; Rishabh,35,0,35,0
1739702411941,MATH 170B,A03,847532,Dixit; Rishabh,34,0,35,1
1739702411941,MATH 170B,A04,847533,Dixit; Rishabh,29,0,35,6
1739702412969,MATH 170C,A01,847535,Dixit; Rishabh,35,0,35,0
1739702412969,MATH 170C,A02,847536,Dixit; Rishabh,35,0,35,0
1739702412969,MATH 170C,A03,847537,Dixit; Rishabh,34,0,35,1
1739702412969,MATH 170C,A04,847538,Dixit; Rishabh,35,0,35,0
1739702413997,MATH 171B,A01,847557,Huang; Lei,32,0,35,3
1739702413997,MATH 171B,A02,847560,Huang; Lei,34,0,35,1
1739702413997,MATH 171B,A03,847596,Huang; Lei,31,0,35,4
1739702413997,MATH 171B,A04,847597,Huang; Lei,32,0,35,3
1739702415024,MATH 179,A01,847599,Cheng; Li-Tien,25,0,25,0
1739702416050,MATH 180A,A01,847601,Webber; Robert Jacobs,31,0,35,4
1739702416050,MATH 180A,A02,847602,Webber; Robert Jacobs,35,0,35,0
1739702416050,MATH 180A,A03,847603,Webber; Robert Jacobs,34,0,35,1
1739702416050,MATH 180A,A04,847604,Webber; Robert Jacobs,32,0,35,3
1739702416050,MATH 180A,B01,847606,Hardiman; Liam,35,0,35,0
1739702416050,MATH 180A,B02,847680,Hardiman; Liam,31,0,35,4
1739702416050,MATH 180A,B03,847682,Hardiman; Liam,35,0,35,0
1739702416050,MATH 180A,B04,847683,Hardiman; Liam,35,0,35,0
1739702417074,MATH 180B,A01,847686,Warnke; Lutz Peter,32,0,32,0
1739702417074,MATH 180B,A02,847688,Warnke; Lutz Peter,31,0,32,1
1739702417074,MATH 180B,A03,847689,Warnke; Lutz Peter,31,0,32,1
1739702417074,MATH 180B,A04,847691,Warnke; Lutz Peter,31,0,32,1
1739702417074,MATH 180B,A05,847693,Warnke; Lutz Peter,32,0,32,0
1739702417074,MATH 180B,A06,847694,Warnke; Lutz Peter,30,0,32,2
1739702418098,MATH 180C,A01,847701,Ang; Jie Jun,34,0,35,1
1739702418098,MATH 180C,A02,847707,Ang; Jie Jun,35,0,35,0
1739702418098,MATH 180C,A03,847708,Ang; Jie Jun,32,0,35,3
1739702418098,MATH 180C,A04,847711,Ang; Jie Jun,31,0,35,4
1739702419122,MATH 181A,A01,847753,Zhang; Danna,15,0,35,20
1739702419122,MATH 181A,A02,847756,Zhang; Danna,32,0,35,3
1739702419122,MATH 181A,A03,847757,Zhang; Danna,32,0,35,3
1739702419122,MATH 181A,A04,847758,Zhang; Danna,33,0,35,2
1739702420151,MATH 181B,A01,847760,Rava; Denise,30,0,35,5
1739702420151,MATH 181B,A02,847761,Rava; Denise,34,0,35,1
1739702420151,MATH 181B,A03,847764,Rava; Denise,34,0,35,1
1739702420151,MATH 181B,A04,847765,Rava; Denise,35,0,35,0
1739702421181,MATH 183,A01,847768,Vishwanath; Siddharth,21,0,32,11
1739702421181,MATH 183,A02,847769,Vishwanath; Siddharth,30,0,32,2
1739702421181,MATH 183,A03,847770,Vishwanath; Siddharth,31,0,32,1
1739702421181,MATH 183,A04,847772,Vishwanath; Siddharth,29,0,32,3
1739702421181,MATH 183,A05,847774,Vishwanath; Siddharth,32,0,32,0
1739702421181,MATH 183,A06,847864,Vishwanath; Siddharth,31,0,32,1
1739702422208,MATH 184,A01,847866,Wesley; William J,35,0,35,0
1739702422208,MATH 184,A02,847874,Wesley; William J,33,0,35,2
1739702422208,MATH 184,A03,847875,Wesley; William J,35,0,35,0
1739702422208,MATH 184,A04,847876,Wesley; William J,33,0,35,2
1739702423237,MATH 185,A01,847880,Rava; Denise,31,0,35,4
1739702423237,MATH 185,A02,847881,Rava; Denise,35,0,35,0
1739702424266,MATH 187A,A01,847883,Klevdal; Christian Sleek,14,0,32,18
1739702424266,MATH 187A,A02,847886,Klevdal; Christian Sleek,29,0,32,3
1739702424266,MATH 187A,A03,847892,Klevdal; Christian Sleek,27,0,32,5
1739702424266,MATH 187A,A04,847893,Klevdal; Christian Sleek,32,0,32,0
1739702424266,MATH 187A,A05,847894,Klevdal; Christian Sleek,31,0,32,1
1739702424266,MATH 187A,A06,847903,Klevdal; Christian Sleek,31,0,32,1
1739702425292,MATH 187B,A01,847905,Bucur; Alina Ioana,28,0,35,7
1739702425292,MATH 187B,A02,847906,Bucur; Alina Ioana,34,0,35,1
1739702426319,MATH 189,A01,847908,Lou; Zhipeng,0,0,10,10
1739702426319,MATH 189,A02,847909,Lou; Zhipeng,0,0,10,10
1739702426319,MATH 189,A03,847910,Lou; Zhipeng,0,0,10,10
1739702426319,MATH 189,A04,847911,Lou; Zhipeng,0,0,10,10
1739702426319,MATH 189,A05,847912,Lou; Zhipeng,0,0,10,10
1739702426319,MATH 189,A06,847917,Lou; Zhipeng,0,0,10,10
1739702427347,MATH 190B,A01,848005,McKernan; James,31,0,35,4
1739702428373,MATH 194,A01,848012,Fitzsimmons; Patrick J,12,0,32,20
1739702428373,MATH 194,A02,848080,Fitzsimmons; Patrick J,31,0,32,1
1739702428373,MATH 194,A03,848081,Fitzsimmons; Patrick J,26,0,32,6
1739702428373,MATH 194,A04,848107,Fitzsimmons; Patrick J,32,0,32,0
1739702428373,MATH 194,A05,848108,Fitzsimmons; Patrick J,31,0,32,1
1739702428373,MATH 194,A06,848147,Fitzsimmons; Patrick J,30,0,32,2
1739702429396,MATH 197,001,872928,Kedlaya; Kiran S.,9999,0,9999,0
1739702430426,MATH 200C,A00,846124,Salehi Golsefidy; Alireza,18,0,20,2
1739702431451,MATH 202C,A00,846125,Rhoades; Brendon Patrick,18,0,20,2
1739702432477,MATH 203C,A00,846128,Izadi; Elham,20,0,20,0
1739702433502,MATH 204C,A00,846131,Pollack; Aaron,20,0,20,0
1739702434530,MATH 205,A00,846132,Popescu; Cristian D.,18,0,20,2
1739702435557,MATH 208,A00,846133,Oprea; Dragos N.,10,0,10,0
1739702436581,MATH 209,A00,846173,Bucur; Alina Ioana,10,0,10,0
1739702437605,MATH 211A,A00,846174,Salehi Golsefidy; Alireza,10,0,10,0
1739702438630,MATH 211B,A00,846175,Sanchez; Anthony,9,0,10,1
1739702439655,MATH 212B,A01,846177,Komarova; Natalia,10,0,10,0
1739702440679,MATH 214,A01,846179,Li; Bo,2,0,5,3
1739702440679,MATH 214,A02,846181,Li; Bo,5,0,5,0
1739702441707,MATH 216C,A00,846182,Cloninger; Alexander,17,0,20,3
1739702442734,MATH 218,A00,846183,Komarova; Natalia,9,0,10,1
1739702443759,MATH 220C,A00,846184,Oprea; Dragos N.,20,0,20,0
1739702444783,MATH 231C,A00,846185,Li; Bo,20,0,20,0
1739702445811,MATH 240C,A00,846187,Ioana; Adrian,18,0,20,2
1739702446837,MATH 243,A00,846188,Kunnawalkam Elayavalli; Sr,9,0,10,1
1739702447862,MATH 248,A00,846189,Bejenaru; Ioan,9,0,10,1
1739702448890,MATH 250C,A00,846190,Chow; Bennett,18,0,20,2
1739702449917,MATH 258,A00,846191,Ni; Lei,10,0,10,0
1739702450943,MATH 262A,A00,846192,Suk; Andrew Hoon,17,0,20,3
1739702451970,MATH 264C,A00,846193,Rhoades; Brendon Patrick,18,0,20,2
1739702452995,MATH 269,A00,846194,Warnke; Lutz Peter,9,0,10,1
1739702454022,MATH 270C,A00,846195,Leok; Melvin,14,0,20,6
1739702455049,MATH 271C,A00,846197,Nie; Jiawang,16,0,20,4
1739702456078,MATH 272C,A00,846198,Miller; Pearson,20,0,20,0
1739702457103,MATH 276,A00,846199,Mc Culloch; Andrew Douglas,0,0,0,0
1739702458127,MATH 278A,A00,846283,Cheng; Li-Tien,10,0,10,0
1739702459153,MATH 278B,A00,846322,Cloninger; Alexander,10,0,10,0
1739702460177,MATH 278C,A00,846333,Nie; Jiawang,10,0,10,0
1739702461201,MATH 279,A01,846359,Cheng; Li-Tien,10,0,10,0
1739702462226,MATH 280C,A00,846360,Kemp; Todd Aahron,18,0,20,2
1739702463253,MATH 281C,A00,846363,Zhang; Danna,8,0,20,12
1739702464278,MATH 285,A00,846378,Schweinsberg; Jason,7,0,20,13
1739702465305,MATH 288,A00,846382,Ang; Jie Jun,9,0,10,1
1739702466335,MATH 289A,A00,846386,Novak; Jonathan I,15,0,20,5
1739702466335,MATH 289A,B00,846413,Lou; Zhipeng,13,0,20,7
1739702466335,MATH 289A,C00,876133,Xu; Ronghui,2,0,10,8
1739702467362,MATH 290C,A00,846451,Roberts; Justin Deritter,18,0,20,2
1739702468386,MATH 292,A00,846481,Lu; Yunze,9,0,10,1
1739702469410,MATH 295,A00,846486,Bejenaru; Ioan,50,0,50,0
1739702470433,MATH 296,A00,846492,Warnke; Lutz Peter,20,0,20,0
1739702471460,MATH 297,001,889670,Gamst; Anthony Collins,0,0,0,0
1739702472485,MATS 200,A00,825196,Graeve; Olivia A,9988,0,9999,11
1739702473512,MATS 201B,A00,825197,Garay; Javier,44,0,55,11
1739702474536,MATS 205A,A00,825200,Meyers; Marc,15,0,20,5
1739702475560,MATS 252,A00,825203,Evdokimenko; Ekaterina,16,0,30,14
1739702476586,MATS 256,A00,825204,Chen; Renkun,24,0,30,6
1739702477665,MATS 261B,A00,825205,Qiao; Yu,20,0,25,5
1739702478692,MBC 296,001,887235,Staff,9999,0,9999,0
1739702479717,MCWP 40,001,858225,Wastal; Carrie King,14,0,15,1
1739702479717,MCWP 40,003,858230,Wastal; Carrie King,12,0,15,3
1739702479717,MCWP 40,004,858231,Wastal; Carrie King,13,0,15,2
1739702479717,MCWP 40,006,858235,Montejo; Carolina,20,0,20,0
1739702479717,MCWP 40,007,858240,Wastal; Carrie King,15,0,15,0
1739702479717,MCWP 40,008,858241,Wastal; Carrie King,11,0,15,4
1739702480746,MCWP 50,001,826425,Bartulis; Jason Michael,19,0,20,1
1739702480746,MCWP 50,002,826426,Bartulis; Jason Michael,19,0,20,1
1739702480746,MCWP 50,003,826427,Bartulis; Jason Michael,20,0,20,0
1739702480746,MCWP 50,004,826429,Compas; Sean Matthew,17,0,20,3
1739702480746,MCWP 50,005,826431,Compas; Sean Matthew,20,0,20,0
1739702480746,MCWP 50,006,826432,Krone; Jarret,19,0,20,1
1739702480746,MCWP 50,007,826433,Krone; Jarret,19,0,20,1
1739702480746,MCWP 50,008,826434,Redela; Pamela Morgan,20,0,20,0
1739702480746,MCWP 50,009,826435,Redela; Pamela Morgan,20,0,20,0
1739702480746,MCWP 50,010,826436,Carter; Andrea L,17,0,20,3
1739702480746,MCWP 50,011,826437,Carter; Andrea L,20,0,20,0
1739702480746,MCWP 50,012,826439,Nies; Laurie Elizabeth,20,0,20,0
1739702480746,MCWP 50,013,826474,Nies; Laurie Elizabeth,19,0,20,1
1739702480746,MCWP 50,014,826483,Duru; Nur,17,0,20,3
1739702480746,MCWP 50,015,826484,Duru; Nur,20,0,20,0
1739702480746,MCWP 50,016,826486,Silva; Kelly B,20,0,20,0
1739702480746,MCWP 50,017,826488,Silva; Kelly B,20,0,20,0
1739702480746,MCWP 50,018,826489,Silva; Kelly B,20,0,20,0
1739702480746,MCWP 50,019,826490,Carter; Jennifer A,20,0,20,0
1739702480746,MCWP 50,020,826491,Carter; Jennifer A,20,0,20,0
1739702480746,MCWP 50,021,826492,Smith; Haydee Marie,20,0,20,0
1739702480746,MCWP 50,022,826493,Smith; Haydee Marie,19,0,20,1
1739702480746,MCWP 50,023,826543,Morshed; Michael James,16,0,20,4
1739702480746,MCWP 50,024,826579,Morshed; Michael James,16,0,20,4
1739702480746,MCWP 50,025,826582,Pham; Vincent Minhduc,20,0,20,0
1739702480746,MCWP 50,026,826609,Pham; Vincent Minhduc,20,0,20,0
1739702481774,MCWP 50R,A00,826669,Miller; Elizabeth Deen,17,0,20,3
1739702481774,MCWP 50R,B00,826714,Miller; Elizabeth Deen,19,0,20,1
1739702482800,MCWP 125,A00,826719,Guillen; Melinda,20,0,20,0
1739702482800,MCWP 125,B00,826720,Guillen; Melinda,18,0,20,2
1739702482800,MCWP 125,C00,826721,Guillen; Melinda,15,0,20,5
1739702483827,MED 225,A00,872558,Esko; Jeffrey D.,6,0,6,0
1739702484852,MED 246,A00,872562,Gordts; Philip & Lewis; Amanda Lark & Godula; Kamil & Gagneux; Pascal & Esko; Jeffrey D. & Bode; Lars,10,0,10,0
1739702485878,MED 262,A00,883267,Singh; Karandeep,31,0,35,4
1739702486903,MED 265,A00,884437,El-Kareh; Robert E & Sitapati; Amy,27,0,30,3
1739702487931,MED 267,A01,883697,Hogarth; Michael Andrew,23,0,30,7
1739702488957,MED 275,A00,872551,Liu; George Yenhsi,7,0,10,3
1739702489981,MED 278,A00,884420,Carter; Hannah Kathryn & Mesirov; Jill P. & Curtius; Kathleen Mary,14,0,16,2
1739702491006,MED 296,001,866575,Chi; Neil C.,4,0,5,1
1739702491006,MED 296,002,866576,Castellanos; Luis R.,4,0,5,1
1739702491006,MED 296,003,866585,Jeong; Ah-Reum,4,0,5,1
1739702491006,MED 296,004,866590,Staff,5,0,5,0
1739702491006,MED 296,005,866627,Staff,5,0,5,0
1739702492033,MGT 3,A00,839898,Wagner; Timothy Ryan,96,0,98,2
1739702493059,MGT 4,A01,839906,Levkoff; Steven B.,5,0,6,1
1739702493059,MGT 4,A02,839911,Levkoff; Steven B.,5,0,6,1
1739702493059,MGT 4,A03,839913,Levkoff; Steven B.,5,0,6,1
1739702493059,MGT 4,B01,839919,Brooks; Marcus Raymond,30,0,32,2
1739702494091,MGT 5,A00,839921,Molloie Jr.; William H,184,0,186,2
1739702495120,MGT 12,A00,839922,Lindenberger; Wade Douglas,88,0,98,10
1739702495120,MGT 12,B00,839926,Lindenberger; Wade Douglas,75,0,100,25
1739702495120,MGT 12,C00,840027,Pecore; Joseph P.,87,0,100,13
1739702496153,MGT 16,A00,840029,Buchanan; Harold G,95,0,100,5
1739702496153,MGT 16,B00,840031,Buchanan; Harold G,95,0,100,5
1739702496153,MGT 16,C00,840033,Campbell; Robert Harold,119,0,120,1
1739702496153,MGT 16,D00,840034,Campbell; Robert Harold,118,0,120,2
1739702496153,MGT 16,E00,840049,Demill; Burritt,98,0,98,0
1739702496153,MGT 16,F00,840056,Demill; Burritt,97,0,98,1
1739702497178,MGT 18,A00,840060,McKay; Michael J,97,0,98,1
1739702497178,MGT 18,B00,840063,McKay; Michael J,96,0,98,2
1739702497178,MGT 18,C00,840074,McKay; Michael J,94,0,98,4
1739702497178,MGT 18,D00,840076,Chamberlain; Travis Dean,98,0,98,0
1739702498202,MGT 45,A00,840097,Pecore; Joseph P.,128,0,150,22
1739702498202,MGT 45,B00,840098,Pecore; Joseph P.,141,0,150,9
1739702499226,MGT 71,A00,840099,Park; Kun Soo,94,0,98,4
1739702500254,MGT 71R,A00,840101,Phiroz; Zal Navroze,117,0,150,33
1739702501282,MGT 100,A00,840102,Wilbur; Kenneth C,78,0,98,20
1739702501282,MGT 100,B00,840103,Wilbur; Kenneth C,87,0,98,11
1739702501282,MGT 100,C00,840104,Wilbur; Kenneth C,95,0,98,3
1739702502317,MGT 103,A00,840105,Bates; Kenneth Walter,93,0,98,5
1739702502317,MGT 103,B00,840106,Demill; Burritt,97,0,98,1
1739702502317,MGT 103,C00,840107,Eberhard; Craig A,98,0,98,0
1739702502317,MGT 103,D00,840225,Eberhard; Craig A,97,0,98,1
1739702502317,MGT 103,E00,840226,Ehrich; Kristine R,93,0,98,5
1739702502317,MGT 103,F00,840227,Ehrich; Kristine R,95,0,98,3
1739702502317,MGT 103,G00,840228,Ehrich; Kristine R,96,0,98,2
1739702503345,MGT 105,A00,840229,Bates; Kenneth Walter,87,0,98,11
1739702504371,MGT 106,A00,840230,Eberhard; Craig A,96,0,98,2
1739702505396,MGT 107,A00,881472,Yorkston; Eric A,94,0,98,4
1739702506424,MGT 109,A00,840231,Jasko; Katarzyna Beata,85,0,98,13
1739702506424,MGT 109,B00,840232,Liu; Wei,87,0,98,11
1739702507448,MGT 112,A00,840233,Somasundaram; Tyagarajan,91,0,98,7
1739702507448,MGT 112,B00,840234,Somasundaram; Tyagarajan,76,0,98,22
1739702508474,MGT 119,A00,840235,Anderson; Jon Marcus,140,0,140,0
1739702508474,MGT 119,B00,840236,Davis; Kathleen Ann,98,0,98,0
1739702508474,MGT 119,C00,840237,Mc Kenzie; Craig R.M.,97,0,98,1
1739702508474,MGT 119,D00,840238,Etingue Kum; Menes,40,0,40,0
1739702509499,MGT 121B,A00,840239,Klaas; Jeffrey David,91,0,98,7
1739702510526,MGT 128R,A00,840240,Krishnan; Viswanathan,83,0,98,15
1739702511551,MGT 131A,A00,840242,Houskeeper; Robert,147,0,150,3
1739702512576,MGT 131B,A00,840243,Houskeeper; Robert,98,0,98,0
1739702513605,MGT 132,A00,840244,Blakley; Bruce,95,0,98,3
1739702514631,MGT 137,A00,840245,Lindenberger; Wade Douglas,84,0,98,14
1739702515659,MGT 146,A00,881478,Brooks; Marcus Raymond,97,0,98,1
1739702516682,MGT 147,A00,840246,Anderson; John Charles,74,0,75,1
1739702517709,MGT 151R,A00,840253,Phiroz; Zal Navroze,84,0,98,14
1739702518736,MGT 153,A00,840254,Perols; Johan Lars,67,0,90,23
1739702519761,MGT 155,A00,881481,Shin; Hyo Duk,95,0,98,3
1739702520786,MGT 160,A00,840265,Johnson; Erik Barry,90,0,90,0
1739702520786,MGT 160,B00,840266,Staff,87,0,90,3
1739702520786,MGT 160,C00,840267,Staff,82,0,90,8
1739702521812,MGT 162,A00,840269,Levin; Joel,93,0,98,5
1739702521812,MGT 162,B00,840270,Levin; Joel,98,0,98,0
1739702522837,MGT 162R,A00,840271,Gneezy; Uri,173,0,199,26
1739702523867,MGT 164,A00,840272,McKay; Mary A,98,0,98,0
1739702523867,MGT 164,B00,840273,McKay; Mary A,97,0,98,1
1739702523867,MGT 164,C00,840274,McKay; Mary A,97,0,98,1
1739702523867,MGT 164,D00,840275,Meyer; Alison Bloomfield,92,0,98,6
1739702524894,MGT 166,A00,840365,Moran; Cathleen L.,98,0,98,0
1739702524894,MGT 166,B00,840429,Moran; Cathleen L.,96,0,98,2
1739702524894,MGT 166,C00,840430,Moran; Cathleen L.,97,0,98,1
1739702525918,MGT 167,A00,840431,Klaas; Jeffrey David,96,0,98,2
1739702526942,MGT 171R,A00,840478,Phiroz; Zal Navroze,73,0,98,25
1739702527967,MGT 172,A00,840536,Hedges; Kathleen & Royal; Rebecca,114,0,120,6
1739702527967,MGT 172,B00,840580,Hedges; Kathleen,92,0,98,6
1739702527967,MGT 172,C00,840581,Zimmermann; Carsten,96,0,98,2
1739702527967,MGT 172,D00,881483,Zimmermann; Carsten,97,0,98,1
1739702528994,MGT 173,A00,840604,Hayes; Sherry Lorine,91,0,98,7
1739702530020,MGT 175,A00,840636,Gopal; Christopher S.,94,0,98,4
1739702531044,MGT 180,A00,840641,Bliss; Barbara Ann,145,0,150,5
1739702531044,MGT 180,B00,840642,Bliss; Barbara Ann,143,0,150,7
1739702532073,MGT 181,A00,840643,Buchanan; Harold G,117,0,120,3
1739702533096,MGT 184,A00,886143,Parashar; Sat P,89,0,98,9
1739702534121,MGT 185,A00,840648,Dunn; Louis Jean,88,0,98,10
1739702535148,MGT 187,A00,840649,Dunn; Louis Jean,68,0,75,7
1739702536172,MGT 189,A00,840650,Avenancio-Leon; Carlos,89,0,98,9
1739702537197,MGT 255,A00,840651,Rottenstreich; Yuval S,15,0,20,5
1739702538224,MGT 259,A00,872537,Staff,16,0,20,4
1739702539252,MGT 285,A00,840652,Liu; Jun,20,0,20,0
1739702540279,MGT 296,001,870424,Gneezy; Ayelet,3,0,3,0
1739702540279,MGT 296,002,870453,Amir; On,3,0,3,0
1739702540279,MGT 296,003,870454,Amir; On & Karmarkar; Uma R,3,0,3,0
1739702540279,MGT 296,004,870455,Liu; Jun,2,0,3,1
1739702540279,MGT 296,005,870456,Hansen; Karsten T.,3,0,3,0
1739702540279,MGT 296,006,870471,Erat; Sanjiv,3,0,3,0
1739702540279,MGT 296,007,870472,Timmermann; Allan,3,0,3,0
1739702540279,MGT 296,008,870501,Smith; Pamela Karen,3,0,3,0
1739702540279,MGT 296,009,870502,Zhang; Zhe,3,0,3,0
1739702540279,MGT 296,010,870508,Oveis; Christopher S,3,0,3,0
1739702540279,MGT 296,011,870523,Amir; On & Gneezy; Ayelet,2,0,3,1
1739702540279,MGT 296,012,870537,Luo; Danqi,3,0,3,0
1739702541313,MMW 13,A01,823232,Chang; Edmond Yi-Teh,16,0,16,0
1739702541313,MMW 13,A02,823239,Chang; Edmond Yi-Teh,16,0,16,0
1739702541313,MMW 13,A03,823242,Chang; Edmond Yi-Teh,16,0,16,0
1739702541313,MMW 13,A04,823251,Chang; Edmond Yi-Teh,16,0,16,0
1739702541313,MMW 13,A05,823252,Chang; Edmond Yi-Teh,16,0,16,0
1739702541313,MMW 13,A06,823253,Chang; Edmond Yi-Teh,15,0,16,1
1739702541313,MMW 13,A07,823255,Chang; Edmond Yi-Teh,16,0,16,0
1739702541313,MMW 13,A08,823257,Chang; Edmond Yi-Teh,16,0,16,0
1739702541313,MMW 13,A09,823263,Chang; Edmond Yi-Teh,16,0,16,0
1739702541313,MMW 13,A10,823291,Chang; Edmond Yi-Teh,16,0,16,0
1739702541313,MMW 13,A11,823292,Chang; Edmond Yi-Teh,16,0,16,0
1739702541313,MMW 13,A12,823293,Chang; Edmond Yi-Teh,16,0,16,0
1739702541313,MMW 13,A13,823370,Chang; Edmond Yi-Teh,0,0,0,0
1739702541313,MMW 13,A14,823480,Chang; Edmond Yi-Teh,0,0,0,0
1739702541313,MMW 13,A15,823481,Chang; Edmond Yi-Teh,16,0,16,0
1739702541313,MMW 13,A16,823482,Chang; Edmond Yi-Teh,15,0,16,1
1739702541313,MMW 13,A17,823483,Chang; Edmond Yi-Teh,16,0,16,0
1739702541313,MMW 13,A18,823484,Chang; Edmond Yi-Teh,16,0,16,0
1739702541313,MMW 13,A19,823485,Chang; Edmond Yi-Teh,0,0,0,0
1739702541313,MMW 13,A20,823486,Chang; Edmond Yi-Teh,0,0,0,0
1739702541313,MMW 13,B01,823488,Zhiri; Oumelbanine,15,0,16,1
1739702541313,MMW 13,B02,823490,Zhiri; Oumelbanine,15,0,16,1
1739702541313,MMW 13,B03,823491,Zhiri; Oumelbanine,14,0,16,2
1739702541313,MMW 13,B04,823492,Zhiri; Oumelbanine,15,0,16,1
1739702541313,MMW 13,B05,823493,Zhiri; Oumelbanine,16,0,16,0
1739702541313,MMW 13,B06,823494,Zhiri; Oumelbanine,13,0,16,3
1739702541313,MMW 13,B07,823495,Zhiri; Oumelbanine,15,0,16,1
1739702541313,MMW 13,B08,823496,Zhiri; Oumelbanine,15,0,16,1
1739702541313,MMW 13,B09,823522,Zhiri; Oumelbanine,16,0,16,0
1739702541313,MMW 13,B10,823528,Zhiri; Oumelbanine,16,0,16,0
1739702541313,MMW 13,B11,823604,Zhiri; Oumelbanine,16,0,16,0
1739702541313,MMW 13,B12,823613,Zhiri; Oumelbanine,16,0,16,0
1739702541313,MMW 13,B13,823624,Zhiri; Oumelbanine,16,0,16,0
1739702541313,MMW 13,B14,823627,Zhiri; Oumelbanine,15,0,16,1
1739702541313,MMW 13,B15,823631,Zhiri; Oumelbanine,16,0,16,0
1739702541313,MMW 13,B16,823642,Zhiri; Oumelbanine,15,0,16,1
1739702541313,MMW 13,C01,823773,Murillo; Dana V.,16,0,16,0
1739702541313,MMW 13,C02,823774,Murillo; Dana V.,16,0,16,0
1739702541313,MMW 13,C03,823793,Murillo; Dana V.,16,0,16,0
1739702541313,MMW 13,C04,823794,Murillo; Dana V.,16,0,16,0
1739702541313,MMW 13,C05,823801,Murillo; Dana V.,16,0,16,0
1739702541313,MMW 13,C06,823856,Murillo; Dana V.,16,0,16,0
1739702541313,MMW 13,C07,823876,Murillo; Dana V.,16,0,16,0
1739702541313,MMW 13,C08,823878,Murillo; Dana V.,16,0,16,0
1739702541313,MMW 13,C09,823956,Murillo; Dana V.,0,0,0,0
1739702541313,MMW 13,C10,823978,Murillo; Dana V.,0,0,0,0
1739702541313,MMW 13,C11,824009,Murillo; Dana V.,0,0,0,0
1739702541313,MMW 13,C12,824022,Murillo; Dana V.,0,0,0,0
1739702541313,MMW 13,C13,824023,Murillo; Dana V.,16,0,16,0
1739702541313,MMW 13,C14,824027,Murillo; Dana V.,15,0,16,1
1739702541313,MMW 13,C15,824029,Murillo; Dana V.,0,0,0,0
1739702541313,MMW 13,C16,824036,Murillo; Dana V.,0,0,0,0
1739702541313,MMW 13,D01,824044,Vitkus; Daniel J.,16,0,16,0
1739702541313,MMW 13,D02,824045,Vitkus; Daniel J.,16,0,16,0
1739702541313,MMW 13,D03,824050,Vitkus; Daniel J.,16,0,16,0
1739702541313,MMW 13,D04,824066,Vitkus; Daniel J.,16,0,16,0
1739702541313,MMW 13,D05,824070,Vitkus; Daniel J.,16,0,16,0
1739702541313,MMW 13,D06,824080,Vitkus; Daniel J.,16,0,16,0
1739702541313,MMW 13,D07,824081,Vitkus; Daniel J.,16,0,16,0
1739702541313,MMW 13,D08,824092,Vitkus; Daniel J.,16,0,16,0
1739702541313,MMW 13,D09,824112,Vitkus; Daniel J.,0,0,0,0
1739702541313,MMW 13,D10,824248,Vitkus; Daniel J.,0,0,0,0
1739702541313,MMW 13,D11,824303,Vitkus; Daniel J.,0,0,0,0
1739702541313,MMW 13,D12,824311,Vitkus; Daniel J.,0,0,0,0
1739702541313,MMW 13,D13,824312,Vitkus; Daniel J.,16,0,16,0
1739702541313,MMW 13,D14,824317,Vitkus; Daniel J.,16,0,16,0
1739702541313,MMW 13,D15,824377,Vitkus; Daniel J.,0,0,0,0
1739702541313,MMW 13,D16,824378,Vitkus; Daniel J.,0,0,0,0
1739702542346,MMW 15,A01,824426,Chang; Edmond Yi-Teh,27,0,28,1
1739702542346,MMW 15,A02,824586,Chang; Edmond Yi-Teh,26,0,28,2
1739702542346,MMW 15,A03,824617,Chang; Edmond Yi-Teh,24,0,28,4
1739702542346,MMW 15,A04,824641,Chang; Edmond Yi-Teh,26,0,28,2
1739702542346,MMW 15,A05,824653,Chang; Edmond Yi-Teh,25,0,28,3
1739702542346,MMW 15,A06,824689,Chang; Edmond Yi-Teh,28,0,28,0
1739702542346,MMW 15,A07,824735,Chang; Edmond Yi-Teh,28,0,28,0
1739702542346,MMW 15,A08,824804,Chang; Edmond Yi-Teh,27,0,28,1
1739702542346,MMW 15,A09,824805,Chang; Edmond Yi-Teh,0,0,0,0
1739702542346,MMW 15,A10,824963,Chang; Edmond Yi-Teh,0,0,0,0
1739702542346,MMW 15,B01,824999,Peterson; Johanna L,0,0,0,0
1739702542346,MMW 15,B02,825015,Peterson; Johanna L,0,0,0,0
1739702542346,MMW 15,B03,825050,Peterson; Johanna L,18,0,28,10
1739702542346,MMW 15,B04,825079,Peterson; Johanna L,24,0,28,4
1739702542346,MMW 15,B05,825109,Peterson; Johanna L,27,0,28,1
1739702542346,MMW 15,B06,825114,Peterson; Johanna L,24,0,28,4
1739702542346,MMW 15,B07,825151,Peterson; Johanna L,23,0,28,5
1739702542346,MMW 15,B08,825183,Peterson; Johanna L,19,0,28,9
1739702542346,MMW 15,B09,825190,Peterson; Johanna L,28,0,28,0
1739702542346,MMW 15,B10,825191,Peterson; Johanna L,26,0,28,2
1739702542346,MMW 15,B11,825192,Peterson; Johanna L,0,0,0,0
1739702542346,MMW 15,B12,825193,Peterson; Johanna L,0,0,0,0
1739702543372,MSED 295,A00,825207,Staff,5,0,5,0
1739702544398,MUS 1C,A01,826943,Staff,24,0,25,1
1739702544398,MUS 1C,A02,826944,Staff,23,0,25,2
1739702544398,MUS 1C,A03,826945,Staff,25,0,25,0
1739702545426,MUS 2C,A01,826955,Obermueller; Karola,29,0,30,1
1739702546453,MUS 2CK,A00,826957,Ohnishi; Takae,14,0,15,1
1739702546453,MUS 2CK,B00,826960,Ohnishi; Takae,15,0,15,0
1739702547478,MUS 2JK,A00,826963,Kenyatta; Kamau,13,0,15,2
1739702548508,MUS 4,A01,826968,Day; Kevin Alexander,24,0,25,1
1739702548508,MUS 4,A02,826969,Day; Kevin Alexander,24,0,25,1
1739702548508,MUS 4,A03,826970,Day; Kevin Alexander,25,0,25,0
1739702548508,MUS 4,A04,826972,Day; Kevin Alexander,25,0,25,0
1739702548508,MUS 4,A05,826973,Day; Kevin Alexander,25,0,25,0
1739702548508,MUS 4,A06,826986,Day; Kevin Alexander,25,0,25,0
1739702548508,MUS 4,A07,826987,Day; Kevin Alexander,25,0,25,0
1739702548508,MUS 4,A08,826988,Day; Kevin Alexander,25,0,25,0
1739702548508,MUS 4,A09,826989,Day; Kevin Alexander,25,0,25,0
1739702548508,MUS 4,A10,826990,Day; Kevin Alexander,24,0,25,1
1739702549534,MUS 6,A01,826992,Hankins; Sarah E.,24,0,25,1
1739702549534,MUS 6,A02,826993,Hankins; Sarah E.,23,0,25,2
1739702549534,MUS 6,A03,826994,Hankins; Sarah E.,25,0,25,0
1739702549534,MUS 6,A04,826995,Hankins; Sarah E.,22,0,25,3
1739702550567,MUS 8,A01,826997,Smythe; Cory Benjamin,23,0,25,2
1739702550567,MUS 8,A02,826998,Smythe; Cory Benjamin,25,0,25,0
1739702550567,MUS 8,A03,827002,Smythe; Cory Benjamin,25,0,25,0
1739702550567,MUS 8,A04,827003,Smythe; Cory Benjamin,22,0,25,3
1739702550567,MUS 8,A05,827004,Smythe; Cory Benjamin,25,0,25,0
1739702550567,MUS 8,A06,827005,Smythe; Cory Benjamin,25,0,25,0
1739702550567,MUS 8,A07,827006,Smythe; Cory Benjamin,24,0,25,1
1739702550567,MUS 8,A08,827007,Smythe; Cory Benjamin,23,0,25,2
1739702551593,MUS 11,A01,827011,Terrazas Perez; Wilfrido D,23,0,25,2
1739702551593,MUS 11,A02,827012,Terrazas Perez; Wilfrido D,23,0,25,2
1739702551593,MUS 11,A03,827013,Terrazas Perez; Wilfrido D,25,0,25,0
1739702551593,MUS 11,A04,827014,Terrazas Perez; Wilfrido D,24,0,25,1
1739702551593,MUS 11,A05,827015,Terrazas Perez; Wilfrido D,25,0,25,0
1739702551593,MUS 11,A06,827016,Terrazas Perez; Wilfrido D,25,0,25,0
1739702551593,MUS 11,A07,827017,Terrazas Perez; Wilfrido D,25,0,25,0
1739702551593,MUS 11,A08,827018,Terrazas Perez; Wilfrido D,22,0,25,3
1739702552620,MUS 12,A01,827020,Guy; Nancy,24,0,25,1
1739702552620,MUS 12,A02,827021,Guy; Nancy,25,0,25,0
1739702552620,MUS 12,A03,827022,Guy; Nancy,25,0,25,0
1739702552620,MUS 12,A04,827023,Guy; Nancy,24,0,25,1
1739702553649,MUS 14,A01,827025,McCormack; Timothy Matthew,25,0,25,0
1739702553649,MUS 14,A02,827026,McCormack; Timothy Matthew,25,0,25,0
1739702553649,MUS 14,A03,827027,McCormack; Timothy Matthew,24,0,25,1
1739702553649,MUS 14,A04,827028,McCormack; Timothy Matthew,25,0,25,0
1739702554678,MUS 15,A01,827031,Staff,22,0,25,3
1739702554678,MUS 15,A02,827032,Staff,23,0,25,2
1739702554678,MUS 15,A03,827033,Staff,24,0,25,1
1739702554678,MUS 15,A04,827034,Staff,25,0,25,0
1739702554678,MUS 15,A05,827035,Staff,25,0,25,0
1739702554678,MUS 15,A06,827036,Staff,23,0,25,2
1739702554678,MUS 15,A07,827037,Staff,25,0,25,0
1739702554678,MUS 15,A08,827038,Staff,24,0,25,1
1739702554678,MUS 15,A09,827039,Staff,25,0,25,0
1739702554678,MUS 15,A10,827049,Staff,23,0,25,2
1739702555709,MUS 17,A01,827051,Staff,24,0,25,1
1739702555709,MUS 17,A02,827052,Staff,25,0,25,0
1739702555709,MUS 17,A03,827053,Staff,25,0,25,0
1739702555709,MUS 17,A04,827054,Staff,24,0,25,1
1739702555709,MUS 17,A05,827055,Staff,25,0,25,0
1739702555709,MUS 17,A06,827056,Staff,24,0,25,1
1739702555709,MUS 17,A07,827057,Staff,24,0,25,1
1739702555709,MUS 17,A08,827060,Staff,23,0,25,2
1739702555709,MUS 17,A09,827061,Staff,25,0,25,0
1739702555709,MUS 17,A10,827062,Staff,25,0,25,0
1739702555709,MUS 17,A11,827063,Staff,25,0,25,0
1739702555709,MUS 17,A12,827064,Staff,25,0,25,0
1739702556734,MUS 19R,A01,827066,Britt; King James,23,0,25,2
1739702556734,MUS 19R,A02,827067,Britt; King James,15,0,25,10
1739702556734,MUS 19R,A03,827068,Britt; King James,25,0,25,0
1739702556734,MUS 19R,A04,827069,Britt; King James,22,0,25,3
1739702556734,MUS 19R,A05,827070,Britt; King James,25,0,25,0
1739702556734,MUS 19R,A06,827071,Britt; King James,21,0,25,4
1739702556734,MUS 19R,A07,827072,Britt; King James,24,0,25,1
1739702556734,MUS 19R,A08,827083,Britt; King James,23,0,25,2
1739702556734,MUS 19R,B01,827121,Britt; King James,5,0,5,0
1739702556734,MUS 19R,B02,827122,Britt; King James,5,0,5,0
1739702556734,MUS 19R,B03,827123,Britt; King James,5,0,5,0
1739702556734,MUS 19R,B04,827128,Britt; King James,5,0,5,0
1739702556734,MUS 19R,B05,827129,Britt; King James,5,0,5,0
1739702556734,MUS 19R,B06,827130,Britt; King James,5,0,5,0
1739702556734,MUS 19R,B07,827198,Britt; King James,5,0,5,0
1739702556734,MUS 19R,B08,827199,Britt; King James,5,0,5,0
1739702557763,MUS 32,001,855621,Dresser; Mark Stuart,10,0,10,0
1739702557763,MUS 32,002,855622,Kenyatta; Kamau,10,0,10,0
1739702557763,MUS 32,003,855623,Curtis; Charles Rector,10,0,10,0
1739702557763,MUS 32,004,855624,Carlstrom; Mitchell Kraig,10,0,10,0
1739702557763,MUS 32,005,855625,Terrazas Perez; Wilfrido D,10,0,10,0
1739702557763,MUS 32,006,855628,Ohnishi; Takae,10,0,10,0
1739702557763,MUS 32,007,855629,Burr; Anthony I,10,0,10,0
1739702557763,MUS 32,008,855630,Carlson; Erik,10,0,10,0
1739702557763,MUS 32,009,855631,Staff,10,0,10,0
1739702558792,MUS 32V,A00,827206,Narucki; Susan M,10,0,10,0
1739702558792,MUS 32V,B00,827209,Flores Bucio; Mariana,10,0,10,0
1739702558792,MUS 32V,C00,827210,Zazueta Cervera; Miguel Angel,10,0,10,0
1739702559816,MUS 32VM,A00,827211,Zazueta Cervera; Miguel Angel,19,0,19,0
1739702560840,MUS 43,A00,827216,Yadegari; Shahrokh D,91,0,96,5
1739702561870,MUS 95C,A00,827217,Flores Bucio; Mariana,34,0,40,6
1739702562897,MUS 95D,A00,827219,Yadegari; Shahrokh D,40,0,40,0
1739702563920,MUS 95E,A00,827229,Henson; Matthew Alexander,40,0,40,0
1739702564949,MUS 95F,A00,827332,Carlstrom; Mitchell Kraig,40,0,40,0
1739702565976,MUS 95G,A00,827371,Anderson; Kenneth,386,0,395,9
1739702565976,MUS 95G,B00,827384,Anderson; Kenneth,391,0,395,4
1739702567000,MUS 95JC,A00,827385,Kenyatta; Kamau,25,0,25,0
1739702568025,MUS 95L,A00,827386,Pittman; Katherine Sue,65,0,65,0
1739702569050,MUS 95P,A00,827387,Nourai; Keyavash,17,0,20,3
1739702570073,MUS 95W,A00,827388,Seshadri; Kartik,21,0,25,4
1739702570073,MUS 95W,B00,827389,Seshadri; Kartik,25,0,25,0
1739702571098,MUS 101C,A01,827517,Day; Kevin Alexander,34,0,35,1
1739702572124,MUS 103C,A00,827518,Steiger; Rand,14,0,15,1
1739702573148,MUS 103F,A00,827546,Steiger; Rand,1,0,1,0
1739702574173,MUS 107,A00,827547,Guy; Nancy,15,0,15,0
1739702575200,MUS 111,A00,827548,Liang; Lei,118,0,120,2
1739702576224,MUS 113,A00,827549,Narucki; Susan M,30,0,30,0
1739702577250,MUS 114,A00,827550,Schick; Steven,138,0,140,2
1739702578278,MUS 120C,A01,827563,Leslie Santana; Myrta,24,0,25,1
1739702579306,MUS 130,A00,827567,Ohnishi; Takae,35,0,35,0
1739702580335,MUS 132,001,855633,Dresser; Mark Stuart,10,0,10,0
1739702580335,MUS 132,002,855635,Kenyatta; Kamau,10,0,10,0
1739702580335,MUS 132,003,855637,Curtis; Charles Rector,10,0,10,0
1739702580335,MUS 132,004,855639,Carlstrom; Mitchell Kraig,10,0,10,0
1739702580335,MUS 132,006,855641,Terrazas Perez; Wilfrido D,10,0,10,0
1739702580335,MUS 132,007,855642,Ohnishi; Takae,10,0,10,0
1739702580335,MUS 132,008,855643,Burr; Anthony I,10,0,10,0
1739702580335,MUS 132,009,855646,Carlson; Erik,10,0,10,0
1739702580335,MUS 132,010,855647,Smythe; Cory Benjamin,10,0,10,0
1739702580335,MUS 132,011,855648,Richards; Stephanie F,10,0,10,0
1739702580335,MUS 132,012,855649,Nourai; Keyavash,10,0,10,0
1739702581416,MUS 132R,A00,827568,Narucki; Susan M,2,0,2,0
1739702582444,MUS 132V,A00,827569,Narucki; Susan M,15,0,15,0
1739702582444,MUS 132V,B00,827570,Zazueta Cervera; Miguel Angel,15,0,15,0
1739702582444,MUS 132V,C00,827572,Flores Bucio; Mariana,15,0,15,0
1739702583469,MUS 134,A00,827573,Yadegari; Shahrokh D,30,0,30,0
1739702584496,MUS 137C,A00,827574,Kenyatta; Kamau,35,0,35,0
1739702585521,MUS 143,A00,827575,Yadegari; Shahrokh D,28,0,30,2
1739702586546,MUS 150,A00,872496,Roberts; Matana,28,0,30,2
1739702587571,MUS 151,A00,827577,Hankins; Sarah E.,9,0,20,11
1739702588597,MUS 160B,A00,827579,Dubnov; Shlomo,14,0,15,1
1739702588597,MUS 160B,B00,827581,Freitas Caetano; Marcelo,15,0,15,0
1739702589621,MUS 172,A01,827584,Staff,38,0,45,7
1739702590645,MUS 174C,A00,827585,Erbe; Tom,21,0,27,6
1739702591671,MUS 175,A00,827586,Smyth; Tamara R.,27,0,30,3
1739702592698,MUS 176,A00,827587,Britt; King James,30,0,30,0
1739702593723,MUS 201A,A00,827590,Narucki; Susan M,15,0,15,0
1739702593723,MUS 201A,B00,827592,Dresser; Mark Stuart,15,0,15,0
1739702594746,MUS 201C,A00,827593,Schick; Steven,15,0,15,0
1739702595774,MUS 202,A00,827596,Schick; Steven,40,0,40,0
1739702596801,MUS 203C,A00,827597,McCormack; Timothy Matthew,13,0,15,2
1739702597827,MUS 203D,A00,827598,Davis; Anthony Curtis,10,0,10,0
1739702597827,MUS 203D,B00,827599,Obermueller; Karola,10,0,10,0
1739702597827,MUS 203D,C00,827600,Liang; Lei,10,0,10,0
1739702597827,MUS 203D,D00,827601,Lou; Michelle Siulai,10,0,10,0
1739702597827,MUS 203D,E00,827602,Steiger; Rand,10,0,10,0
1739702597827,MUS 203D,F00,827605,McCormack; Timothy Matthew,10,0,10,0
1739702598852,MUS 204,A00,827607,Obermueller; Karola,24,0,25,1
1739702599877,MUS 205,A00,827608,Hankins; Sarah E.,14,0,15,1
1739702600903,MUS 206,A00,827609,Lou; Michelle Siulai,0,0,0,0
1739702600903,MUS 206,B00,827610,Dresser; Mark Stuart,15,0,15,0
1739702600903,MUS 206,C00,872457,Roberts; Matana,14,0,15,1
1739702601929,MUS 207,A00,827611,Leslie Santana; Myrta,13,0,15,2
1739702601929,MUS 207,B00,872458,Guy; Nancy,15,0,15,0
1739702602956,MUS 210,A00,827612,Davis; Anthony Curtis,15,0,15,0
1739702603983,MUS 229,A00,872460,Liang; Lei,15,0,15,0
1739702605012,MUS 232,001,855654,Dresser; Mark Stuart,10,0,10,0
1739702605012,MUS 232,002,855655,Kenyatta; Kamau,10,0,10,0
1739702605012,MUS 232,003,855656,Curtis; Charles Rector,10,0,10,0
1739702605012,MUS 232,004,855659,Terrazas Perez; Wilfrido D,10,0,10,0
1739702605012,MUS 232,005,855660,Ohnishi; Takae,10,0,10,0
1739702605012,MUS 232,006,855661,Burr; Anthony I,10,0,10,0
1739702605012,MUS 232,007,855662,Carlson; Erik,10,0,10,0
1739702605012,MUS 232,008,855663,Schick; Steven,10,0,10,0
1739702605012,MUS 232,009,855664,Narucki; Susan M,10,0,10,0
1739702606040,MUS 234,A00,827614,Yadegari; Shahrokh D,20,0,20,0
1739702607066,MUS 245,A00,827616,Carlson; Erik,15,0,15,0
1739702608094,MUS 267,A00,827617,Erbe; Tom,13,0,15,2
1739702609118,MUS 270C,A00,827618,Dubnov; Shlomo,18,0,20,2
1739702610145,NANO 100L,A00,808557,Vecchio; Kenneth S,17,0,20,3
1739702611172,NANO 103,A00,808560,Jahed Motlagh; Zeinab,49,0,50,1
1739702612197,NANO 108,A00,808561,Lubarda; Vlado,100,0,100,0
1739702613226,NANO 112,A01,808563,Vazquez Mena; Oscar,69,0,70,1
1739702614256,NANO 115L,A01,808567,Xu; Sheng,32,0,38,6
1739702614256,NANO 115L,B01,808569,Yang; Kesong,38,0,38,0
1739702615281,NANO 120B,A01,808575,Pokorski; Jonathan Kyle,32,0,35,3
1739702615281,NANO 120B,B01,808577,Ong; Shyue Ping,34,0,35,1
1739702616307,NANO 158,A00,808580,Luo; Jian,50,0,50,0
1739702617332,NANO 174,A00,808582,Meyers; Marc,49,0,50,1
1739702618360,NANO 181R,A00,869155,Ong; Shyue Ping,38,0,40,2
1739702619386,NANO 200,A00,808584,Jahed Motlagh; Zeinab,108,0,120,12
1739702620413,NANO 273,A00,808614,Shah; Nisarg,24,0,30,6
1739702621438,NANO 279,A00,808619,Liu; Ping,44,0,50,6
1739702622462,NANO 281R,A00,808633,Ong; Shyue Ping,37,0,60,23
1739702623498,NANO 282,A00,808661,Steinmetz; Nicole F,49,0,50,1
1739702624526,NEU 200C,A00,827621,Miller; Cory T.,15,0,18,3
1739702625554,NEU 276,A01,827623,Castle; Michael James,26,0,28,2
1739702626580,NEU 296,001,866729,Evans; Sean Jeffrey,6,0,10,4
1739702626580,NEU 296,002,866730,Staff,5,0,5,0
1739702626580,NEU 296,003,866731,Staff,5,0,5,0
1739702627604,NEUG 221,A00,827624,Zou; Yimin,8,0,12,4
1739702628630,NEUG 280,A00,827625,Chen; Xu,12,0,12,0
1739702629658,NEUG 296,A00,827626,Bloodgood; Brenda Laurie,9999,0,9999,0
1739702629658,NEUG 296,B00,827627,Allen; Nicola J,9999,0,9999,0
1739702630685,OPTH 296,001,866835,Afshari; Natalie,4,0,5,1
1739702630685,OPTH 296,002,866836,Staff,5,0,5,0
1739702630685,OPTH 296,003,866838,Staff,5,0,5,0
1739702631712,ORTH 296,A00,866851,Staff,5,0,5,0
1739702631712,ORTH 296,001,866849,Schwartz; Alexandra K.,4,0,5,1
1739702631712,ORTH 296,002,866850,Staff,5,0,5,0
1739702632738,PAE 240,A00,866068,Villarreal Jr.; Elias,30,0,30,0
1739702633763,PAE 241,A01,866073,Villarreal Jr.; Elias,30,0,30,0
1739702634790,PAE 242,A00,866077,Villarreal Jr.; Elias,30,0,30,0
1739702635815,PAE 243,A00,866078,Villarreal Jr.; Elias,30,0,30,0
1739702636838,PAE 244,A00,866119,Villarreal Jr.; Elias,30,0,30,0
1739702637863,PAE 245,A01,866083,Villarreal Jr.; Elias,30,0,30,0
1739702638890,PAE 246,A00,866085,Villarreal Jr.; Elias,30,0,30,0
1739702639918,PATH 296,001,866942,Staff,5,0,5,0
1739702639918,PATH 296,002,866945,Staff,5,0,5,0
1739702639918,PATH 296,003,866947,Staff,5,0,5,0
1739702640946,PEDS 296,001,866976,Staff,5,0,5,0
1739702640946,PEDS 296,002,866982,Staff,5,0,5,0
1739702640946,PEDS 296,003,866985,Staff,5,0,5,0
1739702641974,PH 45,A01,818863,Stone; Matthew David,28,0,30,2
1739702641974,PH 45,A02,818864,Stone; Matthew David,26,0,30,4
1739702643002,PH 50,A00,818865,Glockner; Susan Mariscal,291,0,300,9
1739702644030,PH 95,A00,885315,Larsen; Britta Ann,39,0,40,1
1739702645055,PH 101,A00,818868,Tan; Gene Brian,43,0,50,7
1739702646082,PH 102,A01,818870,Rana; Brinda Kanti,17,0,25,8
1739702646082,PH 102,A02,818871,Rana; Brinda Kanti,22,0,25,3
1739702646082,PH 102,B01,818963,Rana; Brinda Kanti,21,0,25,4
1739702646082,PH 102,B02,818965,Rana; Brinda Kanti,24,0,25,1
1739702647108,PH 110,A00,818966,Campbell; Chadwick Karl,58,0,60,2
1739702647108,PH 110,B00,818968,Zoumas-Morse; Christine E.,46,0,50,4
1739702648134,PH 120,A00,818972,Wynn; Adriane Michelle,50,0,60,10
1739702649158,PH 130,A00,818976,Gould; Carlos Francisco,36,0,50,14
1739702650183,PH 155,A00,818977,Fielding-Miller; Rebecca,68,0,70,2
1739702651207,PH 162,A00,872363,Eikey; Elizabeth Victoria,23,0,30,7
1739702652233,PH 194,A00,818984,Zoumas-Morse; Christine E.,0,0,0,0
1739702652233,PH 194,B00,819006,Zoumas-Morse; Christine E.,0,0,0,0
1739702652233,PH 194,C00,819010,Nguyen-Grozavu; France T.,0,0,0,0
1739702652233,PH 194,D00,819013,Nguyen-Grozavu; France T.,0,0,0,0
1739702652233,PH 194,E00,819017,White; Anne Elizabeth Clar,0,0,0,0
1739702652233,PH 194,F00,819024,Marquez; Becky,0,0,0,0
1739702653257,PH 196BH,A01,819028,Binkin; Nancy Jeanne,20,0,20,0
1739702654284,PHAR 219,A00,828488,Ross; Camille,0,0,0,0
1739702655308,PHAR 227,A00,872418,Zhang; Jin,19,0,20,1
1739702656334,PHAR 231,A00,881484,Daneman; Richard & Newton; Alexandra C.,20,0,20,0
1739702656334,PHAR 231,B00,881486,Staff,20,0,20,0
1739702656334,PHAR 231,C00,881489,Schoeneberg; Johannes,20,0,20,0
1739702657359,PHAR 234,A00,881479,Newton; Alexandra C.,20,0,20,0
1739702658386,PHAR 276,A00,828494,Mc Culloch; Andrew Douglas,0,0,0,0
1739702659412,PHAR 295,A00,828499,Joiner; William J.,14,0,15,1
1739702660438,PHB 223,A00,819029,Vaida; Florin,17,0,36,19
1739702661461,PHB 228,A00,819036,Thomas; Ronald G,26,0,36,10
1739702662486,PHB 248,A00,819043,Xu; Ronghui,10,0,25,15
1739702663514,PHB 281,A00,872569,Staff,55,0,65,10
1739702664539,PHIL 1,A00,829682,Grush; Rick Scott,57,0,60,3
1739702665564,PHIL 10,A01,829896,Grush; Rick Scott,44,0,44,0
1739702665564,PHIL 10,A02,829897,Grush; Rick Scott,43,0,44,1
1739702665564,PHIL 10,A03,829898,Grush; Rick Scott,43,0,44,1
1739702665564,PHIL 10,A04,829899,Grush; Rick Scott,42,0,44,2
1739702665564,PHIL 10,A05,829900,Grush; Rick Scott,42,0,44,2
1739702665564,PHIL 10,A06,829901,Grush; Rick Scott,42,0,44,2
1739702666589,PHIL 13,A01,829909,Brandt; Reuven A,0,0,0,0
1739702666589,PHIL 13,A02,829910,Brandt; Reuven A,21,0,25,4
1739702666589,PHIL 13,A03,829911,Brandt; Reuven A,0,0,0,0
1739702666589,PHIL 13,A04,829912,Brandt; Reuven A,25,0,25,0
1739702666589,PHIL 13,A05,829913,Brandt; Reuven A,23,0,25,2
1739702666589,PHIL 13,A06,829914,Brandt; Reuven A,24,0,25,1
1739702667615,PHIL 27,A01,829916,Harrell; Maralee Mae,20,0,25,5
1739702667615,PHIL 27,A02,829917,Harrell; Maralee Mae,21,0,25,4
1739702667615,PHIL 27,A03,829918,Harrell; Maralee Mae,17,0,25,8
1739702667615,PHIL 27,A04,829919,Harrell; Maralee Mae,23,0,25,2
1739702668644,PHIL 28,A01,829921,Lamey; Andy M.,24,0,25,1
1739702668644,PHIL 28,A02,829922,Lamey; Andy M.,24,0,25,1
1739702668644,PHIL 28,A03,829923,Lamey; Andy M.,15,0,25,10
1739702668644,PHIL 28,A04,829924,Lamey; Andy M.,24,0,25,1
1739702668644,PHIL 28,A05,829925,Lamey; Andy M.,23,0,25,2
1739702668644,PHIL 28,A06,829926,Lamey; Andy M.,24,0,25,1
1739702669670,PHIL 33,A01,829928,Tolley; Clinton,23,0,25,2
1739702669670,PHIL 33,A02,829929,Tolley; Clinton,24,0,25,1
1739702670696,PHIL 50,A00,829930,Yuan; Yuan,111,0,120,9
1739702671722,PHIL 60,A00,829989,Marechal; Patricia,33,0,33,0
1739702672747,PHIL 101,A00,829994,Marechal; Patricia,58,0,60,2
1739702673773,PHIL 102,A00,830057,Johnson; Monte,30,0,33,3
1739702674800,PHIL 108,A00,830058,Hardimon; Michael O.,31,0,33,2
1739702675826,PHIL 112,A00,830059,Hardimon; Michael O.,35,0,40,5
1739702676851,PHIL 120,A00,830060,Carr; Jennifer Rose,50,0,55,5
1739702677875,PHIL 125,A00,830063,Carr; Jennifer Rose,32,0,33,1
1739702678903,PHIL 131,A00,830065,Watkins; Eric,32,0,33,1
1739702679929,PHIL 134,A00,830066,Rudolph; Rachel Etta,31,0,33,2
1739702680956,PHIL 145,A00,830069,McKenzie; Kerry V.,54,0,60,6
1739702681982,PHIL 155,A00,830070,Tolley; Clinton,115,0,120,5
1739702683009,PHIL 160,A00,830071,Yuan; Yuan,32,0,33,1
1739702684036,PHIL 162,A00,830072,Lamey; Andy M.,41,0,42,1
1739702685115,PHIL 173,A00,830076,Brandt; Reuven A,108,0,120,12
1739702686144,PHIL 174,A01,830079,Danks; David J,27,0,27,0
1739702686144,PHIL 174,A02,830080,Danks; David J,27,0,27,0
1739702686144,PHIL 174,A03,830081,Danks; David J,27,0,27,0
1739702686144,PHIL 174,A04,830083,Danks; David J,27,0,27,0
1739702686144,PHIL 174,A05,830084,Danks; David J,26,0,27,1
1739702686144,PHIL 174,A06,830089,Danks; David J,27,0,27,0
1739702686144,PHIL 174,A07,830090,Danks; David J,27,0,27,0
1739702686144,PHIL 174,A08,830093,Danks; David J,27,0,27,0
1739702687172,PHIL 201A,A00,830095,Watkins; Eric,17,0,20,3
1739702688196,PHIL 202,A00,830097,Brink; David O.,16,0,20,4
1739702689223,PHIL 209B,A00,830098,Gere; Catherina M.,9,0,10,1
1739702690249,PHIL 209C,A00,830108,McKenzie; Kerry V.,10,0,10,0
1739702691277,PHIL 232,A00,830138,Sher; Gila,18,0,20,2
1739702692311,PHIL 234,A00,830139,Rudolph; Rachel Etta,18,0,20,2
1739702693336,PHIL 271,A00,830142,Vargas; Manuel Rogelio & Fulkerson; Matthew Todd,10,0,10,0
1739702694364,PHIL 275,A00,830179,Watkins; Eric,9,0,10,1
1739702695388,PHIL 277,A00,830185,Tolley; Clinton,9,0,10,1
1739702696414,PHIL 278,A00,830186,Fulkerson; Matthew Todd & Cohen; Jonathan David,10,0,10,0
1739702697440,PHIL 280,A00,830192,Kovaka; Karenc,10,0,10,0
1739702698465,PHIL 281,A00,830207,Tolley; Clinton,10,0,10,0
1739702699494,PHIL 283,A00,830214,Tolley; Clinton & Vargas; Manuel Rogelio,9,0,10,1
1739702700518,PHIL 284,A00,830244,Kovaka; Karenc,10,0,10,0
1739702701546,PHIL 285,A00,830255,Fulkerson; Matthew Todd & Cohen; Jonathan David,18,0,20,2
1739702702571,PHIL 286,A00,830259,Callender; Craig Adam & Chen; Keming,10,0,10,0
1739702703595,PHIL 287,A00,830262,Johnson; Monte,10,0,10,0
1739702704629,PHIL 290,001,828857,Nelkin; Dana Kay,9999,0,9999,0
1739702704629,PHIL 290,002,828858,Bazargan-Forward; Saba,9999,0,9999,0
1739702704629,PHIL 290,003,828861,Brandt; Reuven A,9999,0,9999,0
1739702704629,PHIL 290,004,828864,Brink; David O.,9999,0,9999,0
1739702704629,PHIL 290,005,828868,Callender; Craig Adam,9999,0,9999,0
1739702704629,PHIL 290,006,828869,Carr; Jennifer Rose,9999,0,9999,0
1739702704629,PHIL 290,007,828875,Cartwright; Nancy D.,9999,0,9999,0
1739702704629,PHIL 290,008,828878,Cohen; Jonathan David,9999,0,9999,0
1739702704629,PHIL 290,009,828880,Danks; David J,9999,0,9999,0
1739702704629,PHIL 290,010,828896,Fulkerson; Matthew Todd,9999,0,9999,0
1739702704629,PHIL 290,011,828897,Grush; Rick Scott,9999,0,9999,0
1739702704629,PHIL 290,012,828934,Hardimon; Michael O.,9999,0,9999,0
1739702704629,PHIL 290,013,828950,Harrell; Maralee Mae,9999,0,9999,0
1739702704629,PHIL 290,014,828951,Johnson; Monte,9999,0,9999,0
1739702704629,PHIL 290,015,828956,Kovaka; Karenc,9999,0,9999,0
1739702704629,PHIL 290,016,828959,Lamey; Andy M.,9999,0,9999,0
1739702704629,PHIL 290,017,828963,Marechal; Patricia,9999,0,9999,0
1739702704629,PHIL 290,018,828969,McKenzie; Kerry V.,9999,0,9999,0
1739702704629,PHIL 290,019,828970,Rickless; Samuel Charles,9999,0,9999,0
1739702704629,PHIL 290,020,828971,Sher; Gila,9999,0,9999,0
1739702704629,PHIL 290,021,828983,Shields; Christopher John,9999,0,9999,0
1739702704629,PHIL 290,022,829062,Tolley; Clinton,9999,0,9999,0
1739702704629,PHIL 290,023,829063,Vargas; Manuel Rogelio,9999,0,9999,0
1739702704629,PHIL 290,024,829065,Watkins; Eric,9999,0,9999,0
1739702704629,PHIL 290,025,829067,Chen; Keming,9999,0,9999,0
1739702704629,PHIL 290,026,829069,Yuan; Yuan,9999,0,9999,0
1739702704629,PHIL 290,027,829070,Kocurek; Alexander William,9999,0,9999,0
1739702704629,PHIL 290,028,829073,Rudolph; Rachel Etta,9999,0,9999,0
1739702705657,PHIL 295,001,829074,Bazargan-Forward; Saba,9999,0,9999,0
1739702705657,PHIL 295,002,829076,Brandt; Reuven A,9999,0,9999,0
1739702705657,PHIL 295,003,829080,Brink; David O.,9999,0,9999,0
1739702705657,PHIL 295,004,829081,Callender; Craig Adam,9999,0,9999,0
1739702705657,PHIL 295,005,829082,Carr; Jennifer Rose,9999,0,9999,0
1739702705657,PHIL 295,006,829135,Cartwright; Nancy D.,9999,0,9999,0
1739702705657,PHIL 295,007,829136,Chen; Keming,9999,0,9999,0
1739702705657,PHIL 295,008,829137,Cohen; Jonathan David,9999,0,9999,0
1739702705657,PHIL 295,009,829138,Danks; David J,9999,0,9999,0
1739702705657,PHIL 295,010,829139,Fulkerson; Matthew Todd,9999,0,9999,0
1739702705657,PHIL 295,011,829143,Grush; Rick Scott,9999,0,9999,0
1739702705657,PHIL 295,012,829144,Hardimon; Michael O.,9999,0,9999,0
1739702705657,PHIL 295,013,829145,Harrell; Maralee Mae,9999,0,9999,0
1739702705657,PHIL 295,014,829146,Johnson; Monte,9999,0,9999,0
1739702705657,PHIL 295,015,829147,Kovaka; Karenc,9999,0,9999,0
1739702705657,PHIL 295,016,829148,Lamey; Andy M.,9999,0,9999,0
1739702705657,PHIL 295,017,829149,Marechal; Patricia,9999,0,9999,0
1739702705657,PHIL 295,018,829150,McKenzie; Kerry V.,9999,0,9999,0
1739702705657,PHIL 295,019,829151,Nelkin; Dana Kay,9999,0,9999,0
1739702705657,PHIL 295,020,829152,Rickless; Samuel Charles,9999,0,9999,0
1739702705657,PHIL 295,021,829153,Sher; Gila,9999,0,9999,0
1739702705657,PHIL 295,022,829154,Shields; Christopher John,9999,0,9999,0
1739702705657,PHIL 295,023,829156,Tolley; Clinton,9999,0,9999,0
1739702705657,PHIL 295,024,829157,Vargas; Manuel Rogelio,9999,0,9999,0
1739702705657,PHIL 295,025,829158,Watkins; Eric,9999,0,9999,0
1739702705657,PHIL 295,026,829159,Kocurek; Alexander William,9999,0,9999,0
1739702705657,PHIL 295,027,829160,Rudolph; Rachel Etta,9999,0,9999,0
1739702705657,PHIL 295,028,829161,Yuan; Yuan,9999,0,9999,0
1739702706681,PHYS 1A,A00,830264,Tsai; Philbert S,350,0,360,10
1739702707706,PHYS 1AL,001,830274,Yagil; Avi & Tsai; Philbert S,25,0,30,5
1739702707706,PHYS 1AL,002,830320,Yagil; Avi & Tsai; Philbert S,28,0,30,2
1739702707706,PHYS 1AL,003,830324,Yagil; Avi & Tsai; Philbert S,29,0,30,1
1739702707706,PHYS 1AL,004,830352,Yagil; Avi & Tsai; Philbert S,30,0,30,0
1739702707706,PHYS 1AL,005,830364,Yagil; Avi & Tsai; Philbert S,27,0,30,3
1739702707706,PHYS 1AL,006,830365,Yagil; Avi & Tsai; Philbert S,25,0,30,5
1739702707706,PHYS 1AL,007,830366,Yagil; Avi & Tsai; Philbert S,30,0,30,0
1739702707706,PHYS 1AL,008,830378,Yagil; Avi & Tsai; Philbert S,29,0,30,1
1739702707706,PHYS 1AL,009,830485,Yagil; Avi & Tsai; Philbert S,29,0,30,1
1739702707706,PHYS 1AL,010,830486,Yagil; Avi & Tsai; Philbert S,30,0,30,0
1739702707706,PHYS 1AL,011,830496,Yagil; Avi & Tsai; Philbert S,30,0,30,0
1739702708734,PHYS 1B,A00,830497,Groisman; Alexander,344,0,360,16
1739702709765,PHYS 1BL,001,830498,Yagil; Avi & Tsai; Philbert S,29,0,30,1
1739702709765,PHYS 1BL,002,830499,Yagil; Avi & Tsai; Philbert S,29,0,30,1
1739702709765,PHYS 1BL,003,830500,Yagil; Avi & Tsai; Philbert S,29,0,30,1
1739702709765,PHYS 1BL,004,830501,Yagil; Avi & Tsai; Philbert S,28,0,30,2
1739702709765,PHYS 1BL,005,830502,Yagil; Avi & Tsai; Philbert S,29,0,30,1
1739702709765,PHYS 1BL,006,830503,Yagil; Avi & Tsai; Philbert S,28,0,30,2
1739702709765,PHYS 1BL,007,830504,Yagil; Avi & Tsai; Philbert S,26,0,30,4
1739702709765,PHYS 1BL,008,830505,Yagil; Avi & Tsai; Philbert S,29,0,30,1
1739702709765,PHYS 1BL,009,830507,Yagil; Avi & Tsai; Philbert S,29,0,30,1
1739702709765,PHYS 1BL,010,830508,Yagil; Avi & Tsai; Philbert S,26,0,30,4
1739702709765,PHYS 1BL,011,830509,Yagil; Avi & Tsai; Philbert S,29,0,30,1
1739702709765,PHYS 1BL,012,830510,Yagil; Avi & Tsai; Philbert S,29,0,30,1
1739702710790,PHYS 1C,A00,830511,Popmintchev; Tenio,591,0,600,9
1739702710790,PHYS 1C,B00,830512,Popmintchev; Tenio,562,0,600,38
1739702711830,PHYS 1CL,001,830513,Yagil; Avi & Tsai; Philbert S,29,0,30,1
1739702711830,PHYS 1CL,002,830514,Yagil; Avi & Tsai; Philbert S,30,0,30,0
1739702711830,PHYS 1CL,003,830515,Yagil; Avi & Tsai; Philbert S,24,0,30,6
1739702711830,PHYS 1CL,004,830516,Yagil; Avi & Tsai; Philbert S,26,0,30,4
1739702711830,PHYS 1CL,005,830517,Yagil; Avi & Tsai; Philbert S,24,0,30,6
1739702711830,PHYS 1CL,006,830518,Yagil; Avi & Tsai; Philbert S,30,0,30,0
1739702711830,PHYS 1CL,007,830519,Yagil; Avi & Tsai; Philbert S,26,0,30,4
1739702711830,PHYS 1CL,008,830520,Yagil; Avi & Tsai; Philbert S,25,0,30,5
1739702711830,PHYS 1CL,009,830521,Yagil; Avi & Tsai; Philbert S,28,0,30,2
1739702711830,PHYS 1CL,010,830522,Yagil; Avi & Tsai; Philbert S,29,0,30,1
1739702711830,PHYS 1CL,011,872498,Yagil; Avi & Tsai; Philbert S,30,0,30,0
1739702711830,PHYS 1CL,012,872499,Yagil; Avi & Tsai; Philbert S,30,0,30,0
1739702711830,PHYS 1CL,013,830584,Yagil; Avi & Tsai; Philbert S,18,0,30,12
1739702711830,PHYS 1CL,014,830586,Yagil; Avi & Tsai; Philbert S,27,0,30,3
1739702711830,PHYS 1CL,015,830588,Yagil; Avi & Tsai; Philbert S,26,0,30,4
1739702711830,PHYS 1CL,016,830591,Yagil; Avi & Tsai; Philbert S,24,0,30,6
1739702711830,PHYS 1CL,017,830592,Yagil; Avi & Tsai; Philbert S,29,0,30,1
1739702711830,PHYS 1CL,018,830598,Yagil; Avi & Tsai; Philbert S,27,0,30,3
1739702711830,PHYS 1CL,019,830604,Yagil; Avi & Tsai; Philbert S,29,0,30,1
1739702711830,PHYS 1CL,020,830605,Yagil; Avi & Tsai; Philbert S,28,0,30,2
1739702711830,PHYS 1CL,021,830607,Yagil; Avi & Tsai; Philbert S,27,0,30,3
1739702711830,PHYS 1CL,022,830609,Yagil; Avi & Tsai; Philbert S,28,0,30,2
1739702711830,PHYS 1CL,023,872500,Yagil; Avi & Tsai; Philbert S,28,0,30,2
1739702711830,PHYS 1CL,024,872501,Yagil; Avi & Tsai; Philbert S,30,0,30,0
1739702711830,PHYS 1CL,025,830613,Yagil; Avi & Tsai; Philbert S,29,0,30,1
1739702711830,PHYS 1CL,026,830617,Yagil; Avi & Tsai; Philbert S,30,0,30,0
1739702711830,PHYS 1CL,027,830658,Yagil; Avi & Tsai; Philbert S,30,0,30,0
1739702711830,PHYS 1CL,028,830661,Yagil; Avi & Tsai; Philbert S,29,0,30,1
1739702711830,PHYS 1CL,029,830669,Yagil; Avi & Tsai; Philbert S,25,0,30,5
1739702711830,PHYS 1CL,030,830676,Yagil; Avi & Tsai; Philbert S,30,0,30,0
1739702711830,PHYS 1CL,031,830679,Yagil; Avi & Tsai; Philbert S,24,0,30,6
1739702711830,PHYS 1CL,032,830680,Yagil; Avi & Tsai; Philbert S,28,0,30,2
1739702711830,PHYS 1CL,033,872502,Yagil; Avi & Tsai; Philbert S,30,0,30,0
1739702711830,PHYS 1CL,034,872503,Yagil; Avi & Tsai; Philbert S,27,0,30,3
1739702712858,PHYS 2A,A01,830828,Shotwell; Brian,19,0,30,11
1739702712858,PHYS 2A,A02,830829,Shotwell; Brian,29,0,30,1
1739702712858,PHYS 2A,A03,830830,Shotwell; Brian,30,0,30,0
1739702712858,PHYS 2A,A04,830831,Shotwell; Brian,30,0,30,0
1739702712858,PHYS 2A,A05,830832,Shotwell; Brian,28,0,30,2
1739702712858,PHYS 2A,A06,830849,Shotwell; Brian,27,0,30,3
1739702712858,PHYS 2A,A07,830887,Shotwell; Brian,28,0,30,2
1739702712858,PHYS 2A,A08,830888,Shotwell; Brian,30,0,30,0
1739702712858,PHYS 2A,A09,830889,Shotwell; Brian,30,0,30,0
1739702712858,PHYS 2A,A10,830890,Shotwell; Brian,30,0,30,0
1739702712858,PHYS 2A,A11,830934,Shotwell; Brian,0,0,0,0
1739702712858,PHYS 2A,A12,830938,Shotwell; Brian,0,0,0,0
1739702713886,PHYS 2B,A01,830950,Meyertholen; Andrew D.,29,0,30,1
1739702713886,PHYS 2B,A02,830982,Meyertholen; Andrew D.,30,0,30,0
1739702713886,PHYS 2B,A03,830983,Meyertholen; Andrew D.,30,0,30,0
1739702713886,PHYS 2B,A04,830984,Meyertholen; Andrew D.,30,0,30,0
1739702713886,PHYS 2B,A05,830985,Meyertholen; Andrew D.,25,0,30,5
1739702713886,PHYS 2B,A06,830986,Meyertholen; Andrew D.,30,0,30,0
1739702713886,PHYS 2B,A07,830987,Meyertholen; Andrew D.,28,0,30,2
1739702713886,PHYS 2B,A08,830988,Meyertholen; Andrew D.,29,0,30,1
1739702713886,PHYS 2B,A09,830989,Meyertholen; Andrew D.,30,0,30,0
1739702713886,PHYS 2B,A10,831009,Meyertholen; Andrew D.,29,0,30,1
1739702713886,PHYS 2B,A11,831010,Meyertholen; Andrew D.,24,0,30,6
1739702713886,PHYS 2B,A12,831018,Meyertholen; Andrew D.,30,0,30,0
1739702713886,PHYS 2B,B01,831020,Meyertholen; Andrew D.,21,0,30,9
1739702713886,PHYS 2B,B02,831021,Meyertholen; Andrew D.,30,0,30,0
1739702713886,PHYS 2B,B03,831022,Meyertholen; Andrew D.,29,0,30,1
1739702713886,PHYS 2B,B04,831036,Meyertholen; Andrew D.,28,0,30,2
1739702713886,PHYS 2B,B05,831037,Meyertholen; Andrew D.,29,0,30,1
1739702713886,PHYS 2B,B06,831043,Meyertholen; Andrew D.,30,0,30,0
1739702713886,PHYS 2B,B07,831046,Meyertholen; Andrew D.,30,0,30,0
1739702713886,PHYS 2B,B08,831047,Meyertholen; Andrew D.,30,0,30,0
1739702713886,PHYS 2B,B09,831061,Meyertholen; Andrew D.,29,0,30,1
1739702713886,PHYS 2B,B10,831062,Meyertholen; Andrew D.,29,0,30,1
1739702713886,PHYS 2B,B11,831069,Meyertholen; Andrew D.,30,0,30,0
1739702713886,PHYS 2B,B12,831070,Meyertholen; Andrew D.,30,0,30,0
1739702714913,PHYS 2BL,A01,831108,Sharma; Vivek A.,24,0,24,0
1739702714913,PHYS 2BL,A02,831109,Sharma; Vivek A.,12,0,24,12
1739702714913,PHYS 2BL,A03,831112,Sharma; Vivek A.,22,0,24,2
1739702714913,PHYS 2BL,A04,831113,Sharma; Vivek A.,21,0,24,3
1739702714913,PHYS 2BL,A05,831127,Sharma; Vivek A.,24,0,24,0
1739702714913,PHYS 2BL,A06,831150,Sharma; Vivek A.,17,0,24,7
1739702714913,PHYS 2BL,A07,831327,Sharma; Vivek A.,21,0,24,3
1739702714913,PHYS 2BL,A08,831329,Sharma; Vivek A.,23,0,24,1
1739702714913,PHYS 2BL,A09,831338,Sharma; Vivek A.,24,0,24,0
1739702714913,PHYS 2BL,A10,831345,Sharma; Vivek A.,23,0,24,1
1739702714913,PHYS 2BL,A11,831355,Sharma; Vivek A.,21,0,24,3
1739702714913,PHYS 2BL,A12,831357,Sharma; Vivek A.,24,0,24,0
1739702714913,PHYS 2BL,A13,831428,Sharma; Vivek A.,24,0,24,0
1739702714913,PHYS 2BL,A14,831433,Sharma; Vivek A.,21,0,24,3
1739702714913,PHYS 2BL,A15,831434,Sharma; Vivek A.,21,0,24,3
1739702715941,PHYS 2C,A01,831436,Shotwell; Brian,29,0,30,1
1739702715941,PHYS 2C,A02,831440,Shotwell; Brian,30,0,30,0
1739702715941,PHYS 2C,A03,831441,Shotwell; Brian,27,0,30,3
1739702715941,PHYS 2C,A04,831444,Shotwell; Brian,29,0,30,1
1739702715941,PHYS 2C,A05,831445,Shotwell; Brian,27,0,30,3
1739702715941,PHYS 2C,A06,831446,Shotwell; Brian,30,0,30,0
1739702715941,PHYS 2C,A07,831453,Shotwell; Brian,28,0,30,2
1739702715941,PHYS 2C,A08,831454,Shotwell; Brian,29,0,30,1
1739702715941,PHYS 2C,A09,831469,Shotwell; Brian,25,0,30,5
1739702715941,PHYS 2C,A10,831470,Shotwell; Brian,27,0,30,3
1739702715941,PHYS 2C,A11,831471,Shotwell; Brian,30,0,30,0
1739702715941,PHYS 2C,A12,831481,Shotwell; Brian,27,0,30,3
1739702716967,PHYS 2CL,A01,831597,Ni; Kaixuan,25,0,28,3
1739702716967,PHYS 2CL,A02,831598,Ni; Kaixuan,23,0,28,5
1739702716967,PHYS 2CL,A03,831599,Ni; Kaixuan,27,0,28,1
1739702716967,PHYS 2CL,A04,831601,Ni; Kaixuan,26,0,28,2
1739702716967,PHYS 2CL,A05,831602,Ni; Kaixuan,26,0,28,2
1739702716967,PHYS 2CL,A06,831603,Ni; Kaixuan,26,0,28,2
1739702717992,PHYS 2D,A01,831605,Branson; James G,26,0,30,4
1739702717992,PHYS 2D,A02,831606,Branson; James G,30,0,30,0
1739702717992,PHYS 2D,A03,831607,Branson; James G,30,0,30,0
1739702719021,PHYS 4B,A01,831609,Grinstein; Benjamin,30,0,30,0
1739702719021,PHYS 4B,A02,831610,Grinstein; Benjamin,29,0,30,1
1739702719021,PHYS 4B,A03,831611,Grinstein; Benjamin,29,0,30,1
1739702719021,PHYS 4B,A04,831612,Grinstein; Benjamin,28,0,30,2
1739702720047,PHYS 4E,A01,831622,Intriligator; Kenneth Arthur,39,0,40,1
1739702720047,PHYS 4E,A02,831630,Intriligator; Kenneth Arthur,40,0,40,0
1739702720047,PHYS 4E,A03,831631,Intriligator; Kenneth Arthur,39,0,40,1
1739702721076,PHYS 87,A00,869095,Grinstein; Benjamin,20,0,20,0
1739702722102,PHYS 100C,A01,831698,Barreiro Guerrero; Julio,57,0,60,3
1739702723130,PHYS 105B,A01,831700,Green; Daniel Richard,24,0,24,0
1739702724155,PHYS 120,A01,831702,Yang; Liang,31,0,32,1
1739702724155,PHYS 120,A02,831916,Yang; Liang,30,0,32,2
1739702725180,PHYS 130A,A01,831918,You; Yizhuang,90,0,90,0
1739702726208,PHYS 130B,A01,831921,You; Yizhuang,49,0,50,1
1739702727236,PHYS 137,A01,831924,Intriligator; Kenneth Arthur,33,0,36,3
1739702728265,PHYS 140A,A01,831928,Frano Pereira; Alex M,45,0,50,5
1739702729292,PHYS 141,A00,831929,Zhao; Hongbo,57,0,60,3
1739702730320,PHYS 152B,A01,831932,Hirsch; Jorge Eduardo,17,0,20,3
1739702731344,PHYS 154,A01,872509,Grinstein; Benjamin,21,0,23,2
1739702732369,PHYS 162,A01,831935,Keating; Brian,43,0,46,3
1739702733394,PHYS 170,A01,831938,Oh; Seungeun,23,0,25,2
1739702734419,PHYS 177,A00,831940,Dudko; Olga,18,0,20,2
1739702735447,PHYS 202,A00,831941,Vergassola; Massimo & Diamond; Patrick H,19,0,20,1
1739702736472,PHYS 203B,A01,831943,Fogler; Michael M.,17,0,20,3
1739702737495,PHYS 210A,A01,831946,Arovas; Daniel P,19,0,20,1
1739702738523,PHYS 212C,A01,831948,Grover; Tarun,18,0,20,2
1739702739548,PHYS 215C,A00,831949,McGreevy; John A.,10,0,10,0
1739702740576,PHYS 221A,A00,831953,Tan; Tzer Han,20,0,20,0
1739702741601,PHYS 222A,A00,831954,Ni; Kaixuan,10,0,10,0
1739702742629,PHYS 227,A00,831958,Fuller; George Michael,22,0,25,3
1739702743653,PHYS 228,A00,831961,Flauger; Raphael M,24,0,25,1
1739702744682,PHYS 232,A00,831962,Hirsch; Jorge Eduardo,5,0,5,0
1739702745706,PHYS 239,A00,831963,Goldenfeld; Nigel,7,0,10,3
1739702745706,PHYS 239,B00,831964,Serra; Mattia,8,0,10,2
1739702746733,PHYS 241,A00,831965,Zhao; Hongbo,4,0,5,1
1739702747760,PHYS 250,A00,831969,Di Ventra; Massimiliano,50,0,50,0
1739702748785,PHYS 251,A00,831970,Grinstein; Benjamin,20,0,20,0
1739702749812,PHYS 252,A00,831971,Diamond; Patrick H,10,0,10,0
1739702750840,PHYS 253,A00,831972,Fuller; George Michael,30,0,30,0
1739702751865,PHYS 254,A00,831973,Serra; Mattia,29,0,30,1
1739702752892,PHYS 255,A00,831974,Hwa; Terence T.,30,0,30,0
1739702753918,PHYS 260,A00,831975,Fuller; George Michael,50,0,50,0
1739702754944,PHYS 277,A00,831976,Dudko; Olga,14,0,20,6
1739702755971,POLI 5D,A01,832046,Arnold; David Hall,7,0,8,1
1739702755971,POLI 5D,A02,832047,Arnold; David Hall,8,0,8,0
1739702755971,POLI 5D,A03,832049,Arnold; David Hall,8,0,8,0
1739702755971,POLI 5D,A04,832050,Arnold; David Hall,7,0,8,1
1739702755971,POLI 5D,A05,832051,Arnold; David Hall,8,0,8,0
1739702755971,POLI 5D,B01,832055,Dai; Yinlin,5,0,5,0
1739702755971,POLI 5D,B02,832056,Dai; Yinlin,4,0,5,1
1739702756997,POLI 10D,A01,832058,Noble; Benjamin S,33,0,34,1
1739702756997,POLI 10D,A02,832059,Noble; Benjamin S,33,0,34,1
1739702756997,POLI 10D,A03,832060,Noble; Benjamin S,34,0,34,0
1739702756997,POLI 10D,A04,832061,Noble; Benjamin S,33,0,34,1
1739702756997,POLI 10D,A05,832062,Noble; Benjamin S,33,0,34,1
1739702756997,POLI 10D,A06,832064,Noble; Benjamin S,34,0,34,0
1739702758025,POLI 12D,A01,832067,Thai; Eric,30,0,34,4
1739702758025,POLI 12D,A02,832068,Thai; Eric,32,0,34,2
1739702758025,POLI 12D,A03,832069,Thai; Eric,34,0,34,0
1739702758025,POLI 12D,A04,832070,Thai; Eric,34,0,34,0
1739702758025,POLI 12D,A05,832072,Thai; Eric,33,0,34,1
1739702758025,POLI 12D,A06,832074,Thai; Eric,34,0,34,0
1739702759050,POLI 27,A01,832079,Elgin; Samuel Zincke,27,0,34,7
1739702759050,POLI 27,A02,832081,Elgin; Samuel Zincke,31,0,34,3
1739702759050,POLI 27,A03,832082,Elgin; Samuel Zincke,34,0,34,0
1739702759050,POLI 27,A04,832083,Elgin; Samuel Zincke,32,0,34,2
1739702760080,POLI 28,A01,832085,Elgin; Samuel Zincke,29,0,34,5
1739702760080,POLI 28,A02,832087,Elgin; Samuel Zincke,30,0,34,4
1739702760080,POLI 28,A03,832092,Elgin; Samuel Zincke,32,0,34,2
1739702760080,POLI 28,A04,832093,Elgin; Samuel Zincke,33,0,34,1
1739702761108,POLI 30D,A01,832096,Anderson; Anthony Michael,19,0,28,9
1739702761108,POLI 30D,A02,832098,Anderson; Anthony Michael,23,0,28,5
1739702761108,POLI 30D,A03,832100,Anderson; Anthony Michael,27,0,28,1
1739702761108,POLI 30D,A04,832102,Anderson; Anthony Michael,27,0,28,1
1739702761108,POLI 30D,A05,832103,Anderson; Anthony Michael,20,0,28,8
1739702761108,POLI 30D,A06,832252,Anderson; Anthony Michael,28,0,28,0
1739702762135,POLI 87,A00,881663,Mignozzetti; Umberto,20,0,20,0
1739702763161,POLI 100O,A00,832254,Boehmer; Alison Paige,106,0,115,9
1739702764188,POLI 104Q,A00,832257,Nichter; Maysa,100,0,120,20
1739702765213,POLI 104U,A00,869584,Nichter; Maysa,56,0,75,19
1739702766238,POLI 104V,A00,832258,Staff,43,0,50,7
1739702767263,POLI 110C,A00,832259,Soon; Valerie,49,0,50,1
1739702768291,POLI 119A,A00,832260,Staff,45,0,50,5
1739702769314,POLI 120D,A00,832261,Hansen; Jan Eric,45,0,50,5
1739702770343,POLI 121D,A00,832262,Roberts; Margaret Earling,113,0,115,2
1739702771369,POLI 126AB,A00,832263,Fisk; David Lee,154,0,156,2
1739702772395,POLI 131CR,A00,832264,Hoston; Germaine,131,0,135,4
1739702772395,POLI 131CR,B00,877489,Hoston; Germaine,30,0,30,0
1739702773420,POLI 140D,A00,832265,Wong; Tak Kei,191,0,200,9
1739702774444,POLI 145C,A00,832267,Fisk; David Lee,191,0,196,5
1739702775470,POLI 149,A00,832268,Joseph; Michael F,192,0,196,4
1739702776498,POLI 150A,A00,832269,Wong; Tak Kei,235,0,245,10
1739702777523,POLI 170,A00,872371,Staff,110,0,115,5
1739702778551,POLI 176,A00,832337,Roberts; Margaret Earling,73,0,80,7
1739702779577,POLI 194,A00,832339,Staff,9999,0,9999,0
1739702780603,POLI 194SD,A00,832431,Nichter; Maysa,25,0,25,0
1739702781628,POLI 197SD,001,832432,Nichter; Maysa,25,0,25,0
1739702782655,POLI 198RA,001,832499,Broz; James Lawrence,25,0,25,0
1739702783679,POLI 203B,A00,832500,Slantchev; Branislav,23,0,25,2
1739702784702,POLI 218R,A00,832535,Hoston; Germaine,24,0,25,1
1739702785732,POLI 219,A00,832536,Soon; Valerie,10,0,10,0
1739702786756,POLI 220A,A00,832537,Ferree; Karen E,21,0,25,4
1739702787780,POLI 243,A00,832538,Joseph; Michael F,24,0,25,1
1739702788860,POLI 250,A00,832539,Stout; Christopher Timothy,22,0,25,3
1739702790910,POLI 273,A00,832541,Mignozzetti; Umberto,8,0,25,17
1739702791937,POLI 281,A00,832542,Ban; Pamela M,11,0,12,1
1739702792962,POLI 282,A00,832543,Ferree; Karen E,24,0,25,1
1739702793986,POLI 283,A00,832544,Slantchev; Branislav,23,0,25,2
1739702795010,POLI 285,A00,832545,Ingham; Sean,12,0,12,0
1739702796034,POLI 286,A00,832546,Mignozzetti; Umberto,25,0,25,0
1739702797060,PSY 296,001,867611,Eyler; Lisa T.,4,0,5,1
1739702797060,PSY 296,002,867612,Fettes; Danielle Lynn,4,0,5,1
1739702797060,PSY 296,003,867613,Staff,5,0,5,0
1739702798084,PSYC 1,A00,841780,Hurwitz; Ethan Scott,292,0,300,8
1739702799111,PSYC 3R,A00,841782,Pilegard; Celeste Cristine,297,0,310,13
1739702800141,PSYC 60,A01,862444,Lowe; Angela Beth,34,0,35,1
1739702800141,PSYC 60,A02,862476,Lowe; Angela Beth,33,0,35,2
1739702800141,PSYC 60,A03,862477,Lowe; Angela Beth,34,0,35,1
1739702800141,PSYC 60,A04,862499,Lowe; Angela Beth,32,0,35,3
1739702800141,PSYC 60,A05,862516,Lowe; Angela Beth,35,0,35,0
1739702800141,PSYC 60,A06,862578,Lowe; Angela Beth,34,0,35,1
1739702800141,PSYC 60,A07,862603,Lowe; Angela Beth,34,0,35,1
1739702800141,PSYC 60,B01,862605,Rose; Fred E.,32,0,35,3
1739702800141,PSYC 60,B02,862622,Rose; Fred E.,34,0,35,1
1739702800141,PSYC 60,B03,862658,Rose; Fred E.,33,0,35,2
1739702800141,PSYC 60,B04,862659,Rose; Fred E.,32,0,35,3
1739702800141,PSYC 60,B05,862669,Rose; Fred E.,35,0,35,0
1739702800141,PSYC 60,B06,862680,Rose; Fred E.,33,0,35,2
1739702800141,PSYC 60,B07,862682,Rose; Fred E.,34,0,35,1
1739702801166,PSYC 70,A01,862683,Pilegard; Celeste Cristine,29,0,35,6
1739702801166,PSYC 70,A02,862684,Pilegard; Celeste Cristine,33,0,35,2
1739702801166,PSYC 70,A03,862688,Pilegard; Celeste Cristine,35,0,35,0
1739702801166,PSYC 70,A04,862697,Pilegard; Celeste Cristine,35,0,35,0
1739702801166,PSYC 70,A05,862698,Pilegard; Celeste Cristine,35,0,35,0
1739702801166,PSYC 70,A06,862738,Pilegard; Celeste Cristine,35,0,35,0
1739702802195,PSYC 71,A01,841792,Geller; Emma Harlan,21,0,25,4
1739702802195,PSYC 71,A02,841793,Geller; Emma Harlan,25,0,26,1
1739702802195,PSYC 71,B01,841795,Steiner; Eric Tomas,16,0,21,5
1739702802195,PSYC 71,B02,841797,Steiner; Eric Tomas,20,0,21,1
1739702803222,PSYC 88,A00,841802,Dobkins; Karen R.,52,0,65,13
1739702804252,PSYC 100,A00,841803,Chapman; Eddie Nathaniel,299,0,348,49
1739702805278,PSYC 101,A00,841804,Schachner; Adena,264,0,295,31
1739702806304,PSYC 102,A00,841807,Moranton; Nirelia Melbina-,294,0,295,1
1739702807332,PSYC 104,A00,841810,McCullough; Michael E,193,0,265,72
1739702808358,PSYC 105,A00,841812,Lau; Aubrey,294,0,295,1
1739702809383,PSYC 108,A00,841813,Adrian; Julia Anna,291,0,295,4
1739702810408,PSYC 111B,A01,841865,Geller; Emma Harlan,35,0,35,0
1739702811437,PSYC 116C,A01,841922,Lang; Ariel,25,0,25,0
1739702812462,PSYC 117,A01,872925,Bajic; Daniel Andrew,25,0,25,0
1739702813488,PSYC 118,A01,841931,Miller; Cory T.,39,0,45,6
1739702814515,PSYC 124,A00,841932,Chapman; Eddie Nathaniel,336,0,348,12
1739702815540,PSYC 125,A00,841933,Rose; Fred E.,140,0,146,6
1739702816568,PSYC 127,A00,841934,Dickenson; Janna Alene,17,0,20,3
1739702817594,PSYC 131,A00,841936,Anagnostaras; Stephan,47,0,65,18
1739702818618,PSYC 132,A00,841937,Steiner; Eric Tomas,90,0,120,30
1739702819646,PSYC 137,A00,841939,Winkielman; Piotr,212,0,216,4
1739702820674,PSYC 144,A00,841941,Wixted; John T,293,0,295,2
1739702821699,PSYC 164,A00,841943,Kaplan; Paul,276,0,295,19
1739702822726,PSYC 169,A00,841944,Tallman; Catherine Walsh,271,0,295,24
1739702823752,PSYC 178,A00,841945,Glaser; Dale,132,0,146,14
1739702824776,PSYC 179,A00,841980,Lacefield; Katharine I,290,0,350,60
1739702825800,PSYC 188,A00,842062,Lacefield; Katharine I,233,0,300,67
1739702826824,PSYC 190,A00,842063,Barner; David A.,274,0,300,26
1739702827858,PSYC 193,A00,842067,Brashier; Nadia Marie,214,0,216,2
1739702827858,PSYC 193,B00,842068,Gremel; Christina M,33,0,35,2
1739702827858,PSYC 193,C00,842095,Harris; Christine Renee,20,0,20,0
1739702827858,PSYC 193,D00,842096,Lin; Chujun,59,0,60,1
1739702827858,PSYC 193,E00,842154,Long; Bria,24,0,25,1
1739702827858,PSYC 193,F00,872477,Mukku; Dhananjaya,35,0,35,0
1739702828884,PSYC 193L,A01,842159,Aron; Adam,18,0,21,3
1739702828884,PSYC 193L,B01,842163,Barner; David A.,22,0,24,2
1739702828884,PSYC 193L,C01,842167,Brown; Sandra A,65,0,65,0
1739702829912,PSYC 194C,A01,842196,Heyman; Gail D.,1,0,1,0
1739702830936,PSYC 210,A00,842202,Powell; Lindsey Jane,17,0,20,3
1739702831964,PSYC 222,A00,842339,Gorman; Michael R.,20,0,20,0
1739702832989,PSYC 224,A00,842402,Miller; Cory T.,29,0,30,1
1739702834013,PSYC 242,A00,842579,Walker; Caren Michelle,28,0,30,2
1739702835041,PSYC 270C,A00,842580,Dobkins; Karen R.,19,0,20,1
1739702836066,PSYC 271,A00,842581,Anagnostaras; Stephan,19,0,20,1
1739702837091,PSYC 272,A00,842582,Gentner; Tim,18,0,20,2
1739702837091,PSYC 272,B00,872469,Mukku; Dhananjaya,20,0,20,0
1739702838115,PSYC 274,A00,842583,McCullough; Michael E,30,0,30,0
1739702839142,PSYC 275,A00,842600,Brady; Timothy Francis,29,0,30,1
1739702840168,PSYC 276,A00,842601,McCullough; Michael E,15,0,20,5
1739702841192,PSYC 280,A00,842760,Serences; John Thomas,76,0,80,4
1739702842221,PSYC 296,001,851620,Anagnostaras; Stephan,9999,0,9999,0
1739702842221,PSYC 296,002,851621,Aron; Adam,9999,0,9999,0
1739702842221,PSYC 296,003,851622,Mukku; Dhananjaya,9999,0,9999,0
1739702842221,PSYC 296,004,851623,Barner; David A.,9998,0,9999,1
1739702842221,PSYC 296,005,851624,Schachner; Adena,9999,0,9999,0
1739702842221,PSYC 296,006,851625,Brady; Timothy Francis,9999,0,9999,0
1739702842221,PSYC 296,007,851627,Brashier; Nadia Marie,9999,0,9999,0
1739702842221,PSYC 296,008,851628,Brown; Sandra A,9999,0,9999,0
1739702842221,PSYC 296,009,851629,Carver; Leslie J.,9999,0,9999,0
1739702842221,PSYC 296,010,851630,Chapman; Eddie Nathaniel,9999,0,9999,0
1739702842221,PSYC 296,011,851631,Dickenson; Janna Alene,9999,0,9999,0
1739702842221,PSYC 296,012,851632,Dobkins; Karen R.,9999,0,9999,0
1739702842221,PSYC 296,014,851635,Ferreira; Victor,9999,0,9999,0
1739702842221,PSYC 296,015,851636,Geller; Emma Harlan,9999,0,9999,0
1739702842221,PSYC 296,016,851637,Gentner; Tim,9998,0,9999,1
1739702842221,PSYC 296,017,851642,Gorman; Michael R.,9999,0,9999,0
1739702842221,PSYC 296,018,851644,Gremel; Christina M,9999,0,9999,0
1739702842221,PSYC 296,019,851645,Harris; Christine Renee,9999,0,9999,0
1739702842221,PSYC 296,020,851646,Heyman; Gail D.,9999,0,9999,0
1739702842221,PSYC 296,021,851647,Lin; Chujun,9999,0,9999,0
1739702842221,PSYC 296,022,851648,Long; Bria,9999,0,9999,0
1739702842221,PSYC 296,023,851650,McCullough; Michael E,9999,0,9999,0
1739702842221,PSYC 296,024,851655,Mc Kenzie; Craig R.M.,9999,0,9999,0
1739702842221,PSYC 296,025,851656,Miller; Cory T.,9999,0,9999,0
1739702842221,PSYC 296,026,851657,Oesch; Nicholas W,9999,0,9999,0
1739702842221,PSYC 296,028,851662,Pilegard; Celeste Cristine,9999,0,9999,0
1739702842221,PSYC 296,029,851664,Powell; Lindsey Jane,9999,0,9999,0
1739702842221,PSYC 296,030,851665,Rickard; Timothy C.,9999,0,9999,0
1739702842221,PSYC 296,031,851672,Serences; John Thomas,9999,0,9999,0
1739702842221,PSYC 296,032,851774,Walker; Caren Michelle,9999,0,9999,0
1739702842221,PSYC 296,033,851778,Winkielman; Piotr,9999,0,9999,0
1739702842221,PSYC 296,034,851808,Wixted; John T,9999,0,9999,0
1739702843249,RAD 296,001,867654,Staff,5,0,5,0
1739702843249,RAD 296,002,867659,Staff,5,0,5,0
1739702843249,RAD 296,003,867666,Staff,5,0,5,0
1739702844277,RELI 150,A00,832548,Rahimi; Babak,37,0,40,3
1739702845302,RELI 189,A00,832549,Rahimi; Babak,40,0,40,0
1739702846327,REV 12,A00,869164,Yu; Paul K L,40,0,40,0
1739702847351,REV 20,A00,869165,Yu; Paul K L,40,0,40,0
1739702848380,REV 87,A00,869166,Rodriguez; Bretton Sigfred,19,0,20,1
1739702849407,RMAS 296,001,867895,Murphy; James D,5,0,5,0
1739702849407,RMAS 296,002,867896,Staff,5,0,5,0
1739702849407,RMAS 296,003,867897,Staff,5,0,5,0
1739702850432,RMED 296,001,867854,Duleba; Antoni,4,0,5,1
1739702850432,RMED 296,002,867860,Staff,5,0,5,0
1739702850432,RMED 296,003,867882,Staff,5,0,5,0
1739702851459,SE 3,A01,838151,Van Den Einde; Yael Dahlia,42,0,52,10
1739702851459,SE 3,A02,838152,Van Den Einde; Yael Dahlia,50,0,52,2
1739702851459,SE 3,A03,838153,Van Den Einde; Yael Dahlia,50,0,53,3
1739702851459,SE 3,A04,838154,Van Den Einde; Yael Dahlia,51,0,53,2
1739702851459,SE 3,A05,838155,Van Den Einde; Yael Dahlia,49,0,50,1
1739702852484,SE 101B,A01,838160,Van Den Einde; Yael Dahlia,53,0,56,3
1739702853519,SE 105,A01,838162,Qiao; Yu,85,0,88,3
1739702854544,SE 110A,A01,838164,Staff,53,0,56,3
1739702855574,SE 110B,A00,838166,Zhu; Qiang,123,0,125,2
1739702856602,SE 130B,A01,838174,Krysl; Petr,93,0,100,7
1739702857628,SE 131A,A01,838499,Krysl; Petr,103,0,110,7
1739702858654,SE 140B,A01,838504,Palermo; Alessandro,22,0,24,2
1739702858654,SE 140B,A02,838505,Palermo; Alessandro,21,0,24,3
1739702858654,SE 140B,A03,838507,Palermo; Alessandro,23,0,24,1
1739702858654,SE 140B,A04,871139,Palermo; Alessandro,13,0,24,11
1739702858654,SE 140B,A05,871140,Palermo; Alessandro,0,0,24,24
1739702858654,SE 140B,A06,871141,Palermo; Alessandro,23,0,24,1
1739702859682,SE 143B,A01,838512,Kosmatka; John B,4,0,15,11
1739702859682,SE 143B,A02,838513,Kosmatka; John B,9,0,15,6
1739702860711,SE 150A,A01,838526,Uang; Chia-Ming,94,0,100,6
1739702861737,SE 150B,A01,838538,Morrison; Machel Leigh,36,0,50,14
1739702862766,SE 151B,A00,838540,Tsampras; Georgios,62,0,75,13
1739702863794,SE 160B,A01,838543,Kim; Hyunsun Alicia,96,0,100,4
1739702864819,SE 165,A00,838544,Todd; Michael,0,0,10,10
1739702865845,SE 183,A00,872450,Tomac; Ingrid,0,0,0,3
1739702866870,SE 202,A00,838832,Kosmatka; John B,28,0,30,2
1739702867898,SE 203B,A00,838855,Tsampras; Georgios,49,0,65,16
1739702868926,SE 213,A00,838859,Palermo; Alessandro,21,0,30,9
1739702869955,SE 214,A00,870032,Shing; P. Benson,19,0,40,21
1739702870982,SE 215,A00,838876,Zhu; Qiang,34,0,45,11
1739702872009,SE 224,A00,838921,Conte; Joel P,36,0,50,14
1739702873037,SE 246,A00,838926,McCartney; John Scott,25,0,30,5
1739702874062,SE 249,A01,839605,Tomac; Ingrid,15,0,20,5
1739702875087,SE 251B,A00,838934,Qiao; Yu,17,0,25,8
1739702876111,SE 253B,A00,838942,Kim; Hyonny,30,0,30,0
1739702877139,SE 260B,A00,838947,Kim; Hyunsun Alicia,10,0,10,0
1739702878164,SE 265,A00,838954,Todd; Michael,10,0,20,10
1739702879189,SE 279,A00,838959,Chen; Jiun-Shyan,24,0,30,6
1739702880213,SE 290,A00,838962,Loh; Kenneth J. H.,74,0,100,26
1739702881246,SE 296,001,838963,Asaro; Robert J,9999,0,9999,0
1739702881246,SE 296,002,838980,Chen; Jiun-Shyan,9999,0,9999,0
1739702881246,SE 296,003,838992,Conte; Joel P,9999,0,9999,0
1739702881246,SE 296,004,839039,Elgamal; Ahmed,9999,0,9999,0
1739702881246,SE 296,005,839040,Hutchinson; Tara,9999,0,9999,0
1739702881246,SE 296,006,839041,Jandaghi Semnani; Shabnam,9999,0,9999,0
1739702881246,SE 296,007,839042,Kim; Hyonny,9999,0,9999,0
1739702881246,SE 296,008,839055,Kim; Hyunsun Alicia,9999,0,9999,0
1739702881246,SE 296,009,839059,Kosmatka; John B,9999,0,9999,0
1739702881246,SE 296,010,839087,Krysl; Petr,9999,0,9999,0
1739702881246,SE 296,011,839094,Kuester; Falko,9999,0,9999,0
1739702881246,SE 296,012,839115,Lanza Di Scalea; Francesco,9999,0,9999,0
1739702881246,SE 296,013,839173,Loh; Kenneth J. H.,9999,0,9999,0
1739702881246,SE 296,014,839174,McCartney; John Scott,9999,0,9999,0
1739702881246,SE 296,015,839198,Morrison; Machel Leigh,9999,0,9999,0
1739702881246,SE 296,016,839229,Mosqueda; Gilberto,9999,0,9999,0
1739702881246,SE 296,017,839230,Qiao; Yu,9999,0,9999,0
1739702881246,SE 296,018,839234,Restrepo; Jose,9999,0,9999,0
1739702881246,SE 296,019,839243,Shing; P. Benson,9999,0,9999,0
1739702881246,SE 296,020,839323,Todd; Michael,9999,0,9999,0
1739702881246,SE 296,021,839326,Tomac; Ingrid,9999,0,9999,0
1739702881246,SE 296,022,839327,Tsampras; Georgios,9999,0,9999,0
1739702881246,SE 296,023,839329,Uang; Chia-Ming,9999,0,9999,0
1739702881246,SE 296,024,839340,Van Den Einde; Yael Dahlia,9999,0,9999,0
1739702881246,SE 296,025,839342,Zhu; Qiang,9999,0,9999,0
1739702881246,SE 296,026,839351,Tehrani; Mehran,9999,0,9999,0
1739702881246,SE 296,027,839356,Palermo; Alessandro,9999,0,9999,0
1739702882272,SEV 20,A00,838033,Antonovics; Kate L.,30,0,30,0
1739702883297,SIO 10,A00,839607,Borsa; Adrian Antal,591,0,600,9
1739702884322,SIO 16,A00,839615,Stegman; David,146,0,150,4
1739702885347,SIO 35,A00,839616,Driscoll; Neal W.,189,0,210,21
1739702886372,SIO 50,A01,839691,Cook; Geoffrey W,20,0,22,2
1739702886372,SIO 50,A02,839692,Cook; Geoffrey W,20,0,22,2
1739702887401,SIO 60,A01,839695,Ricke; Katharine L & Lucas; Andrew J.,29,0,34,5
1739702888425,SIO 75,A00,839696,Norris; Richard D.,28,0,30,2
1739702889451,SIO 87,A00,839697,Cook; Geoffrey W,20,0,20,0
1739702889451,SIO 87,B00,839698,Cook; Geoffrey W,20,0,20,0
1739702889451,SIO 87,C00,872480,Feddersen; Falk & Morzfeld; Matthias,15,0,15,0
1739702889451,SIO 87,D00,876215,Jensen; Paul R.,19,0,20,1
1739702890475,SIO 90,A00,839699,Shipp; Lauren Elizabeth,60,0,65,5
1739702891500,SIO 111,A01,839895,Feddersen; Falk,27,0,30,3
1739702892579,SIO 112,A01,839701,Morzfeld; Matthias,38,0,40,2
1739702893604,SIO 113,A01,839703,May; David Alexander,33,0,40,7
1739702894633,SIO 115,A01,872479,Fricker; Helen A.,61,0,65,4
1739702895661,SIO 121,A00,839704,Bowman; Jeff Shovlowsky,25,0,30,5
1739702896686,SIO 135,A01,839706,Fricker; Helen A. & Sandwell; David T,20,0,20,0
1739702896686,SIO 135,A02,872452,Fricker; Helen A. & Sandwell; David T,20,0,20,0
1739702897712,SIO 136,A01,839708,Kacev; David & Shipp; Lauren Elizabeth,29,0,34,5
1739702897712,SIO 136,A02,839709,Kacev; David & Shipp; Lauren Elizabeth,32,0,34,2
1739702898739,SIO 139,A00,839713,Kacev; David,89,0,95,6
1739702899763,SIO 141,A01,839715,Pomeroy; Robert S.,14,0,14,0
1739702900789,SIO 143,A01,839717,Andersson; Andreas Jerry,31,0,35,4
1739702901832,SIO 145,A01,872421,Choy; Carolyn Anela,9,0,18,9
1739702902857,SIO 152,A01,839719,Van Allen; Emily Joyce,17,0,20,3
1739702903887,SIO 153,A01,839722,Capaldi; Tomas,29,0,30,1
1739702904913,SIO 160,A00,839723,Fialko; Yuri A.,26,0,30,4
1739702905938,SIO 173,A00,839724,Xie; Shang-Ping,26,0,30,4
1739702906967,SIO 174,A00,839725,Aluwihare; Lihini & Russell; Lynn M.,26,0,30,4
1739702907994,SIO 176,A00,839726,Merrifield; Sophia T,27,0,30,3
1739702909019,SIO 181,A01,839728,Tresguerres; Martin,20,0,25,5
1739702909019,SIO 181,A02,839729,Tresguerres; Martin,23,0,25,2
1739702909019,SIO 181,A03,839730,Tresguerres; Martin,25,0,25,0
1739702909019,SIO 181,A04,839731,Tresguerres; Martin,23,0,25,2
1739702909019,SIO 181,A05,839732,Tresguerres; Martin,25,0,25,0
1739702909019,SIO 181,A06,839733,Tresguerres; Martin,24,0,25,1
1739702910045,SIO 184,A01,839735,Rouse; Gregory W.,17,0,24,7
1739702910045,SIO 184,A02,839736,Rouse; Gregory W.,20,0,24,4
1739702911070,SIO 190,A01,839738,Lin; Ying-Tsong,18,0,20,2
1739702911070,SIO 190,B01,839740,Kacev; David,26,0,30,4
1739702911070,SIO 190,D01,839742,Gaasterland; Theresa,20,0,20,0
1739702912098,SIO 190L,A00,886144,Staff,28,0,30,2
1739702912098,SIO 190L,A01,886145,Staff,30,0,30,0
1739702913123,SIO 194,A00,851602,Staff,0,0,0,0
1739702914149,SIOB 242C,A01,839746,Gaasterland; Theresa,25,0,25,0
1739702915178,SIOB 243,A00,839748,Gerwick; William Henry,17,0,20,3
1739702916206,SIOB 262,A00,839749,Gerwick; William Henry,25,0,25,0
1739702917232,SIOB 270A,A01,839751,Petrik; Colleen Mary,11,0,15,4
1739702918260,SIOB 278,A00,839752,Jensen; Paul R.,13,0,15,2
1739702918260,SIOB 278,B00,872373,Hechinger; Ryan F.,11,0,15,4
1739702918260,SIOB 278,C00,874430,Allen; Andrew Ellis,13,0,15,2
1739702919287,SIOB 279,A00,871153,Barton; Andrew David,43,0,50,7
1739702920313,SIOB 282,A00,839753,Palenik; Brian,18,0,20,2
1739702921340,SIOB 284,A01,839755,Rouse; Gregory W.,1,0,3,2
1739702921340,SIOB 284,A02,839756,Rouse; Gregory W.,2,0,3,1
1739702922368,SIOB 286,A01,839758,Aburto Oropeza; Marco Octavio,20,0,25,5
1739702923396,SIOB 291,A00,839759,Staff,0,0,0,0
1739702924422,SIOB 297,A00,839760,Allen; Eric,19,0,25,6
1739702925448,SIOC 202B,A00,839761,Stramski; Dariusz & Gabriel; Anne Alice-Agnes,16,0,20,4
1739702926473,SIOC 203C,A01,839763,Young; William Roy,18,0,20,2
1739702927498,SIOC 207C,A00,872521,Vasconcelos; Manuela,5,0,5,0
1739702928527,SIOC 208,A00,839764,Lucas; Andrew J.,45,0,50,5
1739702929555,SIOC 209,A00,872379,Werner; Bradley T.,10,0,10,0
1739702929555,SIOC 209,B00,874420,Watson-Parris; Duncan & Hao; Xuanting,17,0,20,3
1739702930580,SIOC 211B,A00,839779,Feddersen; Falk,5,0,8,3
1739702931609,SIOC 212B,A01,839861,Cessi; Paola,11,0,15,4
1739702932637,SIOC 217C,A00,839862,Lutsko; Nicholas J.,23,0,25,2
1739702933662,SIOC 218A,A00,839863,Send; Uwe,3,0,10,7
1739702934687,SIOC 228,A00,839865,Shi; Yuanyuan,1,0,10,9
1739702935713,SIOC 235,A00,839866,Xie; Shang-Ping,7,0,10,3
1739702936738,SIOC 250,A00,839871,Norris; Joel Roland,20,0,20,0
1739702937763,SIOC 296,A00,871155,Gabriel; Corey John,9,0,20,11
1739702938790,SIOG 200B,A00,839873,Gabriel; Anne Alice-Agnes,19,0,20,1
1739702939816,SIOG 224,A00,839876,Laske; Gabi & Stegman; David,20,0,20,0
1739702940842,SIOG 227C,A00,839879,Fan; Wenyuan & Gabriel; Anne Alice-Agnes,20,0,20,0
1739702941869,SIOG 228,A00,839880,Van Allen; Emily Joyce,13,0,20,7
1739702942896,SIOG 230,A00,839882,Constable; Catherine G,25,0,25,0
1739702943921,SIOG 232,A00,839885,Constable; Steven C & Constable; Catherine G,49,0,50,1
1739702944952,SIOG 236,A01,839890,Fricker; Helen A. & Sandwell; David T,5,0,5,0
1739702944952,SIOG 236,A02,872451,Fricker; Helen A. & Sandwell; David T,5,0,5,0
1739702945977,SIOG 239,A00,839891,Fan; Wenyuan,19,0,20,1
1739702947003,SIOG 268,A00,872652,Martz; Todd R.,9,0,10,1
1739702948028,SOCE 194,A00,851601,Staff,0,0,0,0
1739702949053,SOCG 204,A00,838022,Ng; Kwai,0,0,10,10
1739702950080,SOCG 206,A00,838023,Alvarez; Camila Huerta,6,0,10,4
1739702951108,SOCG 246,A00,838024,Kenworthy; Lane A.,4,0,10,6
1739702952132,SOCG 255B,A00,838025,Gere; Catherina M.,7,0,10,3
1739702953158,SOCG 255C,A00,838026,McKenzie; Kerry V.,7,0,10,3
1739702954188,SOCG 263,A00,838027,Jules-Rosette; Bennetta W.,9,0,10,1
1739702955214,SOCG 278,A00,838030,Watson; Tobias,4,0,10,6
1739702956239,SOCG 280,A00,838031,Fitzgerald; David S,4,0,10,6
1739702957262,SOCG 290,A00,838032,Goldman; Harvey Stern,7,0,10,3
1739702958291,SOCI 2,A01,837726,Payne; Christine Anna,27,0,30,3
1739702958291,SOCI 2,A02,837727,Payne; Christine Anna,30,0,30,0
1739702958291,SOCI 2,A03,837728,Payne; Christine Anna,29,0,30,1
1739702958291,SOCI 2,A04,837729,Payne; Christine Anna,29,0,30,1
1739702958291,SOCI 2,A05,837730,Payne; Christine Anna,30,0,30,0
1739702958291,SOCI 2,A06,837766,Payne; Christine Anna,0,0,0,0
1739702958291,SOCI 2,A07,837769,Payne; Christine Anna,0,0,0,0
1739702958291,SOCI 2,A08,837770,Payne; Christine Anna,0,0,0,0
1739702959317,SOCI 10,A01,869965,Kenworthy; Lane A.,27,0,30,3
1739702959317,SOCI 10,A02,869977,Kenworthy; Lane A.,28,0,30,2
1739702959317,SOCI 10,A03,869985,Kenworthy; Lane A.,30,0,30,0
1739702959317,SOCI 10,A04,869986,Kenworthy; Lane A.,28,0,30,2
1739702960342,SOCI 20,A01,837783,Calderon-Zaks; Michael Aar,35,0,35,0
1739702960342,SOCI 20,A02,837807,Calderon-Zaks; Michael Aar,34,0,35,1
1739702961369,SOCI 60,A01,837816,Sutton; April Marie,28,0,32,4
1739702961369,SOCI 60,A02,837817,Sutton; April Marie,32,0,32,0
1739702961369,SOCI 60,A03,837818,Sutton; April Marie,29,0,32,3
1739702961369,SOCI 60,A04,837819,Sutton; April Marie,31,0,32,1
1739702962399,SOCI 100,A01,837840,Medvetz; Thomas Matthew,29,0,30,1
1739702962399,SOCI 100,A02,837848,Medvetz; Thomas Matthew,30,0,30,0
1739702962399,SOCI 100,A03,837849,Medvetz; Thomas Matthew,30,0,30,0
1739702962399,SOCI 100,A04,837850,Medvetz; Thomas Matthew,28,0,30,2
1739702963426,SOCI 103M,A00,837862,Kilpatrick; Kevin,29,0,30,1
1739702964452,SOCI 104,A00,837863,Arnal; Maud Marie Leonie,28,0,30,2
1739702965477,SOCI 106,A00,837869,Payne; Christine Anna,27,0,30,3
1739702966502,SOCI 109,A00,837870,Kilpatrick; Kevin,29,0,30,1
1739702967532,SOCI 111,A00,837871,Ribas Norris; Janet Vanesa,56,0,56,0
1739702968556,SOCI 111T,A00,837872,Thorpe; Charles Robert,65,0,65,0
1739702969580,SOCI 112,A00,837885,Pitt; Richard Norris,58,0,65,7
1739702970606,SOCI 113,A00,837886,Rogers; Julia Ellen,73,0,75,2
1739702971631,SOCI 115,A00,837889,Sutton; April Marie,63,0,65,2
1739702972657,SOCI 117,A01,851612,Jones; Makeba,9,0,13,4
1739702972657,SOCI 117,A02,851613,Jones; Makeba,13,0,13,0
1739702972657,SOCI 117,A03,851614,Jones; Makeba,12,0,12,0
1739702972657,SOCI 117,A04,851616,Jones; Makeba,12,0,12,0
1739702972657,SOCI 117,B01,870980,Staff,10,0,10,0
1739702972657,SOCI 117,B02,870985,Staff,10,0,10,0
1739702972657,SOCI 117,B03,870987,Staff,10,0,10,0
1739702972657,SOCI 117,B04,871055,Staff,10,0,10,0
1739702973685,SOCI 119,A00,837925,Victoria Torres; Pablo,87,0,90,3
1739702974710,SOCI 125C,A00,872640,Watson; Tobias,55,0,56,1
1739702975735,SOCI 125M,A00,837948,Fitzgerald; David S,45,0,45,0
1739702976763,SOCI 126,A01,851618,Jones; Makeba,18,0,20,2
1739702976763,SOCI 126,A02,837966,Jones; Makeba,20,0,20,0
1739702976763,SOCI 126,A03,837969,Jones; Makeba,20,0,20,0
1739702977789,SOCI 129,A00,837973,Pitt; Richard Norris,72,0,75,3
1739702978817,SOCI 132,A00,837974,Blair-Loy; Mary,74,0,75,1
1739702979842,SOCI 133,A00,837983,Calderon-Zaks; Michael Aar,55,0,56,1
1739702980870,SOCI 134,A00,837989,Rogers; Julia Ellen,45,0,45,0
1739702981895,SOCI 135,A00,838005,Ruiz; Jonathan Joseph,54,0,56,2
1739702982921,SOCI 138,A00,838006,Ruiz; Jonathan Joseph,55,0,56,1
1739702983946,SOCI 139,A00,838007,Ribas Norris; Janet Vanesa,41,0,46,5
1739702984971,SOCI 139A,A00,838008,Estefan; Michel,52,0,56,4
1739702986000,SOCI 140A,A00,838009,Gong; Neil M,66,0,70,4
1739702987028,SOCI 140J,A00,838010,Estefan; Michel,92,0,100,8
1739702988053,SOCI 148,A00,838011,Maron; Asa,34,0,35,1
1739702989078,SOCI 150,A00,838012,Victoria Torres; Pablo,68,0,75,7
1739702990102,SOCI 151,A00,838013,Goldman; Harvey Stern,64,0,65,1
1739702991128,SOCI 156,A00,838014,Ostovany; Khashayar,40,0,40,0
1739702992153,SOCI 157,A00,838015,Crofts; Christine,45,0,56,11
1739702993179,SOCI 158,A00,838016,Ostovany; Khashayar,39,0,40,1
1739702994203,SOCI 160,A00,838017,Medvetz; Thomas Matthew,70,0,70,0
1739702995231,SOCI 161,A00,838018,Arnal; Maud Marie Leonie,49,0,50,1
1739702996313,SOCI 168,A00,838019,Thorpe; Charles Robert,40,0,40,0
1739702997341,SOCI 168E,A00,838021,Crofts; Christine,19,0,35,16
1739702998369,SOCI 174,A00,872915,Shafir; Gershon,28,0,30,2
1739702999394,SOMC 229,A00,867907,Hoang; Mai Phuong,160,0,160,0
1739703000423,SOMC 240,A00,867911,Coyne; Christopher John,160,0,160,0
1739703001448,SOMC 242,A00,867913,Kline; Ahnika Sarah,160,0,160,0
1739703002476,SOMC 244,A00,867940,Evans; Sean Jeffrey,160,0,160,0
1739703003504,SOMC 245C,A01,867952,Noel; Geoffroy Pierre Jean,160,0,160,0
1739703004529,SOMC 246C,A00,867953,Eyler; Lisa T.,160,0,160,0
1739703005558,SOMC 247C,A50,867992,Calcutt; Nigel A,160,0,160,0
1739703006582,SOMC 248C,A00,867993,Joshi; Weena Erin,160,0,160,0
1739703007610,SOMC 249,A00,867994,Bui; Jack D,160,0,160,0
1739703008634,SOMC 250,A00,867997,Reid; Erin G.,160,0,160,0
1739703009662,SOMC 255C,A00,868050,Allison; Matthew,160,0,160,0
1739703010687,SOMI 296,A00,868065,Staff,5,0,5,0
1739703011714,SPPH 161R,A01,864775,Chambers; Christina D,29,0,30,1
1739703011714,SPPH 161R,C01,886226,Chambers; Christina D,20,0,20,0
1739703012741,SPPH 263B,A01,884929,Hook; Vivian Yuan-Ho,98,0,99,1
1739703013765,SPPS 200A,A00,864810,Luli; Alex J,100,0,100,0
1739703014790,SPPS 200B,A00,864827,Luli; Alex J,99,0,99,0
1739703015815,SPPS 200C,A00,864829,Luli; Alex J,99,0,99,0
1739703016842,SPPS 203,A00,864831,Painter; Nathan A.,92,0,99,7
1739703017870,SPPS 205,A01,864838,Bandeira; Nuno Filipe Cabrita,92,0,99,7
1739703018897,SPPS 209,A00,864842,Bounthavong; Mark,93,0,99,6
1739703019922,SPPS 211A,A00,864862,Ferguson; Fleur,92,0,99,7
1739703020946,SPPS 211B,A00,864920,Ferguson; Fleur,96,0,99,3
1739703021971,SPPS 211C,A00,864924,Ferguson; Fleur,93,0,99,6
1739703022997,SPPS 211D,A00,864925,Tsunoda; Shirley M.,99,0,99,0
1739703024021,SPPS 212C,A01,864927,Saunders; Ila Maewal,93,0,99,6
1739703025048,SPPS 213C,A00,864928,Namba; Jennifer Mariko,93,0,99,6
1739703026072,SPPS 218B,A00,864929,Vijapurkar; Ulka,93,0,99,6
1739703027099,SPPS 225,A01,864932,Reed; Chantal,92,0,99,7
1739703028126,SPPS 229,A01,864934,Reid; Erin G.,96,0,99,3
1739703029150,SPPS 237,A00,864935,Mimoto; Mizuho Stacy,96,0,99,3
1739703030177,SPPS 238,A00,864937,Beyhan; Sinem,96,0,99,3
1739703031202,SPPS 239,A01,864942,Bui; Jack D,96,0,99,3
1739703032227,SPPS 241,A01,864944,Tsunoda; Shirley M.,92,0,99,7
1739703033252,SPPS 249,A00,864945,Brandl; Katharina,96,0,99,3
1739703034279,SPPS 250,A00,864946,Tsunoda; Shirley M.,97,0,99,2
1739703035304,SPPS 251,A00,864953,Chen; Timothy,20,0,20,0
1739703036329,SPPS 252,A00,865004,Abdul-Mutakabbir; Jacinda,96,0,99,3
1739703037355,SPPS 253,A00,865006,Tsunoda; Shirley M.,99,0,99,0
1739703038382,SPPS 255,A00,865010,Bounthavong; Mark,98,0,99,1
1739703039405,SPPS 261,A00,865011,Chambers; Christina D,97,0,99,2
1739703040431,SPPS 278,A00,865012,Fricovsky; Eduardo Santiago,98,0,99,1
1739703041457,SPPS 280,A00,865013,Fricovsky; Eduardo Santiago,23,0,23,0
1739703042484,SPPS 281,A00,865014,Gerwick; William Henry,95,0,99,4
1739703043509,SPPS 283,A00,865015,Tsunoda; Shirley M.,98,0,99,1
1739703044533,SURG 296,001,868067,Harris; Jeffrey Paul,4,0,5,1
1739703044533,SURG 296,002,868068,Coffey; Charles Stuart,4,0,5,1
1739703044533,SURG 296,003,868069,Malas; Mahmoud,4,0,5,1
1739703045569,SYN 1,001,836580,Rock; Martin,20,0,20,0
1739703045569,SYN 1,002,836582,Birberick; Brittany Celest,17,0,20,3
1739703045569,SYN 1,003,836583,Meyer; Leslie Rose,20,0,20,0
1739703045569,SYN 1,004,836584,Fish; Gwendolyn Anne,19,0,20,1
1739703045569,SYN 1,005,836585,Fish; Gwendolyn Anne,20,0,20,0
1739703045569,SYN 1,006,836586,Tawater; Hanna Jean,20,0,20,0
1739703045569,SYN 1,007,836590,Fish; Gwendolyn Anne,20,0,20,0
1739703045569,SYN 1,008,836591,Iatarola; Briana Marie,18,0,20,2
1739703045569,SYN 1,009,836592,Browne; Emily,20,0,20,0
1739703045569,SYN 1,010,836594,Staff,20,0,20,0
1739703045569,SYN 1,011,836595,Hom; Kirstyn Courtney,20,0,20,0
1739703045569,SYN 1,012,836599,Hom; Kirstyn Courtney,19,0,20,1
1739703045569,SYN 1,013,836600,Lagapa; Jason,20,0,20,0
1739703045569,SYN 1,014,836603,Deavenport; James Cary,18,0,20,2
1739703045569,SYN 1,015,836606,Girard; Gabrielle,19,0,20,1
1739703045569,SYN 1,016,836607,Deavenport; James Cary,20,0,20,0
1739703045569,SYN 1,017,836622,Girard; Gabrielle,20,0,20,0
1739703045569,SYN 1,018,836653,Atkinson; Arthur Laird,20,0,20,0
1739703045569,SYN 1,019,836656,Girard; Gabrielle,18,0,20,2
1739703045569,SYN 1,020,836658,Atkinson; Arthur Laird,18,0,20,2
1739703045569,SYN 1,021,836659,Staff,20,0,20,0
1739703045569,SYN 1,022,836662,Bishop; Graham,19,0,20,1
1739703045569,SYN 1,023,836663,Bishop; Graham,20,0,20,0
1739703045569,SYN 1,024,836666,Lagapa; Jason,18,0,20,2
1739703045569,SYN 1,025,836723,Lagapa; Jason,20,0,20,0
1739703045569,SYN 1,026,836728,Iatarola; Briana Marie,20,0,20,0
1739703045569,SYN 1,027,836729,Iatarola; Briana Marie,20,0,20,0
1739703045569,SYN 1,028,836730,Difruscio; Mark,20,0,20,0
1739703045569,SYN 1,029,836731,Difruscio; Mark,19,0,20,1
1739703046598,SYN 100,A01,836744,Gladstein; Jill M,12,0,15,3
1739703046598,SYN 100,A02,836745,Gladstein; Jill M,15,0,15,0
1739703046598,SYN 100,B01,836748,Rock; Martin,15,0,15,0
1739703046598,SYN 100,B02,836809,Rock; Martin,14,0,15,1
1739703046598,SYN 100,C01,836812,Browne; Emily,14,0,15,1
1739703046598,SYN 100,C02,836818,Browne; Emily,13,0,15,2
1739703046598,SYN 100,D01,836820,Meyer; Leslie Rose,10,0,15,5
1739703046598,SYN 100,D02,836822,Meyer; Leslie Rose,15,0,15,0
1739703046598,SYN 100,E01,836824,Tawater; Hanna Jean,13,0,15,2
1739703046598,SYN 100,E02,836825,Tawater; Hanna Jean,12,0,15,3
1739703046598,SYN 100,F01,836975,Meyer; Leslie Rose,15,0,15,0
1739703046598,SYN 100,F02,837038,Meyer; Leslie Rose,14,0,15,1
1739703046598,SYN 100,G01,837132,Deavenport; James Cary,13,0,15,2
1739703046598,SYN 100,G02,837133,Deavenport; James Cary,14,0,15,1
1739703046598,SYN 100,H01,837155,Gormally; Brenna,15,0,15,0
1739703046598,SYN 100,H02,872920,Gormally; Brenna,15,0,15,0
1739703046598,SYN 100,I01,837161,Gormally; Brenna,13,0,15,2
1739703046598,SYN 100,I02,837166,Gormally; Brenna,15,0,15,0
1739703046598,SYN 100,J01,837169,Difruscio; Mark,9,0,15,6
1739703046598,SYN 100,J02,837171,Difruscio; Mark,12,0,15,3
1739703046598,SYN 100,K01,837174,Rosenberg; Ryan Glenn,9,0,15,6
1739703046598,SYN 100,K02,837176,Rosenberg; Ryan Glenn,15,0,15,0
1739703046598,SYN 100,L01,837264,Rosenberg; Ryan Glenn,13,0,15,2
1739703046598,SYN 100,L02,837265,Rosenberg; Ryan Glenn,15,0,15,0
1739703046598,SYN 100,M01,837268,Hom; Kirstyn Courtney,12,0,15,3
1739703046598,SYN 100,M02,837269,Hom; Kirstyn Courtney,12,0,15,3
1739703046598,SYN 100,N01,837272,Atkinson; Arthur Laird,14,0,15,1
1739703046598,SYN 100,N02,837275,Atkinson; Arthur Laird,14,0,15,1
1739703046598,SYN 100,O01,837278,Bishop; Graham,13,0,15,2
1739703046598,SYN 100,O02,837284,Bishop; Graham,15,0,15,0
1739703047623,SYN 150,001,837627,Vega; Adrian,20,0,20,0
1739703047623,SYN 150,002,837643,Vega; Adrian,20,0,20,0
1739703048654,TDAC 1,A00,835839,Walsh; Kim C.,19,0,20,1
1739703048654,TDAC 1,B00,835840,Walsh; Kim C.,20,0,20,0
1739703048654,TDAC 1,C00,835841,Walsh; Kim C.,7,0,20,13
1739703048654,TDAC 1,D00,835843,Walsh; Kim C.,19,0,20,1
1739703048654,TDAC 1,E00,835844,Walsh; Kim C.,6,0,20,14
1739703048654,TDAC 1,F00,835845,Walsh; Kim C.,15,0,20,5
1739703049679,TDAC 101,A00,836005,Basso; Beatrice,17,0,20,3
1739703050705,TDAC 102,A00,836006,Harting; Carla Kelso,16,0,20,4
1739703051734,TDAC 105,A00,836007,Barricelli; Marc Alexander,20,0,20,0
1739703052764,TDAC 108,A00,836008,Buescher; Stephen W.,17,0,20,3
1739703052764,TDAC 108,B00,836009,Buescher; Stephen W.,16,0,20,4
1739703052764,TDAC 108,C00,836010,Walsh; Kim C.,20,0,20,0
1739703053791,TDAC 109,A00,836012,Blair; Kyle Adam,20,0,20,0
1739703054823,TDAC 122,A00,836014,Stalling; Vanessa,30,0,30,0
1739703054823,TDAC 122,B00,836015,Perry; Lamar,30,0,30,0
1739703054823,TDAC 122,C00,872388,Celik; Aysan Karagasli,30,0,30,0
1739703054823,TDAC 122,D00,874223,Caban; Andrea Chudnow,30,0,30,0
1739703054823,TDAC 122,E00,874224,Staff,30,0,30,0
1739703055848,TDDE 101,A00,836016,Guirguis; Mark C,20,0,20,0
1739703056874,TDDE 121,A01,836018,Kuhl; Christopher August,16,0,17,1
1739703057902,TDDE 130,A00,836019,Guirguis; Mark C,20,0,20,0
1739703058928,TDDE 131,A00,836020,Petrovich; Victoria A.,19,0,20,1
1739703058928,TDDE 131,B00,872473,Brill; Robert L.,100,0,100,0
1739703059953,TDDE 132,A00,836021,Guirguis; Mark C,20,0,20,0
1739703060978,TDDM 1,A00,835853,Sammartano; Tonnie,40,0,40,0
1739703062006,TDDM 100,A00,836022,Alvarez; Ana Maria,29,0,30,1
1739703063032,TDDR 102,A00,836024,Powell; Lora,19,0,20,1
1739703064057,TDDR 108,A00,836029,Stalling; Vanessa,20,0,20,0
1739703065082,TDDR 111,A00,836039,Castro; Robert Jess,15,0,16,1
1739703065082,TDDR 111,B00,836070,Castro; Robert Jess,16,0,16,0
1739703066107,TDDR 190,A00,836072,Perry; Lamar,35,0,35,0
1739703067133,TDGE 1,A01,835855,Salovey; Todd,19,0,20,1
1739703067133,TDGE 1,A02,835856,Salovey; Todd,20,0,20,0
1739703067133,TDGE 1,A03,835857,Salovey; Todd,19,0,20,1
1739703067133,TDGE 1,A04,835858,Salovey; Todd,20,0,20,0
1739703067133,TDGE 1,A05,835859,Salovey; Todd,19,0,20,1
1739703067133,TDGE 1,A06,835861,Salovey; Todd,17,0,20,3
1739703068157,TDGE 11,A00,835862,Fulton; Julia,224,0,245,21
1739703068157,TDGE 11,B00,835863,Salimi; Rana,157,0,158,1
1739703069183,TDGE 25,A00,835864,Harting; Carla Kelso,15,0,20,5
1739703069183,TDGE 25,B00,835865,Harting; Carla Kelso,14,0,20,6
1739703069183,TDGE 25,C00,835866,Harting; Carla Kelso,19,0,20,1
1739703069183,TDGE 25,D00,835868,Harting; Carla Kelso,16,0,20,4
1739703070208,TDGE 40,A02,835872,Power; Jade Yukana,29,0,30,1
1739703070208,TDGE 40,A03,835873,Power; Jade Yukana,30,0,30,0
1739703071237,TDGE 100,A01,836080,Salovey; Todd,24,0,25,1
1739703071237,TDGE 100,A02,836084,Salovey; Todd,24,0,25,1
1739703072266,TDGE 124,A00,836091,Fulton; Julia,232,0,250,18
1739703073290,TDGE 125,B00,836162,Havis; Allan,215,0,220,5
1739703074317,TDGE 196B,A00,872390,Brown; Bernard Joseph,1,0,1,0
1739703074317,TDGE 196B,B00,872391,Burelle; Julie Sara Veronique,2,0,2,0
1739703074317,TDGE 196B,C00,872392,Celik; Aysan Karagasli,2,0,2,0
1739703074317,TDGE 196B,D00,872394,Havis; Allan,1,0,1,0
1739703074317,TDGE 196B,E00,872396,Mehrishi; Rishika,1,0,1,0
1739703074317,TDGE 196B,F00,872397,Powell; Lora,1,0,1,0
1739703074317,TDGE 196B,G00,872398,Stalling; Vanessa,1,0,1,0
1739703074317,TDGE 196B,H00,872399,Stein; Deborah Isobel,2,0,2,0
1739703075343,TDGR 212,A00,836303,Meyer; Ursula,10,0,10,0
1739703076369,TDGR 219,A00,836305,Portes; Elizabeth Marie,5,0,5,0
1739703077395,TDGR 221B,A00,836306,Caban; Andrea Chudnow,10,0,10,0
1739703078419,TDGR 229,A00,836307,Meyer; Ursula,9,0,9,0
1739703079444,TDGR 233,A00,836308,Staff,9,0,9,0
1739703080471,TDGR 245,A00,836309,Stalling; Vanessa,3,0,3,0
1739703081497,TDGR 250,A00,836311,Staff,5,0,5,0
1739703082525,TDGR 251,A00,836314,Iizuka; Naomi Hisako,5,0,5,0
1739703082525,TDGR 251,B00,836315,Stein; Deborah Isobel,5,0,5,0
1739703083554,TDGR 257B,A00,836388,Stein; Deborah Isobel,7,0,7,0
1739703084579,TDGR 278,A00,836431,Petrovich; Victoria A.,20,0,20,0
1739703085605,TDGR 279,A00,836437,Brill; Robert L.,3,0,3,0
1739703085605,TDGR 279,B00,836440,Petrovich; Victoria A.,3,0,3,0
1739703085605,TDGR 279,C00,836441,McElver; Robert Harrison,3,0,3,0
1739703085605,TDGR 279,D00,836443,Kuhl; Christopher August,3,0,3,0
1739703085605,TDGR 279,E00,836444,Bokovikova; Alina V,3,0,3,0
1739703086632,TDGR 289C,A00,836447,Anderson; Mysia Anyse,10,0,10,0
1739703087656,TDGR 289D,A00,836448,Burelle; Julie Sara Veronique,10,0,10,0
1739703088681,TDGR 292,A00,836449,Anderson; Mysia Anyse,15,0,15,0
1739703089706,TDGR 296,A00,872384,Powell; Lora,10,0,10,0
1739703090731,TDHD 175,A00,836190,Brown; Bernard Joseph,19,0,20,1
1739703091758,TDHT 10,A00,835875,Power; Jade Yukana,24,0,25,1
1739703092784,TDHT 23,A01,835878,Burelle; Julie Sara Veronique,24,0,24,0
1739703092784,TDHT 23,A02,835879,Burelle; Julie Sara Veronique,24,0,24,0
1739703092784,TDHT 23,A03,835880,Burelle; Julie Sara Veronique,22,0,24,2
1739703093812,TDHT 101,A00,836191,Anderson; Mysia Anyse,23,0,25,2
1739703093812,TDHT 101,B00,836193,Staff,24,0,25,1
1739703094836,TDHT 104,A00,836196,Basso; Beatrice,24,0,25,1
1739703095863,TDHT 115,A00,872386,Staff,21,0,25,4
1739703096887,TDMV 1,A00,835881,Caligagan; Maria T.,21,0,30,9
1739703097911,TDMV 2,A00,835882,Weinberg; Sadie,25,0,30,5
1739703098936,TDMV 3,A00,835884,Mack; Kara Shanai',28,0,40,12
1739703100020,TDMV 11,A00,835886,Naves Tannus; Melissa,27,0,30,3
1739703101048,TDMV 20,A00,835890,Smith; Alison D,18,0,20,2
1739703101048,TDMV 20,B00,835920,Brown; Bernard Joseph,40,0,40,0
1739703102075,TDMV 110,A00,836197,Caligagan; Maria T.,29,0,30,1
1739703103099,TDMV 111,A00,836201,Smith; Alison D,26,0,30,4
1739703104124,TDMV 120,A00,836206,Johnston; Holly,30,0,30,0
1739703105148,TDMV 122,A00,836209,Weinberg; Sadie,30,0,30,0
1739703106175,TDMV 123,A00,836214,Johnston; Holly,30,0,30,0
1739703107201,TDMV 130,A00,836216,Mack; Kara Shanai',40,0,40,0
1739703108227,TDMV 138,A00,836222,Jun; Grace Shin Hae,17,0,40,23
1739703109253,TDMV 140,A00,836225,Caligagan; Maria T.,38,0,40,2
1739703109253,TDMV 140,B00,836226,Corrales; Joseph Bernales,39,0,40,1
1739703109253,TDMV 140,C00,836228,Mack; Kara Shanai',30,0,30,0
1739703109253,TDMV 140,D00,836229,Power; Jade Yukana,27,0,30,3
1739703109253,TDMV 140,E00,836232,Lima; Paulo Henrique,30,0,30,0
1739703110278,TDMV 141,A00,836236,Caligagan; Tony,29,0,30,1
1739703111302,TDMV 142,A00,836239,Blanco; Juan Carlos,27,0,30,3
1739703112330,TDMV 143,A00,836288,Fyall; Daunte Edward,29,0,30,1
1739703113358,TDMV 144,A00,836289,Camaya; Michelle Ann,25,0,30,5
1739703113358,TDMV 144,B00,836293,Patnaik; Shibani,30,0,30,0
1739703114383,TDMV 146,A00,836295,Caligagan; Tony,39,0,40,1
1739703115411,TDMV 149,A00,836296,Jun; Grace Shin Hae,38,0,40,2
1739703116437,TDPF 162,A00,836297,Alvarez; Ana Maria,30,0,30,0
1739703117461,TDPR 6,A01,835924,Guirguis; Mark C,50,0,50,0
1739703117461,TDPR 6,A02,835925,Guirguis; Mark C,50,0,50,0
1739703118489,TDPR 102,A00,836298,Guirguis; Mark C,20,0,20,0
1739703119516,TDPR 104,A00,836299,Powell; Lora,15,0,15,0
1739703120541,TDPW 1,A00,835931,Stein; Deborah Isobel,14,0,15,1
1739703120541,TDPW 1,B00,835932,Stein; Deborah Isobel,15,0,15,0
1739703120541,TDPW 1,C00,835934,Stein; Deborah Isobel,15,0,15,0
1739703120541,TDPW 1,D00,835936,Stein; Deborah Isobel,13,0,15,2
1739703120541,TDPW 1,E00,835939,Stein; Deborah Isobel,13,0,15,2
1739703121566,TDPW 102,A00,836300,Iizuka; Naomi Hisako,19,0,20,1
1739703122590,TDTR 10,A00,836002,Wilson; Terry A.,26,0,30,4
1739703123618,TDTR 15,A00,836003,Johnston; Holly,29,0,30,1
1739703124646,TDTR 20,A00,836004,Smith; Alison D,19,0,20,1
1739703125671,TMC 15,A00,836574,Hemans; Patricia Ann Benitez,25,0,27,2
1739703126788,TMC 120,A01,836579,Browne; Errol Tsekani,24,0,25,1
1739703127815,UROL 296,001,868229,Staff,5,0,5,0
1739703127815,UROL 296,002,868230,Staff,5,0,5,0
1739703128840,USP 1,A01,835156,Kwak; Nancy,30,0,30,0
1739703128840,USP 1,A02,835157,Kwak; Nancy,27,0,30,3
1739703128840,USP 1,A03,835158,Kwak; Nancy,29,0,30,1
1739703128840,USP 1,A04,835159,Kwak; Nancy,28,0,30,2
1739703128840,USP 1,A05,835160,Kwak; Nancy,30,0,30,0
1739703128840,USP 1,A06,835161,Kwak; Nancy,30,0,30,0
1739703129865,USP 2,A01,835188,Pezzoli; Keith,34,0,35,1
1739703129865,USP 2,A02,835191,Pezzoli; Keith,33,0,35,2
1739703130890,USP 3,A01,835207,Wickland; Teo Akande,30,0,30,0
1739703130890,USP 3,A02,835290,Wickland; Teo Akande,28,0,30,2
1739703131915,USP 4,A00,835371,Shi; Xiao,24,0,25,1
1739703132943,USP 5,A01,835376,Shenkman; Michael Thomas,30,0,35,5
1739703132943,USP 5,A02,835381,Shenkman; Michael Thomas,34,0,35,1
1739703133969,USP 6,A01,835456,Shvartzberg Carrio; Manuel,35,0,35,0
1739703133969,USP 6,A02,835457,Shvartzberg Carrio; Manuel,35,0,35,0
1739703134995,USP 15,A01,835460,Martin; Isaac,32,0,35,3
1739703134995,USP 15,A02,835461,Martin; Isaac,35,0,35,0
1739703136023,USP 25,A00,835462,Sun; Feiyang,58,0,60,2
1739703137051,USP 60,A01,835468,Wali; Behram,27,0,28,1
1739703138077,USP 100,A00,835469,Moses; Kelema Lee,68,0,70,2
1739703139101,USP 119,A00,835472,Schwaller; Nora Louise,30,0,35,5
1739703140126,USP 124,A00,835475,Hinds; Juli Beth,67,0,70,3
1739703141149,USP 125,A00,835477,Garcia; Guadalupe,22,0,22,0
1739703142173,USP 128B,A01,835530,Lewis; Leslie R,13,0,13,0
1739703143197,USP 131,A00,835537,Wartell; Julie Dara,35,0,65,30
1739703144224,USP 142C,A00,835546,Lerner; Amy M,0,0,0,3
1739703145249,USP 145,A00,835547,Yaghmaee; Saman,142,0,146,4
1739703146273,USP 150,A00,835548,Holmes; Michael Joseph,58,0,60,2
1739703147297,USP 151,A00,835551,Clark; Christopher N,42,0,45,3
1739703148321,USP 152A,A01,835569,Moeder; Nathan L,22,0,22,0
1739703148321,USP 152A,A02,835571,Moeder; Nathan L,21,0,22,1
1739703149346,USP 152B,A00,835581,Moeder; Nathan L,23,0,25,2
1739703150372,USP 153,A00,835641,Shenkman; Michael Thomas,63,0,65,2
1739703151396,USP 158A,A00,835683,Sun; Feiyang,25,0,25,0
1739703152423,USP 159B,A00,835704,Gherini; Paul Pier-Carlo,7,0,8,1
1739703153448,USP 160,A00,835742,Wartell; Julie Dara,25,0,25,0
1739703154491,USP 164,A00,835796,Moses; Kelema Lee,24,0,32,8
1739703155515,USP 165C,A00,835797,Frank; Lawrence Douglas,20,0,20,0
1739703156540,USP 169,A00,835799,Bajaj; Ravi Siddharth,29,0,30,1
1739703157565,USP 170,A00,835800,Entezam; Maryam,60,0,65,5
1739703158590,USP 171,A00,835802,Herzog; Lawrence,65,0,70,5
1739703159615,USP 172,A00,835804,Peerson; Susan,13,0,22,9
1739703160639,USP 175,A00,835805,Velasco; Diego,20,0,22,2
1739703160639,USP 175,B00,835806,Staff,20,0,22,2
1739703161664,USP 177A,A00,835807,Velasco; Diego,21,0,22,1
1739703162691,USP 177B,A00,835814,Peerson; Susan,22,0,25,3
1739703163716,USP 180,A00,835815,Frank; Lawrence Douglas,29,0,30,1
1739703164740,USP 188B,A00,835817,Pezzoli; Keith,30,0,30,0
1739703165768,USP 190,A00,835818,Collins; Caroline Imani,15,0,15,0
1739703166794,USP 191B,A00,835823,Shi; Xiao,18,0,20,2
1739703167821,USP 193,A00,835825,Staff,22,0,22,0
1739703168847,USP 194,A00,835837,Staff,0,0,0,0
1739703169874,USP 198,A00,880741,Moses; Kelema Lee,9999,0,9999,0
1739703170902,USP 265C,A00,835838,Frank; Lawrence Douglas,10,0,10,0
1739703171929,VIS 3,A01,833730,Fayman; Eva,25,0,25,0
1739703171929,VIS 3,A02,833731,Fayman; Eva,22,0,25,3
1739703171929,VIS 3,A03,833806,Fayman; Eva,24,0,25,1
1739703171929,VIS 3,A04,833888,Fayman; Eva,25,0,25,0
1739703171929,VIS 3,A05,833889,Fayman; Eva,25,0,25,0
1739703171929,VIS 3,A06,833890,Fayman; Eva,22,0,25,3
1739703171929,VIS 3,A07,833891,Fayman; Eva,24,0,25,1
1739703171929,VIS 3,A08,833892,Fayman; Eva,23,0,25,2
1739703171929,VIS 3,A09,833893,Fayman; Eva,25,0,25,0
1739703171929,VIS 3,A10,833894,Fayman; Eva,24,0,25,1
1739703171929,VIS 3,A11,833895,Fayman; Eva,25,0,25,0
1739703171929,VIS 3,A12,833896,Fayman; Eva,22,0,25,3
1739703172954,VIS 9,A00,833897,Sprague; Sean Jeffrey,213,0,250,37
1739703173982,VIS 10,A00,833898,Stone; Patricia,238,0,250,12
1739703175012,VIS 21A,A01,833900,Newsome; Elizabeth Ann,32,0,32,0
1739703175012,VIS 21A,A02,833901,Newsome; Elizabeth Ann,31,0,32,1
1739703175012,VIS 21A,A03,833902,Newsome; Elizabeth Ann,32,0,32,0
1739703175012,VIS 21A,A04,833903,Newsome; Elizabeth Ann,31,0,32,1
1739703175012,VIS 21A,A05,833904,Newsome; Elizabeth Ann,32,0,32,0
1739703175012,VIS 21A,A06,833905,Newsome; Elizabeth Ann,32,0,32,0
1739703176041,VIS 22,A01,833907,Williams; Alena J,32,0,32,0
1739703176041,VIS 22,A02,833908,Williams; Alena J,32,0,32,0
1739703176041,VIS 22,A03,833909,Williams; Alena J,30,0,32,2
1739703176041,VIS 22,A04,833910,Williams; Alena J,31,0,32,1
1739703176041,VIS 22,A05,833911,Williams; Alena J,31,0,32,1
1739703176041,VIS 22,A06,833912,Williams; Alena J,32,0,32,0
1739703176041,VIS 22,A07,833913,Williams; Alena J,32,0,32,0
1739703176041,VIS 22,A08,833914,Williams; Alena J,32,0,32,0
1739703176041,VIS 22,A09,833915,Williams; Alena J,32,0,32,0
1739703176041,VIS 22,A10,833916,Williams; Alena J,32,0,32,0
1739703176041,VIS 22,A11,833917,Williams; Alena J,31,0,32,1
1739703176041,VIS 22,A12,833918,Williams; Alena J,32,0,32,0
1739703177067,VIS 31,A00,833919,Dominguez; Ricardo,308,0,320,12
1739703178094,VIS 32,A01,833921,Yoldas; Pinar,31,0,32,1
1739703178094,VIS 32,A02,833922,Yoldas; Pinar,31,0,32,1
1739703179118,VIS 41,A01,833924,D'Elena-Tweed; Jessica Erin,25,0,25,0
1739703179118,VIS 41,A02,833925,D'Elena-Tweed; Jessica Erin,20,0,25,5
1739703179118,VIS 41,A03,833926,D'Elena-Tweed; Jessica Erin,25,0,25,0
1739703179118,VIS 41,A04,833927,D'Elena-Tweed; Jessica Erin,22,0,25,3
1739703179118,VIS 41,A05,833928,D'Elena-Tweed; Jessica Erin,25,0,25,0
1739703179118,VIS 41,A06,833929,D'Elena-Tweed; Jessica Erin,25,0,25,0
1739703180147,VIS 70N,A01,833931,Garnett; Mariah J,22,0,22,0
1739703180147,VIS 70N,A02,833932,Garnett; Mariah J,21,0,22,1
1739703180147,VIS 70N,A03,833972,Garnett; Mariah J,22,0,22,0
1739703180147,VIS 70N,A04,833974,Garnett; Mariah J,20,0,22,2
1739703180147,VIS 70N,A05,834047,Garnett; Mariah J,22,0,22,0
1739703180147,VIS 70N,A06,834048,Garnett; Mariah J,22,0,22,0
1739703181172,VIS 85A,A01,834098,Balboni; Francesca Jean,32,0,34,2
1739703181172,VIS 85A,A02,834099,Balboni; Francesca Jean,33,0,34,1
1739703182197,VIS 87,A00,872413,Mullin; Jennifer S & Twomey; Robert Daniel,10,0,10,0
1739703183223,VIS 100A,A00,834100,Cruz; Edwin Teddy,7,0,15,8
1739703184248,VIS 102,A00,834103,Cruz; Edwin Teddy,140,0,146,6
1739703185273,VIS 105A,A00,834105,Adler; Amy,29,0,30,1
1739703186297,VIS 105B,A00,834106,Tonies; Joshua Vanjaymes,26,0,30,4
1739703187325,VIS 105C,A00,834107,Herc-Balaszek; Malgorzata,14,0,15,1
1739703188351,VIS 106A,A00,834184,Staff,25,0,25,0
1739703188351,VIS 106A,B00,834185,Chew Ii; Troy Lamarr,24,0,25,1
1739703189375,VIS 106B,A00,834191,Ortiz-Torres; Ruben,24,0,25,1
1739703190401,VIS 106C,A00,834192,Staff,12,0,15,3
1739703191428,VIS 107A,A00,834193,Staff,21,0,25,4
1739703192456,VIS 107B,A00,834194,Pylypchuk; Jonathan,22,0,25,3
1739703193482,VIS 110A,A00,834217,Dinco; Dino,14,0,15,1
1739703194507,VIS 110B,A00,834218,Iglesias; Janelle Ann,13,0,15,2
1739703195530,VIS 110D,A00,834220,Tonies; Joshua Vanjaymes,14,0,15,1
1739703196558,VIS 110F,A00,834224,Fayman; Eva,15,0,15,0
1739703197584,VIS 110N,A00,834226,Adler; Amy,15,0,15,0
1739703198610,VIS 113BN,A00,834227,Staff,14,0,15,1
1739703199635,VIS 117E,A00,834229,Newsome; Elizabeth Ann,11,0,15,4
1739703200662,VIS 121AN,A00,834231,Tronzo; William,72,0,75,3
1739703201689,VIS 124E,A00,834312,Rose; Jordan M,70,0,75,5
1739703202716,VIS 127B,A00,834313,Shen; Kuiyi,146,0,146,0
1739703203810,VIS 128A,A00,834314,Tronzo; William,73,0,75,2
1739703204834,VIS 133,A01,834317,Cantrell; Joe Leo,33,0,34,1
1739703204834,VIS 133,A02,834318,Cantrell; Joe Leo,34,0,34,0
1739703205858,VIS 133A,A00,834409,Chevalier; Clarissa Maria,15,0,15,0
1739703206886,VIS 134,A00,834422,Staff,70,0,75,5
1739703207910,VIS 141B,A00,834423,Stalbaum; Brett,13,0,15,2
1739703208935,VIS 145B,A00,834455,Akten; Mehmet,13,0,15,2
1739703208935,VIS 145B,B00,834467,Alexander; Amy J,14,0,15,1
1739703209961,VIS 146A,A00,834482,Paden; Jonathon Dean,18,0,22,4
1739703210987,VIS 147A,A01,834484,Stalbaum; Brett,20,0,22,2
1739703210987,VIS 147A,A02,834485,Stalbaum; Brett,22,0,22,0
1739703210987,VIS 147A,A03,834493,Stalbaum; Brett,21,0,22,1
1739703210987,VIS 147A,A04,834494,Stalbaum; Brett,20,0,22,2
1739703212013,VIS 147B,A00,834495,Paden; Jonathon Dean,15,0,15,0
1739703213041,VIS 149,A00,834496,Yoldas; Pinar,12,0,15,3
1739703214068,VIS 150A,A00,834506,Staff,11,0,15,4
1739703215097,VIS 152D,A01,834679,Wardwell; Mariana Razo,33,0,34,1
1739703215097,VIS 152D,A02,834754,Wardwell; Mariana Razo,34,0,34,0
1739703215097,VIS 152D,A03,834757,Wardwell; Mariana Razo,32,0,34,2
1739703215097,VIS 152D,A04,834760,Wardwell; Mariana Razo,33,0,34,1
1739703216126,VIS 159,A01,834850,Cartwright; Lisa,34,0,34,0
1739703216126,VIS 159,A02,834851,Cartwright; Lisa,30,0,34,4
1739703216126,VIS 159,A03,834852,Cartwright; Lisa,32,0,34,2
1739703216126,VIS 159,A04,834853,Cartwright; Lisa,34,0,34,0
1739703216126,VIS 159,A05,834855,Cartwright; Lisa,31,0,34,3
1739703216126,VIS 159,A06,834857,Cartwright; Lisa,34,0,34,0
1739703217149,VIS 160A,A00,871872,Paden; Jonathon Dean,15,0,15,0
1739703218174,VIS 160B,A00,834858,Akten; Mehmet,8,0,15,7
1739703218174,VIS 160B,B00,834860,Twomey; Robert Daniel,12,0,15,3
1739703218174,VIS 160B,C00,834861,Alexander; Amy J,13,0,15,2
1739703219201,VIS 164,A00,834867,Sprague; Sean Jeffrey,21,0,22,1
1739703219201,VIS 164,B00,834868,Zurita; Dmitri,22,0,22,0
1739703220227,VIS 167,A00,835011,Staff,22,0,22,0
1739703221252,VIS 168,A00,835015,Zurita; Dmitri,21,0,22,1
1739703222277,VIS 169A,A00,881456,Cross; Brian R,21,0,22,1
1739703223301,VIS 171,A00,835016,Cross; Brian R,20,0,22,2
1739703224329,VIS 172,A00,835090,Trigilio; Michael,20,0,22,2
1739703225353,VIS 174,A00,835102,Stone; Patricia,18,0,22,4
1739703225353,VIS 174,B00,835113,Zurita; Dmitri,21,0,22,1
1739703226380,VIS 177,A00,835114,Crandall; Jordan,22,0,22,0
1739703227407,VIS 179,A00,835118,Segade; Alexandro Abraham,22,0,22,0
1739703228435,VIS 180A,A00,835120,Dinco; Dino,22,0,22,0
1739703229462,VIS 180B,A00,835121,Miller; Nicole L,21,0,22,1
1739703230490,VIS 182,A00,835141,Dinco; Dino,17,0,22,5
1739703231514,VIS 185,A00,835142,Miller; Nicole L,22,0,22,0
1739703232539,VIS 190,A00,835143,Dominguez; Ricardo,15,0,15,0
1739703232539,VIS 190,B00,835144,D'Elena-Tweed; Jessica Erin,13,0,15,2
1739703232539,VIS 190,C00,835146,Yoldas; Pinar,15,0,15,0
1739703233566,VIS 202,A00,835148,Garnett; Mariah J,12,0,15,3
1739703234593,VIS 203,A00,835149,Iglesias; Janelle Ann,9,0,15,6
1739703235620,VIS 206,A00,835150,Kester; Grant,9,0,15,6
1739703236648,VIS 208,A00,835151,Moss; Ceci,15,0,15,0
1739703237673,VIS 211,A00,871767,Dean; Danielle Adobi,4,0,15,11
1739703238701,VIS 220,A00,835152,Williams; Alena J,11,0,15,4
1739703239727,VIS 258,A00,835153,Shen; Kuiyi,11,0,15,4
1739703240761,WCWP 10A,001,833211,Dhir; Simrita,20,0,20,0
1739703240761,WCWP 10A,002,833218,Dhir; Simrita,19,0,20,1
1739703240761,WCWP 10A,003,833221,Staff,0,0,0,0
1739703240761,WCWP 10A,006,833232,Susi; Natalie,0,0,0,0
1739703240761,WCWP 10A,011,833250,Staff,0,0,0,0
1739703240761,WCWP 10A,012,833255,Windham; Emily,18,0,20,2
1739703240761,WCWP 10A,013,833258,Windham; Emily,14,0,20,6
1739703240761,WCWP 10A,014,833259,Holloway Ii; Mathew,19,0,20,1
1739703240761,WCWP 10A,015,833261,Windham; Emily,17,0,20,3
1739703240761,WCWP 10A,016,833262,Holloway Ii; Mathew,20,0,20,0
1739703240761,WCWP 10A,017,833263,Holloway Ii; Mathew,20,0,20,0
1739703240761,WCWP 10A,018,872017,Escobar; Jordan Christophe,20,0,20,0
1739703240761,WCWP 10A,019,872087,Escobar; Jordan Christophe,19,0,20,1
1739703240761,WCWP 10A,020,872122,Escobar; Jordan Christophe,19,0,20,1
1739703240761,WCWP 10A,021,872361,Martiniuk; Jill,20,0,20,0
1739703240761,WCWP 10A,022,872362,Martiniuk; Jill,20,0,20,0
1739703240761,WCWP 10A,023,872364,Martiniuk; Jill,20,0,20,0
1739703240761,WCWP 10A,024,872365,Welji; Haleema Nazir,0,0,0,0
1739703241795,WCWP 10B,003,833318,Merryman; Walter,20,0,20,0
1739703241795,WCWP 10B,005,833340,Merryman; Walter,19,0,20,1
1739703241795,WCWP 10B,006,833342,Merryman; Walter,18,0,20,2
1739703241795,WCWP 10B,007,833358,Staff,0,0,0,0
1739703241795,WCWP 10B,008,833359,Ornelas; Tricia,18,0,20,2
1739703241795,WCWP 10B,009,833364,Ornelas; Tricia,16,0,20,4
1739703241795,WCWP 10B,010,833371,Uriarte; Emma,9,0,20,11
1739703241795,WCWP 10B,011,833378,Gagnon; Jeffrey C,0,0,0,0
1739703241795,WCWP 10B,012,833395,Uriarte; Emma,17,0,20,3
1739703241795,WCWP 10B,013,833397,Uriarte; Emma,13,0,20,7
1739703241795,WCWP 10B,014,833398,Staff,0,0,0,0
1739703241795,WCWP 10B,019,833421,Staff,0,0,0,0
1739703241795,WCWP 10B,020,833422,Staff,0,0,0,0
1739703241795,WCWP 10B,021,833423,Staff,0,0,0,0
1739703241795,WCWP 10B,022,833455,Gagnon; Jeffrey C,15,0,16,1
1739703241795,WCWP 10B,023,833489,Gagnon; Jeffrey C,14,0,16,2
1739703241795,WCWP 10B,024,833614,Staff,0,0,0,0
1739703241795,WCWP 10B,025,833615,Gagnon; Jeffrey C,15,0,16,1
1739703241795,WCWP 10B,026,833635,Gagnon; Jeffrey C,16,0,16,0
1739703241795,WCWP 10B,027,833667,Staff,0,0,0,0
1739703241795,WCWP 10B,028,874686,Gagnon; Jeffrey C,14,0,16,2
1739703241795,WCWP 10B,029,874687,Gagnon; Jeffrey C,15,0,16,1
1739703242823,WCWP 100,A00,833668,McCleary; Keith Long,20,0,20,0
1739703242823,WCWP 100,B00,833669,McCleary; Keith Long,19,0,20,1
1739703242823,WCWP 100,C00,833673,Twohig; Niall Ivan,19,0,20,1
1739703242823,WCWP 100,D00,833677,Twohig; Niall Ivan,19,0,20,1
1739703242823,WCWP 100,E00,833678,Young; Mark T,18,0,20,2
1739703242823,WCWP 100,F00,833679,Young; Mark T,19,0,20,1
1739703243849,WES 207,A00,833201,Staff,20,0,20,0
1739703244873,WES 265,A00,833205,Staff,20,0,20,0
1739703247096,AAS 10R,A01,807278,Butler; Elizabeth Annette,28,0,34,6
1739703247096,AAS 10R,A02,807279,Butler; Elizabeth Annette,30,0,34,4
1739703248121,AAS 170R,A00,807281,Butler; Elizabeth Annette,26,0,28,2
1739703249144,AESE 261,A00,804942,Staff,30,0,30,0
1739703250173,AESE 278D,A00,804945,Staff,30,0,30,0
1739703251201,AESE 278E,A00,804981,Staff,30,0,30,0
1739703252225,AESE 279A,A00,804985,Staff,30,0,30,0
1739703253254,ANAR 100,A00,872378,Dunseth; Zachary Clark,19,0,20,1
1739703254278,ANAR 104,A01,803045,Shtienberg; Gilad,24,0,25,1
1739703254278,ANAR 104,A02,803066,Shtienberg; Gilad,0,0,0,0
1739703255306,ANAR 111,A00,803067,Dunseth; Zachary Clark,25,0,25,0
1739703256330,ANAR 138,A00,803079,Algaze; Guillermo,12,0,15,3
1739703257355,ANAR 155,A00,803081,Braswell; Geoffrey E.,19,0,25,6
1739703258383,ANBI 111,A00,803085,Staff,22,0,25,3
1739703259409,ANBI 116,A00,803087,Wilder; Linnea Lorene,149,0,150,1
1739703260437,ANBI 139,A00,870761,Gagneux; Pascal,137,0,145,8
1739703261462,ANBI 144,A00,803091,Wilder; Linnea Lorene,70,0,75,5
1739703262490,ANBI 149,A00,803093,Non; Amy L,19,0,20,1
1739703263515,ANBI 174,A00,803096,Strum; Shirley C.,15,0,15,0
1739703264543,ANES 296,001,866120,Suresh; Preetham John,4,0,5,1
1739703264543,ANES 296,002,866141,Staff,5,0,5,0
1739703264543,ANES 296,003,866168,Staff,5,0,5,0
1739703265569,ANSC 100,A00,803098,Bialecki; Jon Anthony,23,0,25,2
1739703265569,ANSC 100,B00,871150,Rabinowitz; Dan,20,0,20,0
1739703266597,ANSC 101,A00,803099,Sloane; Julia Kathryn,35,0,40,5
1739703267625,ANSC 117,A00,803100,Martin Sandino; Amanda Maria Yoland,16,0,18,2
1739703268650,ANSC 134,A00,803104,Petterson; John C.,25,0,25,0
1739703269675,ANSC 137,A00,803105,Stewart; Alexander B,39,0,40,1
1739703270701,ANSC 147,A00,803106,Stewart; Alexander B,36,0,40,4
1739703271729,ANSC 148,A00,803110,Schonberg; Jeffrey,45,0,46,1
1739703272757,ANSC 173,A00,803119,Brenner; Suzanne A,10,0,12,2
1739703273781,ANSC 180,A00,803121,Hankins; Joseph D.,22,0,25,3
1739703274809,ANSC 191,A00,803124,Yeh; Rihan Wen Xin,11,0,12,1
1739703275834,ANTH 2,A01,803000,Marchetto; Maria Carolina,32,0,33,1
1739703275834,ANTH 2,A02,803001,Marchetto; Maria Carolina,32,0,33,1
1739703275834,ANTH 2,A03,803005,Marchetto; Maria Carolina,30,0,33,3
1739703275834,ANTH 2,A04,803006,Marchetto; Maria Carolina,30,0,33,3
1739703275834,ANTH 2,A05,803007,Marchetto; Maria Carolina,33,0,33,0
1739703275834,ANTH 2,A06,803008,Marchetto; Maria Carolina,31,0,31,0
1739703276863,ANTH 3,A01,803012,Algaze; Guillermo,30,0,30,0
1739703276863,ANTH 3,A02,803013,Algaze; Guillermo,30,0,30,0
1739703276863,ANTH 3,A03,803015,Algaze; Guillermo,30,0,30,0
1739703276863,ANTH 3,A04,803016,Algaze; Guillermo,30,0,30,0
1739703277892,ANTH 4,A01,803020,Yeh; Rihan Wen Xin,27,0,30,3
1739703277892,ANTH 4,A02,803021,Yeh; Rihan Wen Xin,30,0,30,0
1739703277892,ANTH 4,A03,803022,Yeh; Rihan Wen Xin,30,0,30,0
1739703277892,ANTH 4,A04,803024,Yeh; Rihan Wen Xin,30,0,30,0
1739703278918,ANTH 10,A00,803025,Stewart; Alexander B,73,0,80,7
1739703279944,ANTH 21,A01,803027,Stone; Annika Britt,38,0,40,2
1739703279944,ANTH 21,A02,803030,Stone; Annika Britt,36,0,40,4
1739703279944,ANTH 21,A03,803031,Stone; Annika Britt,39,0,40,1
1739703279944,ANTH 21,A04,803032,Stone; Annika Britt,39,0,40,1
1739703280971,ANTH 23,A01,803034,Stone; Annika Britt,39,0,40,1
1739703280971,ANTH 23,A02,803036,Stone; Annika Britt,39,0,40,1
1739703280971,ANTH 23,A03,803037,Stone; Annika Britt,40,0,40,0
1739703280971,ANTH 23,A04,803038,Stone; Annika Britt,40,0,40,0
1739703281997,ANTH 87,A00,875928,Staff,20,0,20,0
1739703283025,ANTH 103,A00,803126,Hankins; Joseph D.,98,0,100,2
1739703284050,ANTH 105,A00,803130,Rabinowitz; Dan,73,0,75,2
1739703285076,ANTH 109,A00,803133,Staff,38,0,40,2
1739703286100,ANTH 110,A00,803135,Staff,15,0,20,5
1739703287125,ANTH 128B,A01,803139,Lewis; Leslie R,12,0,12,0
1739703288150,ANTH 196C,A00,803147,Varma; Saiba,20,0,20,0
1739703289177,ANTH 198,001,886925,Varma; Saiba,15,0,15,0
1739703290202,ANTH 200,A00,803150,Pedersen; David,15,0,15,0
1739703291226,ANTH 230,A00,889211,Gagneux; Pascal,17,0,20,3
1739703292251,ANTH 272,A00,803155,Gere; Catherina M.,9,0,10,1
1739703293279,ANTH 273,A00,803158,McKenzie; Kerry V.,10,0,10,0
1739703294303,ANTH 288,A00,803189,Braswell; Geoffrey E.,25,0,25,0
1739703295334,ANTH 295,001,887807,Algaze; Guillermo,3,0,3,0
1739703295334,ANTH 295,002,887809,Braswell; Geoffrey E.,3,0,3,0
1739703295334,ANTH 295,003,887890,Brenner; Suzanne A,3,0,3,0
1739703295334,ANTH 295,004,887891,Csordas; Thomas J.,3,0,3,0
1739703295334,ANTH 295,005,887909,Fox; Patrick Keolu Ozer,3,0,3,0
1739703295334,ANTH 295,006,887940,Gagneux; Pascal,3,0,3,0
1739703295334,ANTH 295,007,887941,Goldstein; Paul S,3,0,3,0
1739703295334,ANTH 295,008,887942,Hankins; Joseph D.,3,0,3,0
1739703295334,ANTH 295,009,887948,Jassal; Aftab,3,0,3,0
1739703295334,ANTH 295,010,887949,Jenkins; Janis A.,3,0,3,0
1739703295334,ANTH 295,011,887950,Jimenez Cano; Nayeli Guada,3,0,3,0
1739703295334,ANTH 295,012,887951,Kaiser; Bronwyn Nicole,3,0,3,0
1739703295334,ANTH 295,013,887955,Kang; Byung Chu,3,0,3,0
1739703295334,ANTH 295,014,887957,Marchetto; Maria Carolina,3,0,3,0
1739703295334,ANTH 295,015,887960,Non; Amy L,3,0,3,0
1739703295334,ANTH 295,016,887961,Pedersen; David,3,0,3,0
1739703295334,ANTH 295,017,887962,Rivera-Collazo; Isabel C,3,0,3,0
1739703295334,ANTH 295,018,887963,Varma; Saiba,3,0,3,0
1739703295334,ANTH 295,019,887969,Yeh; Rihan Wen Xin,3,0,3,0
1739703296366,ANTH 296,001,888015,Braswell; Geoffrey E.,3,0,3,0
1739703296366,ANTH 296,002,888024,Marchetto; Maria Carolina,3,0,3,0
1739703296366,ANTH 296,003,888035,Rivera-Collazo; Isabel C,3,0,3,0
1739703296366,ANTH 296,004,888050,Varma; Saiba,3,0,3,0
1739703296366,ANTH 296,005,888055,Algaze; Guillermo,3,0,3,0
1739703296366,ANTH 296,006,888067,Brenner; Suzanne A,3,0,3,0
1739703296366,ANTH 296,007,888075,Csordas; Thomas J.,3,0,3,0
1739703296366,ANTH 296,008,888081,Fox; Patrick Keolu Ozer,3,0,3,0
1739703296366,ANTH 296,009,888084,Gagneux; Pascal,3,0,3,0
1739703296366,ANTH 296,010,888086,Goldstein; Paul S,2,0,3,1
1739703296366,ANTH 296,011,888089,Hankins; Joseph D.,3,0,3,0
1739703296366,ANTH 296,012,888093,Jassal; Aftab,3,0,3,0
1739703296366,ANTH 296,013,888095,Jenkins; Janis A.,3,0,3,0
1739703296366,ANTH 296,014,888099,Jimenez Cano; Nayeli Guada,3,0,3,0
1739703296366,ANTH 296,015,888101,Kaiser; Bronwyn Nicole,3,0,3,0
1739703296366,ANTH 296,016,888102,Kang; Byung Chu,3,0,3,0
1739703296366,ANTH 296,017,888106,Levy; Thomas E,3,0,3,0
1739703296366,ANTH 296,018,888109,Non; Amy L,3,0,3,0
1739703296366,ANTH 296,019,888111,Pedersen; David,3,0,3,0
1739703296366,ANTH 296,020,888112,Postero; Nancy Grey,3,0,3,0
1739703296366,ANTH 296,021,888116,Semendeferi; Ekaterini,3,0,3,0
1739703296366,ANTH 296,022,888118,Yeh; Rihan Wen Xin,3,0,3,0
1739703297390,ASTR 2,A01,803214,Nadler; Ethan Oliver,296,0,300,4
1739703298416,ASTR 15,A01,803221,Wright; Shelley Adams,47,0,50,3
1739703299443,ASTR 18,A01,803234,Arnold; Kam S,30,0,30,0
1739703300468,ASTR 60,A01,803300,Burgasser; Adam Jonathan,14,0,15,1
1739703300468,ASTR 60,A02,803301,Burgasser; Adam Jonathan,15,0,15,0
1739703300468,ASTR 60,A03,803302,Burgasser; Adam Jonathan,15,0,15,0
1739703300468,ASTR 60,A04,803303,Burgasser; Adam Jonathan,15,0,15,0
1739703301495,ASTR 87,A00,871154,Burgasser; Adam Jonathan,20,0,20,0
1739703302521,ASTR 103,A01,803305,Diamond; Patrick H,30,0,30,0
1739703303547,ASTR 106,A01,803307,Boggs; Steven Edward,30,0,30,0
1739703304573,ASTR 123,A01,803343,Keres; Dusan,35,0,39,4
1739703305599,ASTR 154,A01,803345,Hosseinzadeh; Griffin Alex,40,0,40,0
1739703306624,ASTR 211,A00,803346,Broekgaarden; Floor Suzan,12,0,15,3
1739703307705,ASTR 250,A00,803347,Theissen; Christopher Alexander & Hosseinzadeh; Griffin Alex,26,0,30,4
1739703308730,ASTR 251,A00,803359,Theissen; Christopher Alexander & Hosseinzadeh; Griffin Alex,28,0,30,2
1739703309757,AUD 236,A00,804989,Harris; Jeffrey Paul,5,0,5,0
1739703310785,AUD 260,A01,804994,Zettner; Erika,13,0,13,0
1739703311809,AUD 272,A00,804997,Zettner; Erika,13,0,13,0
1739703312836,AUD 275,A00,805001,Zettner; Erika,13,0,13,0
1739703313862,AUD 284,A00,805004,Zettner; Erika,13,0,13,0
1739703314890,AUD 291,A00,805008,Zettner; Erika,13,0,13,0
1739703315917,AUD 296,A00,805013,Zettner; Erika,6,0,6,0
1739703316944,AWP 3,001,802590,O'Neil; Courtney L,9,0,9,0
1739703316944,AWP 3,002,802591,O'Neil; Courtney L,9,0,9,0
1739703316944,AWP 3,003,802592,Kolodezh; Samuel,8,0,9,1
1739703316944,AWP 3,004,802593,Zimmerman; Guy,9,0,9,0
1739703316944,AWP 3,005,802594,Vaughn; Kelsey Sara,9,0,9,0
1739703316944,AWP 3,006,802595,Vaughn; Kelsey Sara,9,0,9,0
1739703316944,AWP 3,007,802597,Given; William Allan,9,0,9,0
1739703317968,AWP 4A,A00,802601,Ajo; Frances Margaret,10,0,10,0
1739703317968,AWP 4A,B00,802602,Ajo; Frances Margaret,9,0,10,1
1739703317968,AWP 4A,C00,880738,Bauer; Holly Jean,10,0,10,0
1739703319013,AWP 4B,001,802603,Steinberg; Stacy A,0,0,0,0
1739703319013,AWP 4B,002,802604,Steinberg; Stacy A,0,0,0,2
1739703319013,AWP 4B,003,802605,Gilmore; Lauren Monica,0,0,0,1
1739703319013,AWP 4B,004,802606,Gilmore; Lauren Monica,0,0,0,0
1739703319013,AWP 4B,007,802609,Bolin; Jillian,0,0,0,0
1739703319013,AWP 4B,008,802610,Bolin; Jillian,0,0,0,0
1739703319013,AWP 4B,009,802611,Zroka; Amy Liane,0,0,0,0
1739703319013,AWP 4B,010,802612,Zroka; Amy Liane,0,0,0,0
1739703319013,AWP 4B,011,802614,Christie; Veronica Ann,0,0,0,0
1739703319013,AWP 4B,012,802672,Christie; Veronica Ann,0,0,0,0
1739703319013,AWP 4B,013,802673,Jones; William Jadie,0,0,0,0
1739703319013,AWP 4B,014,802676,Jones; William Jadie,0,0,0,1
1739703319013,AWP 4B,015,802677,Heiser; Jerrod A,0,0,0,0
1739703319013,AWP 4B,016,802679,Heiser; Jerrod A,0,0,0,1
1739703319013,AWP 4B,017,802683,Bourdeau; Joseph Albert,0,0,0,0
1739703319013,AWP 4B,018,802684,Bourdeau; Joseph Albert,0,0,0,1
1739703319013,AWP 4B,019,802690,Wilson; Natalie Ann,0,0,0,0
1739703319013,AWP 4B,020,802691,Wilson; Natalie Ann,0,0,0,0
1739703319013,AWP 4B,021,802692,Stanton; Jennifer K,0,0,0,0
1739703319013,AWP 4B,022,802693,Stanton; Jennifer K,0,0,0,1
1739703319013,AWP 4B,023,802696,Riggle; Amanda L,0,0,0,1
1739703319013,AWP 4B,024,802699,Riggle; Amanda L,0,0,0,0
1739703319013,AWP 4B,025,802702,Homenick; Erik Christopher,0,0,0,0
1739703319013,AWP 4B,026,802703,Homenick; Erik Christopher,0,0,0,0
1739703319013,AWP 4B,027,802705,Ornelas Jr.; David Paul,0,0,0,0
1739703319013,AWP 4B,028,802706,Grant; Melinda G,0,0,0,0
1739703319013,AWP 4B,029,802707,Grant; Melinda G,0,0,0,0
1739703319013,AWP 4B,030,802708,Ornelas Jr.; David Paul,0,0,0,0
1739703319013,AWP 4B,031,802709,Falcon; Jennifer A,0,0,0,0
1739703319013,AWP 4B,032,802710,Falcon; Jennifer A,0,0,0,0
1739703319013,AWP 4B,033,802711,Westerfeld; Kevin John,0,0,0,0
1739703319013,AWP 4B,034,802712,Tiernan; Christa Michelle,0,0,0,0
1739703319013,AWP 4B,035,802714,Tiernan; Christa Michelle,0,0,0,0
1739703319013,AWP 4B,036,802980,Westerfeld; Kevin John,0,0,0,0
1739703319013,AWP 4B,038,802982,Gardella; Alexander Drew,0,0,0,0
1739703319013,AWP 4B,039,802983,Gardella; Alexander Drew,0,0,0,0
1739703319013,AWP 4B,040,802985,Coulter; Jane Elisabeth,0,0,0,0
1739703319013,AWP 4B,041,802986,Spicer; Jacqueline,0,0,0,0
1739703319013,AWP 4B,042,802987,Spicer; Jacqueline,0,0,0,0
1739703319013,AWP 4B,043,802989,Tsurska Svetina; Olena,0,0,0,0
1739703319013,AWP 4B,044,802990,Tsurska Svetina; Olena,0,0,0,1
1739703319013,AWP 4B,045,802991,Chandler; Bailee Daniele,0,0,0,0
1739703319013,AWP 4B,046,802993,Chandler; Bailee Daniele,0,0,0,1
1739703319013,AWP 4B,047,802994,Hall; Graham T,0,0,0,0
1739703319013,AWP 4B,048,802995,Hall; Graham T,0,0,0,0
1739703320046,AWP 10R,001,871136,Gocsik; Karen Marie,13,0,15,2
1739703321072,BENG 87,A00,886240,Sah; Robert Lie-Yuan,20,0,20,0
1739703321072,BENG 87,B00,886257,Sah; Robert Lie-Yuan,20,0,20,0
1739703322102,BENG 100,A01,805026,Alexandrov; Ludmil B,30,0,30,0
1739703322102,BENG 100,A02,805028,Alexandrov; Ludmil B,29,0,30,1
1739703322102,BENG 100,A03,805030,Alexandrov; Ludmil B,30,0,30,0
1739703322102,BENG 100,A04,805031,Alexandrov; Ludmil B,29,0,30,1
1739703323127,BENG 102,A00,805032,Chapelin; Fanny,52,0,56,4
1739703324155,BENG 103B,A00,805039,Fraley; Stephanie I.,116,0,120,4
1739703325179,BENG 112B,A01,805055,Shi; Lingyan,22,0,23,1
1739703325179,BENG 112B,A02,805056,Shi; Lingyan,20,0,23,3
1739703326204,BENG 125,A01,805058,Hasty; Jeff M,14,0,32,18
1739703326204,BENG 125,A02,805059,Hasty; Jeff M,31,0,32,1
1739703326204,BENG 125,A03,805060,Hasty; Jeff M,31,0,32,1
1739703326204,BENG 125,A04,805102,Hasty; Jeff M,32,0,32,0
1739703326204,BENG 125,A05,805109,Hasty; Jeff M,19,0,32,13
1739703327228,BENG 130,A00,805118,Kravets; Vira V.,37,0,40,3
1739703328256,BENG 134,A01,805171,Smarr; Benjamin,34,0,40,6
1739703329282,BENG 140B,A01,805175,Cabrales; Pedro,27,0,30,3
1739703329282,BENG 140B,A02,805176,Cabrales; Pedro,29,0,30,1
1739703329282,BENG 140B,A03,805177,Cabrales; Pedro,28,0,30,2
1739703330309,BENG 160,A50,805180,Aguado; Brian Alberto,18,0,25,7
1739703330309,BENG 160,A51,805181,Aguado; Brian Alberto,23,0,25,2
1739703330309,BENG 160,A52,805182,Aguado; Brian Alberto,25,0,25,0
1739703331333,BENG 168,A01,805184,Khojah; Reem I,30,0,30,0
1739703332358,BENG 172,A50,805187,Cabrales; Pedro & Sah; Robert Lie-Yuan,13,0,20,7
1739703332358,BENG 172,A51,805188,Cabrales; Pedro & Sah; Robert Lie-Yuan,19,0,20,1
1739703333386,BENG 182,A01,805190,Bafna; Vineet,29,0,35,6
1739703334411,BENG 186A,A01,805192,Kwon; Ester Jihae,0,0,25,25
1739703334411,BENG 186A,A02,805193,Kwon; Ester Jihae,23,0,25,2
1739703334411,BENG 186A,A04,805195,Kwon; Ester Jihae,17,0,25,8
1739703335436,BENG 186B,A01,805230,Aran; Kiana,39,0,40,1
1739703336463,BENG 187A,A00,805231,Taylor Amos; Alyssa C,152,0,170,18
1739703337490,BENG 187D,A00,805243,Taylor Amos; Alyssa C,34,0,60,26
1739703337490,BENG 187D,B00,805249,Taylor Amos; Alyssa C,50,0,60,10
1739703337490,BENG 187D,C00,805286,Taylor Amos; Alyssa C,41,0,60,19
1739703338516,BENG 190,A00,872568,Khojah; Reem I,24,0,40,16
1739703339542,BENG 193,A00,805288,Engler; Adam J.,0,0,0,0
1739703340569,BENG 196,A00,803380,Engler; Adam J.,9999,0,9999,0
1739703341594,BENG 197,A00,803381,Engler; Adam J.,9999,0,9999,0
1739703342623,BENG 203,A00,805307,Bafna; Vineet & Zhong; Sheng,20,0,20,0
1739703343651,BENG 207,A00,805308,Kwon; Ester Jihae,1,0,40,39
1739703343651,BENG 207,B00,805309,Taylor Amos; Alyssa C,0,0,30,30
1739703343651,BENG 207,C00,805310,Spang; Martin Thomas,15,0,40,25
1739703344679,BENG 209,A00,805311,Scholtes Acevedo; Claire,30,0,30,0
1739703345708,BENG 213,A00,805312,Palsson; Bernhard O.,16,0,20,4
1739703346733,BENG 224,A00,805313,Prado; Gustavo Rotelli,0,0,20,30
1739703347759,BENG 226,A01,805315,Staff,74,0,140,66
1739703348786,BENG 227,A00,805316,Fraley; Stephanie I.,42,0,120,78
1739703349811,BENG 230C,A00,805318,King; Kevin R,59,0,90,31
1739703350840,BENG 232,A01,805320,Sah; Robert Lie-Yuan,16,0,70,54
1739703351868,BENG 233,A00,805364,Shah; Sameer B,21,0,50,29
1739703352894,BENG 234,A00,805365,Silva; Gabriel,22,0,70,48
1739703353922,BENG 235,A00,805366,Bintu; Bogdan,18,0,40,22
1739703354948,BENG 276,A00,805367,Mc Culloch; Andrew Douglas,0,0,0,0
1739703355974,BENG 280C,A01,805370,McVeigh; Elliot R.,37,0,56,19
1739703356999,BENG 281,A00,805371,Smarr; Benjamin,40,0,110,70
1739703358024,BENG 283,A00,805372,Ghassemian; Majid & Sanchez Roige; Alexandra & Chavez; Alejandro,5,0,5,0
1739703359048,BENG 285,A00,805374,Alexandrov; Ludmil B,8,0,8,0
1739703360077,BENG 292,A01,805387,Ross; Camille,20,0,20,0
1739703361103,BENG 294C,A00,805396,Engler; Adam J.,0,0,0,0
1739703362130,BENG 295,A00,803924,Watson; John Thomas,9999,0,9999,0
1739703363153,BGGN 205,A00,851551,Daugherty; Matthew Dorton,53,0,60,7
1739703364181,BGGN 207,A01,851553,Ross; Camille,0,0,0,0
1739703365205,BGGN 215,A00,851554,Petrie; Katherine Lynn,0,0,30,30
1739703366229,BGGN 232,A00,851556,Briggs; Steven & Troemel; Emily Ruth,0,0,30,30
1739703367258,BGGN 239,A01,851558,Kronenberg; Mitchell E.,22,0,30,8
1739703368283,BGGN 240,A01,851560,Aoi; Mikio C,1,0,5,4
1739703368283,BGGN 240,A02,851561,Aoi; Mikio C,5,0,5,0
1739703368283,BGGN 240,A03,851562,Aoi; Mikio C,2,0,5,3
1739703368283,BGGN 240,A04,851564,Aoi; Mikio C,4,0,5,1
1739703369309,BGGN 249C,A00,851566,Miller; Cory T.,0,0,0,0
1739703370336,BGGN 255,A00,851567,Root; Cory Matthew,9,0,30,21
1739703371362,BGGN 267,A01,851569,Benna; Marcus K & Aljadeff; Johnatan,0,0,2,2
1739703371362,BGGN 267,A02,851570,Benna; Marcus K & Aljadeff; Johnatan,2,0,2,0
1739703371362,BGGN 267,A03,851571,Benna; Marcus K & Aljadeff; Johnatan,1,0,1,0
1739703371362,BGGN 267,A04,851572,Benna; Marcus K & Aljadeff; Johnatan,1,0,1,0
1739703372405,BGGN 271,001,881551,Ackerman; Susan,9999,0,9999,0
1739703372405,BGGN 271,002,881552,Akbari; Omar Sultan,9997,0,9999,2
1739703372405,BGGN 271,003,881553,Allen; Nicola J,9998,0,9999,1
1739703372405,BGGN 271,004,881554,Alperin; Mariann,9998,0,9999,1
1739703372405,BGGN 271,005,881555,Antal; Corina Elena,9999,0,9999,0
1739703372405,BGGN 271,006,881561,Boss; Gerard R.,9998,0,9999,1
1739703372405,BGGN 271,007,881562,Bouvet; Michael,9999,0,9999,0
1739703372405,BGGN 271,008,881563,Breen; Ellen C.,9999,0,9999,0
1739703372405,BGGN 271,009,881564,Bui; Jack D,9999,0,9999,0
1739703372405,BGGN 271,010,881565,Burnett; Lindsey,9998,0,9999,1
1739703372405,BGGN 271,011,881566,Caffrey; Conor,9998,0,9999,1
1739703372405,BGGN 271,012,881567,Castle; Michael James,9998,0,9999,1
1739703372405,BGGN 271,013,881568,Chang; John Tzu-yu,9999,0,9999,0
1739703372405,BGGN 271,014,881569,Cheng; Christine Shiang-Ling,9999,0,9999,0
1739703372405,BGGN 271,015,881612,Cheresh; David A.,9997,0,9999,2
1739703372405,BGGN 271,016,881616,Cherqui; Stephanie,9999,0,9999,0
1739703372405,BGGN 271,017,881620,Chu; Hiutung,9998,0,9999,1
1739703372405,BGGN 271,018,881627,Church; Kellie Breen,9999,0,9999,0
1739703372405,BGGN 271,019,881637,Cleland; Elsa Eleanor,9998,0,9999,1
1739703372405,BGGN 271,020,881638,Croker; Ben Adam,9999,0,9999,0
1739703372405,BGGN 271,021,881639,Crotty Alexander; Laura E,9997,0,9999,2
1739703372405,BGGN 271,022,881640,Daugherty; Matthew Dorton,9999,0,9999,0
1739703372405,BGGN 271,023,881641,De Silva; Shermin,9998,0,9999,1
1739703372405,BGGN 271,024,881642,Dhar; Debanjan,9999,0,9999,0
1739703372405,BGGN 271,025,881643,Doherty; Taylor Alan,9998,0,9999,1
1739703372405,BGGN 271,026,881644,Dore; Kim Bohemie,9998,0,9999,1
1739703372405,BGGN 271,027,881645,Dulawa; Stephanie Carole,9999,0,9999,0
1739703372405,BGGN 271,028,881646,Farley; Emma Kristen,9998,0,9999,1
1739703372405,BGGN 271,029,881647,Feng; Gen-Sheng,9998,0,9999,1
1739703372405,BGGN 271,030,881648,Fisch; Kathleen Marie,9995,0,9999,4
1739703372405,BGGN 271,031,881649,George; Olivier,9998,0,9999,1
1739703372405,BGGN 271,032,881650,Ghosh; Pradipta,9998,0,9999,1
1739703372405,BGGN 271,033,881651,Glasgow; Stacey Marie,9997,0,9999,2
1739703372405,BGGN 271,034,881652,Golden; James W,9999,0,9999,0
1739703372405,BGGN 271,035,881653,Gonzalez Gamboa; Ivonne,9999,0,9999,0
1739703372405,BGGN 271,036,881654,Goren; Alon M,9999,0,9999,0
1739703372405,BGGN 271,037,881655,Guatelli; John C,9998,0,9999,1
1739703372405,BGGN 271,038,881656,Guma; Monica,9999,0,9999,0
1739703372405,BGGN 271,039,881657,Gustafsson; Asa Birgitta,9998,0,9999,1
1739703372405,BGGN 271,040,881658,Hamdoun; Amr,9999,0,9999,0
1739703372405,BGGN 271,041,881659,Hao; Nan,9999,0,9999,0
1739703372405,BGGN 271,042,881660,Hasty; Jeff M,9998,0,9999,1
1739703372405,BGGN 271,043,881661,Jiang; Qingfei,9999,0,9999,0
1739703372405,BGGN 271,044,881664,Jin; Yishi,9998,0,9999,1
1739703372405,BGGN 271,045,881665,Joiner; William J.,9999,0,9999,0
1739703372405,BGGN 271,046,881666,Joshi; Shweta,9998,0,9999,1
1739703372405,BGGN 271,047,881667,Ju; Won-Kyu,9998,0,9999,1
1739703372405,BGGN 271,048,881668,Jun; Suckjoon,9999,0,9999,0
1739703372405,BGGN 271,049,881669,Kaech; Susan Michelle,9999,0,9999,0
1739703372405,BGGN 271,050,881670,Kauffman; Alexander,9997,0,9999,2
1739703372405,BGGN 271,051,881672,Koloski; Miranda Jane,9998,0,9999,1
1739703372405,BGGN 271,052,881673,Komiyama; Takaki,9998,0,9999,1
1739703372405,BGGN 271,053,881674,Kronenberg; Mitchell E.,9999,0,9999,0
1739703372405,BGGN 271,054,881675,Kufareva; Irina,9998,0,9999,1
1739703372405,BGGN 271,055,881676,Lee; Yun Sok,9999,0,9999,0
1739703372405,BGGN 271,056,881677,Leutgeb; Stefan,9999,0,9999,0
1739703372405,BGGN 271,057,881678,Li; Willis Xiaowei,9998,0,9999,1
1739703372405,BGGN 271,058,881679,Lim; Byungkook,9999,0,9999,0
1739703372405,BGGN 271,059,881680,Lo; Stanley M.,9998,0,9999,1
1739703372405,BGGN 271,060,881681,Lopez Ramirez; Miguel Alej,9999,0,9999,0
1739703372405,BGGN 271,061,881740,Lu; Li-Fan,9999,0,9999,0
1739703372405,BGGN 271,062,881741,Lu; Pengzhe,9998,0,9999,1
1739703372405,BGGN 271,063,881743,Lyons; Deirdre Colleen,9998,0,9999,1
1739703372405,BGGN 271,064,881744,Lyumkis; Dmitry Evgenievich,9999,0,9999,0
1739703372405,BGGN 271,065,881746,McConville; Patrick James,9999,0,9999,0
1739703372405,BGGN 271,066,881749,Mertens; Jerome Stefan,9997,0,9999,2
1739703372405,BGGN 271,067,881751,Morris; Gerald P,9999,0,9999,0
1739703372405,BGGN 271,068,881752,Muroyama; Andrew David,9999,0,9999,0
1739703372405,BGGN 271,069,881757,Murre; Cornelis,9999,0,9999,0
1739703372405,BGGN 271,070,881758,Nieh; James Charles,9997,0,9999,2
1739703372405,BGGN 271,071,881759,Niwa; Maho,9999,0,9999,0
1739703372405,BGGN 271,072,881760,Parast; Mana,9999,0,9999,0
1739703372405,BGGN 271,073,881761,Perry; Michael William,9999,0,9999,0
1739703372405,BGGN 271,074,881762,Pillus; Lorraine,9998,0,9999,1
1739703372405,BGGN 271,075,881765,Pogliano; Joseph,9998,0,9999,1
1739703372405,BGGN 271,076,881767,Pruneda-Paz; Jose L.,9999,0,9999,0
1739703372405,BGGN 271,077,881768,Rana; Tariq,9999,0,9999,0
1739703372405,BGGN 271,078,881769,Rao; Anjana,9999,0,9999,0
1739703372405,BGGN 271,079,881771,Raz; Eyal,9998,0,9999,1
1739703372405,BGGN 271,080,881772,Ren; Bing,9999,0,9999,0
1739703372405,BGGN 271,081,881775,Rifkin; Scott,9998,0,9999,1
1739703372405,BGGN 271,082,881777,Risbrough; Victoria Blythe,9999,0,9999,0
1739703372405,BGGN 271,083,881778,Rose; Noah Hartmann,9999,0,9999,0
1739703372405,BGGN 271,084,881779,Saier; Milton H.,9998,0,9999,1
1739703372405,BGGN 271,085,881781,Saltiel; Alan,9997,0,9999,2
1739703372405,BGGN 271,086,881782,Sanchez-Lopez; Elsa,9998,0,9999,1
1739703372405,BGGN 271,087,881784,Schroeder; Julian I,9999,0,9999,0
1739703372405,BGGN 271,088,881794,Sebat; Lilia Mikhailovna,9998,0,9999,1
1739703372405,BGGN 271,089,881796,Sen; George L,9999,0,9999,0
1739703372405,BGGN 271,090,881797,Shaner; Nathan C.,9999,0,9999,0
1739703372405,BGGN 271,091,881804,Shurin; Jonathan,9998,0,9999,1
1739703372405,BGGN 271,092,881819,Sicklick; Jason Keith,9999,0,9999,0
1739703372405,BGGN 271,093,881908,Signer; Robert,9999,0,9999,0
1739703372405,BGGN 271,094,881909,Simonson; Tatum Sasha Summ,9999,0,9999,0
1739703372405,BGGN 271,095,881923,Steinmetz; Nicole F,9999,0,9999,0
1739703372405,BGGN 271,096,881924,Su; Chih-Ying,9999,0,9999,0
1739703372405,BGGN 271,097,881936,Telese; Francesca,9999,0,9999,0
1739703372405,BGGN 271,098,881955,Towers; Christina Garlingt,9998,0,9999,1
1739703372405,BGGN 271,099,881956,Wahlin; Karl Jonas,9997,0,9999,2
1739703372405,BGGN 271,100,882046,Webster; Nicholas J G,9998,0,9999,1
1739703372405,BGGN 271,101,882047,Weiskopf; Daniela,9999,0,9999,0
1739703372405,BGGN 271,102,882130,Welsbie; Derek,9999,0,9999,0
1739703372405,BGGN 271,103,882167,Wildonger; Jill Cathleen,9999,0,9999,0
1739703372405,BGGN 271,104,882168,Yeo; Eugene Wei-Ming,9998,0,9999,1
1739703372405,BGGN 271,105,882175,Ying; Wei,9998,0,9999,1
1739703372405,BGGN 271,106,882196,Young; Jared W.,9998,0,9999,1
1739703372405,BGGN 271,107,882235,Zage; Peter,9999,0,9999,0
1739703372405,BGGN 271,108,882236,Zengler; Karsten B,9999,0,9999,0
1739703372405,BGGN 271,109,882237,Zhang; Jin,9999,0,9999,0
1739703372405,BGGN 271,110,882238,Zhao; Yunde,9999,0,9999,0
1739703372405,BGGN 271,111,882239,Zheng; Ye,9998,0,9999,1
1739703372405,BGGN 271,112,882288,Zhou; Huilin,9999,0,9999,0
1739703372405,BGGN 271,113,882289,Zou; Yimin,9998,0,9999,1
1739703372405,BGGN 271,114,882290,Zuniga; Elina I,9999,0,9999,0
1739703373434,BGGN 273,A01,851574,Mueller; Liam O'Connor,13,0,50,37
1739703374463,BGGN 275,A00,851577,Flagg; Matthew Paul,0,0,0,5
1739703375489,BGGN 276,A00,851578,Flagg; Matthew Paul,0,0,0,5
1739703376514,BGGN 292,A00,851579,Shiau; Andrew K,35,0,35,0
1739703377539,BGGN 293,A00,851580,Wilhelm; James E.,0,0,0,5
1739703378567,BGGN 295,A00,851581,Juavinett; Ashley Lauren,0,0,30,30
1739703379591,BGJC 204,A00,851584,Lu; Li-Fan & Chang; John Tzu-yu,9991,0,9999,8
1739703380638,BGRD 200,001,883698,Ackerman; Susan,9999,0,9999,0
1739703380638,BGRD 200,002,883700,Akbari; Omar Sultan,9998,0,9999,1
1739703380638,BGRD 200,003,883710,Allen; Eric,9999,0,9999,0
1739703380638,BGRD 200,004,883736,Allen; Nicola J,9998,0,9999,1
1739703380638,BGRD 200,005,883737,Alperin; Mariann,9998,0,9999,1
1739703380638,BGRD 200,006,883765,Amaro; Rommie E,9999,0,9999,0
1739703380638,BGRD 200,007,883766,Antal; Corina Elena,9999,0,9999,0
1739703380638,BGRD 200,008,883827,Asahina; Kenta,9999,0,9999,0
1739703380638,BGRD 200,009,883879,Augustine; Vineet,9999,0,9999,0
1739703380638,BGRD 200,010,883881,Ayres; Janelle Samantha,9998,0,9999,1
1739703380638,BGRD 200,011,883883,Banghart; Matthew Ryan,9999,0,9999,0
1739703380638,BGRD 200,012,883884,Barton; Andrew David,9999,0,9999,0
1739703380638,BGRD 200,013,883886,Benna; Marcus K,9999,0,9999,0
1739703380638,BGRD 200,014,883887,Bennett; Eric J,9998,0,9999,1
1739703380638,BGRD 200,015,883888,Biering; Scott B,9999,0,9999,0
1739703380638,BGRD 200,016,883890,Bloodgood; Brenda Laurie,9999,0,9999,0
1739703380638,BGRD 200,017,883891,Boss; Gerard R.,9999,0,9999,0
1739703380638,BGRD 200,018,883893,Bouvet; Michael,9999,0,9999,0
1739703380638,BGRD 200,019,883894,Breen; Ellen C.,9999,0,9999,0
1739703380638,BGRD 200,020,883895,Briggs; Steven,9999,0,9999,0
1739703380638,BGRD 200,021,883896,Bui; Jack D,9999,0,9999,0
1739703380638,BGRD 200,022,883897,Burnett; Lindsey,9998,0,9999,1
1739703380638,BGRD 200,023,883899,Caffrey; Conor,9998,0,9999,1
1739703380638,BGRD 200,024,883908,Callaway; Edward M,9999,0,9999,0
1739703380638,BGRD 200,025,883911,Castle; Michael James,9999,0,9999,0
1739703380638,BGRD 200,026,883915,Chaim; Isaac,9998,0,9999,1
1739703380638,BGRD 200,027,883916,Chang; John Tzu-yu,9999,0,9999,0
1739703380638,BGRD 200,028,883917,Chen; Xu,9999,0,9999,0
1739703380638,BGRD 200,029,883919,Cheng; Christine Shiang-Ling,9999,0,9999,0
1739703380638,BGRD 200,030,883921,Cheresh; David A.,9997,0,9999,2
1739703380638,BGRD 200,031,883924,Cherqui; Stephanie,9999,0,9999,0
1739703380638,BGRD 200,032,883929,Chu; Hiutung,9998,0,9999,1
1739703380638,BGRD 200,033,883931,Church; Kellie Breen,9999,0,9999,0
1739703380638,BGRD 200,034,883933,Cleland; Elsa Eleanor,9998,0,9999,1
1739703380638,BGRD 200,035,883934,Cooper; Kimberly Lynn,9999,0,9999,0
1739703380638,BGRD 200,036,883935,Coufal; Nicole Gabriele,9999,0,9999,0
1739703380638,BGRD 200,037,883938,Croker; Ben Adam,9999,0,9999,0
1739703380638,BGRD 200,038,883939,Crotty Alexander; Laura E,9997,0,9999,2
1739703380638,BGRD 200,039,883940,Daugherty; Matthew Dorton,9999,0,9999,0
1739703380638,BGRD 200,040,883941,De Silva; Shermin,9998,0,9999,1
1739703380638,BGRD 200,041,883946,Desai; Arshad,9999,0,9999,0
1739703380638,BGRD 200,042,883949,Dhar; Debanjan,9999,0,9999,0
1739703380638,BGRD 200,043,883993,Dickinson; Alexandra Jazz,9999,0,9999,0
1739703380638,BGRD 200,044,884003,Dixon; Jesse,9999,0,9999,0
1739703380638,BGRD 200,045,884008,Doherty; Taylor Alan,9998,0,9999,1
1739703380638,BGRD 200,046,884028,Dore; Kim Bohemie,9998,0,9999,1
1739703380638,BGRD 200,047,884082,Dulawa; Stephanie Carole,9999,0,9999,0
1739703380638,BGRD 200,048,884084,Ecker; Joseph R,9999,0,9999,0
1739703380638,BGRD 200,049,884107,Engle; Dannielle D,9999,0,9999,0
1739703380638,BGRD 200,050,884337,Ernst; Andreas,9999,0,9999,0
1739703380638,BGRD 200,051,884338,Esko; Jeffrey D.,9999,0,9999,0
1739703380638,BGRD 200,052,884339,Farley; Emma Kristen,9998,0,9999,1
1739703380638,BGRD 200,053,884340,Feldstein; Ariel E,9999,0,9999,0
1739703380638,BGRD 200,054,884341,Feng; Gen-Sheng,9998,0,9999,1
1739703380638,BGRD 200,055,884342,Fisch; Kathleen Marie,9995,0,9999,4
1739703380638,BGRD 200,056,884343,Friedman; Rick Adam,9999,0,9999,0
1739703380638,BGRD 200,057,884344,Furnari; Frank,9999,0,9999,0
1739703380638,BGRD 200,058,884345,Gage; Fred H,9999,0,9999,0
1739703380638,BGRD 200,059,884346,George; Olivier,9998,0,9999,1
1739703380638,BGRD 200,060,884347,Ghosh; Pradipta,9998,0,9999,1
1739703380638,BGRD 200,061,884348,Glasgow; Stacey Marie,9997,0,9999,2
1739703380638,BGRD 200,062,884349,Glass; Christopher,9999,0,9999,0
1739703380638,BGRD 200,063,884350,Golden; James W,9999,0,9999,0
1739703380638,BGRD 200,064,884352,Golden; Susan S.,9999,0,9999,0
1739703380638,BGRD 200,065,884354,Gonzalez Gamboa; Ivonne,9999,0,9999,0
1739703380638,BGRD 200,066,884355,Goren; Alon M,9999,0,9999,0
1739703380638,BGRD 200,067,884356,Guatelli; John C,9998,0,9999,1
1739703380638,BGRD 200,068,884357,Guma; Monica,9999,0,9999,0
1739703380638,BGRD 200,069,884360,Gustafsson; Asa Birgitta,9998,0,9999,1
1739703380638,BGRD 200,070,884361,Gutkind; Jorge Silvio,9999,0,9999,0
1739703380638,BGRD 200,071,884362,Hamdoun; Amr,9999,0,9999,0
1739703380638,BGRD 200,072,884364,Hampton; Randolph Y.,9999,0,9999,0
1739703380638,BGRD 200,073,884367,Hao; Nan,9999,0,9999,0
1739703380638,BGRD 200,074,884368,Hargreaves; Diana Clare,9999,0,9999,0
1739703380638,BGRD 200,075,884369,Hasty; Jeff M,9998,0,9999,1
1739703380638,BGRD 200,076,884370,Hollern; Daniel Patrick,9999,0,9999,0
1739703380638,BGRD 200,077,884372,Holway; David A.,9999,0,9999,0
1739703380638,BGRD 200,078,884374,Huffaker; Alisa,9999,0,9999,0
1739703380638,BGRD 200,079,884375,Hui; Enfu,9999,0,9999,0
1739703380638,BGRD 200,080,884376,Hwa; Terence T.,9999,0,9999,0
1739703380638,BGRD 200,081,884377,Ideker; Trey,9999,0,9999,0
1739703380638,BGRD 200,082,884378,Jackrel; Sara,9998,0,9999,1
1739703380638,BGRD 200,083,884380,Jiang; Qingfei,9999,0,9999,0
1739703380638,BGRD 200,084,884382,Jin; Yishi,9998,0,9999,1
1739703380638,BGRD 200,085,884384,Joiner; William J.,9999,0,9999,0
1739703380638,BGRD 200,086,884385,Joshi; Shweta,9998,0,9999,1
1739703380638,BGRD 200,087,884386,Ju; Won-Kyu,9998,0,9999,1
1739703380638,BGRD 200,088,884387,Jun; Suckjoon,9999,0,9999,0
1739703380638,BGRD 200,089,884388,Kadonaga; James T,9999,0,9999,0
1739703380638,BGRD 200,090,884389,Kaech; Susan Michelle,9999,0,9999,0
1739703380638,BGRD 200,091,884391,Kauffman; Alexander,9997,0,9999,2
1739703380638,BGRD 200,092,884392,Kleinfeld; David,9999,0,9999,0
1739703380638,BGRD 200,093,884393,Knight; Robin,9999,0,9999,0
1739703380638,BGRD 200,094,884394,Koloski; Miranda Jane,9998,0,9999,1
1739703380638,BGRD 200,095,884395,Komiyama; Takaki,9998,0,9999,1
1739703380638,BGRD 200,096,884396,Kosuri; Pallav,9999,0,9999,0
1739703380638,BGRD 200,097,884397,Kronenberg; Mitchell E.,9999,0,9999,0
1739703380638,BGRD 200,099,884400,Kryazhimskiy; Sergey A,9999,0,9999,0
1739703380638,BGRD 200,100,884401,Kufareva; Irina,9998,0,9999,1
1739703380638,BGRD 200,101,884402,Lee; Kuo Fen,9999,0,9999,0
1739703380638,BGRD 200,102,884403,Lee; Yun Sok,9999,0,9999,0
1739703380638,BGRD 200,103,884404,Leutgeb; Jill K.,9999,0,9999,0
1739703380638,BGRD 200,104,884405,Leutgeb; Stefan,9999,0,9999,0
1739703380638,BGRD 200,105,884406,Li; Willis Xiaowei,9998,0,9999,1
1739703380638,BGRD 200,106,884407,Lim; Byungkook,9998,0,9999,1
1739703380638,BGRD 200,107,884410,Lo; Stanley M.,9998,0,9999,1
1739703380638,BGRD 200,108,884414,Looger; Loren Lee,9999,0,9999,0
1739703380638,BGRD 200,109,884415,Lopez Ramirez; Miguel Alej,9999,0,9999,0
1739703380638,BGRD 200,110,884416,Lovett-Barron; Matthew Rod,9999,0,9999,0
1739703380638,BGRD 200,111,884418,Lu; Li-Fan,9998,0,9999,1
1739703380638,BGRD 200,112,884419,Lu; Pengzhe,9998,0,9999,1
1739703380638,BGRD 200,113,884421,Lykke-Andersen; Jens,9999,0,9999,0
1739703380638,BGRD 200,114,884423,Lyons; Deirdre Colleen,9998,0,9999,1
1739703380638,BGRD 200,115,884424,Lyumkis; Dmitry Evgenievich,9999,0,9999,0
1739703380638,BGRD 200,116,884425,Manor; Uri,9999,0,9999,0
1739703380638,BGRD 200,117,884426,Mayfield; Stephen P.,9998,0,9999,1
1739703380638,BGRD 200,118,884427,McConville; Patrick James,9999,0,9999,0
1739703380638,BGRD 200,119,884428,McDonnell; Lisa Marie,9999,0,9999,0
1739703380638,BGRD 200,120,884429,Mertens; Jerome Stefan,9997,0,9999,2
1739703380638,BGRD 200,121,884430,Meyer; Justin Raymond,9999,0,9999,0
1739703380638,BGRD 200,122,884431,Morris; Gerald P,9999,0,9999,0
1739703380638,BGRD 200,123,884432,Mueller; Lena,9999,0,9999,0
1739703380638,BGRD 200,124,884433,Muotri; Alysson,9999,0,9999,0
1739703380638,BGRD 200,125,884434,Muroyama; Andrew David,9997,0,9999,2
1739703380638,BGRD 200,126,884435,Murre; Cornelis,9999,0,9999,0
1739703380638,BGRD 200,127,884436,Neal; Sonya E,9999,0,9999,0
1739703380638,BGRD 200,128,884438,Nieh; James Charles,9997,0,9999,2
1739703380638,BGRD 200,129,884441,Nimmerjahn; Axel,9999,0,9999,0
1739703380638,BGRD 200,130,884444,Niwa; Maho,9999,0,9999,0
1739703380638,BGRD 200,131,884445,Nizet; Victor F.,9998,0,9999,1
1739703380638,BGRD 200,132,884446,Oegema; Karen,9999,0,9999,0
1739703380638,BGRD 200,133,884447,Panda; Satchidananda,9999,0,9999,0
1739703380638,BGRD 200,134,884448,Parast; Mana,9999,0,9999,0
1739703380638,BGRD 200,135,884449,Pasquinelli; Amy,9998,0,9999,1
1739703380638,BGRD 200,136,884450,Pekkurnaz Banghart; Gulcin,9999,0,9999,0
1739703380638,BGRD 200,137,884451,Perry; Michael William,9999,0,9999,0
1739703380638,BGRD 200,138,884452,Pillus; Lorraine,9998,0,9999,1
1739703380638,BGRD 200,139,884454,Pogliano; Joseph,9998,0,9999,1
1739703380638,BGRD 200,140,884456,Pogliano; Kit J.,9999,0,9999,0
1739703380638,BGRD 200,141,884457,Pride; David Tevis,9999,0,9999,0
1739703380638,BGRD 200,142,884458,Pruneda-Paz; Jose L.,9999,0,9999,0
1739703380638,BGRD 200,143,884459,Ramanan; Deepshika,9998,0,9999,1
1739703380638,BGRD 200,144,884460,Rana; Tariq,9999,0,9999,0
1739703380638,BGRD 200,145,884461,Rao; Anjana,9999,0,9999,0
1739703380638,BGRD 200,146,884462,Raz; Eyal,9998,0,9999,1
1739703380638,BGRD 200,147,884464,Reck-Peterson; Samara L,9999,0,9999,0
1739703380638,BGRD 200,148,884468,Ren; Bing,9999,0,9999,0
1739703380638,BGRD 200,149,884469,Rennison; Diana,9999,0,9999,0
1739703380638,BGRD 200,150,884471,Reyes De Barboza; Nabora S,9999,0,9999,0
1739703380638,BGRD 200,151,884472,Rifkin; Scott,9998,0,9999,1
1739703380638,BGRD 200,152,884482,Risbrough; Victoria Blythe,9999,0,9999,0
1739703380638,BGRD 200,153,884484,Rivera; Fabian Chavez,9999,0,9999,0
1739703380638,BGRD 200,154,884486,Rohner; Patrick Thomas,9999,0,9999,0
1739703380638,BGRD 200,155,884488,Rose; Noah Hartmann,9999,0,9999,0
1739703380638,BGRD 200,156,884491,Rosenfeld; Michael G,9999,0,9999,0
1739703380638,BGRD 200,157,884493,Russell; Alistair B,9999,0,9999,0
1739703380638,BGRD 200,158,884494,Saier; Milton H.,9998,0,9999,1
1739703380638,BGRD 200,159,884496,Saltiel; Alan,9997,0,9999,2
1739703380638,BGRD 200,160,884498,Sanchez-Lopez; Elsa,9999,0,9999,0
1739703380638,BGRD 200,161,884502,Saphire; Erica Ollmann,9999,0,9999,0
1739703380638,BGRD 200,162,884504,Schroeder; Julian I,9999,0,9999,0
1739703380638,BGRD 200,163,884508,Sebat; Lilia Mikhailovna,9998,0,9999,1
1739703380638,BGRD 200,164,884510,Sen; George L,9999,0,9999,0
1739703380638,BGRD 200,165,884513,Shah; Sameer B,9999,0,9999,0
1739703380638,BGRD 200,166,884515,Shaner; Nathan C.,9999,0,9999,0
1739703380638,BGRD 200,167,884517,Sharpee; Tatyana,9999,0,9999,0
1739703380638,BGRD 200,168,884519,Shaw; Reuben,9998,0,9999,1
1739703380638,BGRD 200,169,884522,Shurin; Jonathan,9998,0,9999,1
1739703380638,BGRD 200,170,884524,Sicklick; Jason Keith,9999,0,9999,0
1739703380638,BGRD 200,171,884526,Signer; Robert,9999,0,9999,0
1739703380638,BGRD 200,172,884530,Simonson; Tatum Sasha Summ,9999,0,9999,0
1739703380638,BGRD 200,173,884533,Soncin; Francesca,9999,0,9999,0
1739703380638,BGRD 200,174,884535,Steinmetz; Nicole F,9999,0,9999,0
1739703380638,BGRD 200,175,884536,Su; Chih-Ying,9999,0,9999,0
1739703380638,BGRD 200,176,884537,Suel; Gurol Mehmet,9999,0,9999,0
1739703380638,BGRD 200,177,884538,Sun; Xin,9999,0,9999,0
1739703380638,BGRD 200,178,884540,Telese; Francesca,9999,0,9999,0
1739703380638,BGRD 200,179,884543,Towers; Christina Garlingt,9998,0,9999,1
1739703380638,BGRD 200,180,884544,Traver; David,9999,0,9999,0
1739703380638,BGRD 200,181,884545,Troemel; Emily Ruth,9999,0,9999,0
1739703380638,BGRD 200,182,884546,Valdez-Jasso; Daniela,9999,0,9999,0
1739703380638,BGRD 200,183,884549,Vijayanand; Pandurangan,9999,0,9999,0
1739703380638,BGRD 200,184,884552,Villa Rodriguez; Elizabeth,9999,0,9999,0
1739703380638,BGRD 200,185,884553,Wahlin; Karl Jonas,9997,0,9999,2
1739703380638,BGRD 200,186,884555,Wang; Jean Yin Jen,9998,0,9999,1
1739703380638,BGRD 200,187,884556,Webster; Nicholas J G,9998,0,9999,1
1739703380638,BGRD 200,188,884557,Welsbie; Derek,9999,0,9999,0
1739703380638,BGRD 200,189,884600,Wildonger; Jill Cathleen,9998,0,9999,1
1739703380638,BGRD 200,190,884644,Winzeler; Elizabeth A,9998,0,9999,1
1739703380638,BGRD 200,191,884686,Yaksh; Tony L.,9999,0,9999,0
1739703380638,BGRD 200,192,884695,Yelon; Deborah,9999,0,9999,0
1739703380638,BGRD 200,193,884698,Yeo; Eugene Wei-Ming,9998,0,9999,1
1739703380638,BGRD 200,194,884706,Ying; Wei,9998,0,9999,1
1739703380638,BGRD 200,195,884707,Young; Jared W.,9998,0,9999,1
1739703380638,BGRD 200,196,884737,Zage; Peter,9999,0,9999,0
1739703380638,BGRD 200,197,884740,Zengler; Karsten B,9999,0,9999,0
1739703380638,BGRD 200,198,884749,Zhang; Dong-Er,9999,0,9999,0
1739703380638,BGRD 200,199,884750,Zhang; Jin,9999,0,9999,0
1739703380638,BGRD 200,200,884751,Zhao; Yunde,9999,0,9999,0
1739703380638,BGRD 200,201,884766,Zheng; Binhai,9999,0,9999,0
1739703380638,BGRD 200,202,884774,Zheng; Ye,9998,0,9999,1
1739703380638,BGRD 200,203,884849,Zhou; Huilin,9999,0,9999,0
1739703380638,BGRD 200,204,884894,Zou; Yimin,9998,0,9999,1
1739703380638,BGRD 200,205,884895,Zuniga; Elina I,9999,0,9999,0
1739703381665,BGSE 200,A00,851586,Tour; Ella & Petrie; Katherine Lynn,9989,0,9999,10
1739703382690,BGSE 205,A00,851588,Bennett; Eric J,46,0,50,4
1739703382690,BGSE 205,C00,851589,Bennett; Eric J,43,0,50,7
1739703382690,BGSE 205,D00,851590,Bennett; Eric J,48,0,50,2
1739703382690,BGSE 205,E00,851591,Bennett; Eric J,49,0,50,1
1739703383720,BIBC 102,A01,864157,Hampton; Randolph Y.,48,0,73,25
1739703383720,BIBC 102,A02,864159,Hampton; Randolph Y.,66,0,73,7
1739703383720,BIBC 102,A03,864171,Hampton; Randolph Y.,69,0,73,4
1739703383720,BIBC 102,A04,864227,Hampton; Randolph Y.,63,0,73,10
1739703384746,BIBC 103,A01,850483,Coleman; Aaron B.,19,0,24,5
1739703384746,BIBC 103,A02,850484,Coleman; Aaron B.,24,0,24,0
1739703384746,BIBC 103,B01,850487,Coleman; Aaron B.,21,0,24,3
1739703384746,BIBC 103,B02,850489,Coleman; Aaron B.,24,0,24,0
1739703384746,BIBC 103,C01,850492,Burg; Michael,15,0,24,9
1739703384746,BIBC 103,C02,850493,Burg; Michael,23,0,24,1
1739703385775,BIBC 104,A01,850495,Zhao; Yunde,49,0,50,1
1739703385775,BIBC 104,A02,850496,Zhao; Yunde,50,0,50,0
1739703385775,BIBC 104,A03,850500,Zhao; Yunde,48,0,50,2
1739703385775,BIBC 104,A04,850501,Zhao; Yunde,48,0,50,2
1739703386799,BIBC 194,A00,850502,Ernst; Andreas,20,0,32,12
1739703386799,BIBC 194,B00,850503,Saier; Milton H.,21,0,32,11
1739703387827,BICD 100,A01,864248,Biering; Scott B,70,0,73,3
1739703387827,BICD 100,A02,864249,Biering; Scott B,72,0,73,1
1739703387827,BICD 100,A03,864274,Biering; Scott B,73,0,73,0
1739703387827,BICD 100,A04,864287,Biering; Scott B,70,0,73,3
1739703387827,BICD 100,B01,864290,Reinagel; Pam,70,0,73,3
1739703387827,BICD 100,B02,864291,Reinagel; Pam,72,0,73,1
1739703387827,BICD 100,B03,864294,Reinagel; Pam,72,0,73,1
1739703387827,BICD 100,B04,864299,Reinagel; Pam,73,0,73,0
1739703387827,BICD 100,C01,864303,Nguyen; Vu Quang,72,0,73,1
1739703387827,BICD 100,C02,864314,Nguyen; Vu Quang,71,0,73,2
1739703387827,BICD 100,C03,864347,Nguyen; Vu Quang,72,0,73,1
1739703387827,BICD 100,C04,864362,Nguyen; Vu Quang,73,0,73,0
1739703388852,BICD 110,A01,850512,Ernst; Andreas,42,0,73,31
1739703388852,BICD 110,A02,850513,Ernst; Andreas,53,0,73,20
1739703388852,BICD 110,A03,850516,Ernst; Andreas,61,0,73,12
1739703388852,BICD 110,A04,850518,Ernst; Andreas,53,0,73,20
1739703389879,BICD 123,A01,850521,Zhao; Yunde,29,0,36,7
1739703390907,BICD 140,A01,850561,Lu; Li-Fan,50,0,61,11
1739703390907,BICD 140,A02,850563,Lu; Li-Fan,57,0,61,4
1739703390907,BICD 140,A03,850569,Lu; Li-Fan,57,0,61,4
1739703390907,BICD 140,A04,850577,Lu; Li-Fan,60,0,62,2
1739703391937,BICD 158,A01,850601,Bier; Ethan,30,0,36,6
1739703391937,BICD 158,A02,850644,Bier; Ethan,32,0,36,4
1739703391937,BICD 158,A03,850655,Bier; Ethan,33,0,36,3
1739703391937,BICD 158,A04,850656,Bier; Ethan,36,0,37,1
1739703392962,BIEB 121,A00,850668,Butler; Shannon Rhey,25,0,32,7
1739703392962,BIEB 121,B00,850674,Butler; Shannon Rhey,21,0,32,11
1739703393987,BIEB 146,A01,850680,Petrie; Katherine Lynn,91,0,99,8
1739703393987,BIEB 146,A02,850682,Petrie; Katherine Lynn,81,0,99,18
1739703393987,BIEB 146,A03,850684,Petrie; Katherine Lynn,95,0,99,4
1739703393987,BIEB 146,A04,850687,Petrie; Katherine Lynn,94,0,98,4
1739703395013,BIEB 148,A01,850691,Rose; Noah Hartmann,25,0,36,11
1739703395013,BIEB 148,A02,850706,Rose; Noah Hartmann,33,0,36,3
1739703395013,BIEB 148,A03,850778,Rose; Noah Hartmann,34,0,36,2
1739703395013,BIEB 148,A04,850779,Rose; Noah Hartmann,24,0,36,12
1739703396039,BIEB 152,A01,850784,Wodarz; Dominik Franz Xave,70,0,75,5
1739703396039,BIEB 152,A02,850785,Wodarz; Dominik Franz Xave,73,0,75,2
1739703396039,BIEB 152,A03,850786,Wodarz; Dominik Franz Xave,69,0,75,6
1739703396039,BIEB 152,A04,850789,Wodarz; Dominik Franz Xave,68,0,75,7
1739703397068,BIEB 154,A01,850792,Stockwell; Sarah R,15,0,15,0
1739703397068,BIEB 154,A02,850795,Stockwell; Sarah R,14,0,15,1
1739703397068,BIEB 154,A03,850796,Stockwell; Sarah R,13,0,15,2
1739703397068,BIEB 154,A04,850854,Stockwell; Sarah R,15,0,15,0
1739703398094,BIEB 159,A00,850856,Jackrel; Sara,33,0,36,3
1739703399121,BIEB 164,A01,850859,De Silva; Shermin,47,0,50,3
1739703399121,BIEB 164,A02,850862,De Silva; Shermin,41,0,50,9
1739703399121,BIEB 164,A03,850863,De Silva; Shermin,45,0,50,5
1739703399121,BIEB 164,A04,850865,De Silva; Shermin,45,0,50,5
1739703400147,BILD 1,A01,860138,Patrick; Gentry,62,0,62,0
1739703400147,BILD 1,A02,860253,Patrick; Gentry,61,0,62,1
1739703400147,BILD 1,A03,860277,Patrick; Gentry,61,0,62,1
1739703400147,BILD 1,A04,860281,Patrick; Gentry,61,0,64,3
1739703400147,BILD 1,B01,860381,Gonzalez Gamboa; Ivonne,51,0,62,11
1739703400147,BILD 1,B02,860382,Gonzalez Gamboa; Ivonne,61,0,62,1
1739703400147,BILD 1,B03,860383,Gonzalez Gamboa; Ivonne,59,0,62,3
1739703400147,BILD 1,B04,860384,Gonzalez Gamboa; Ivonne,63,0,64,1
1739703400147,BILD 1,C01,860385,Cooper; Andrew Michael,61,0,62,1
1739703400147,BILD 1,C02,860386,Cooper; Andrew Michael,59,0,62,3
1739703400147,BILD 1,C03,860387,Cooper; Andrew Michael,62,0,62,0
1739703400147,BILD 1,C04,860388,Cooper; Andrew Michael,64,0,64,0
1739703401177,BILD 2,A01,860389,Reyes Gonzalez; Catalina,87,0,99,12
1739703401177,BILD 2,A02,860390,Reyes Gonzalez; Catalina,96,0,99,3
1739703401177,BILD 2,A03,860391,Reyes Gonzalez; Catalina,99,0,99,0
1739703401177,BILD 2,A04,860392,Reyes Gonzalez; Catalina,98,0,98,0
1739703402202,BILD 3,A01,860393,Stockwell; Sarah R,68,0,70,2
1739703402202,BILD 3,A02,860394,Stockwell; Sarah R,66,0,70,4
1739703402202,BILD 3,A03,860395,Stockwell; Sarah R,69,0,70,1
1739703402202,BILD 3,A04,860396,Stockwell; Sarah R,66,0,68,2
1739703402202,BILD 3,B01,860397,Hammond; LaTisha Marie,48,0,63,15
1739703402202,BILD 3,B02,860398,Hammond; LaTisha Marie,54,0,60,6
1739703402202,BILD 3,B03,860399,Hammond; LaTisha Marie,57,0,60,3
1739703402202,BILD 3,B04,860400,Hammond; LaTisha Marie,60,0,62,2
1739703402202,BILD 3,C01,860401,Hammond; LaTisha Marie,60,0,62,2
1739703402202,BILD 3,C02,860402,Hammond; LaTisha Marie,58,0,63,5
1739703402202,BILD 3,C03,860403,Hammond; LaTisha Marie,59,0,60,1
1739703402202,BILD 3,C04,860404,Hammond; LaTisha Marie,60,0,60,0
1739703403231,BILD 4,A01,850172,Ochoa Mikrut; Stacy Daniel,22,0,24,2
1739703403231,BILD 4,A02,850250,Ochoa Mikrut; Stacy Daniel,24,0,24,0
1739703403231,BILD 4,A03,850251,Ochoa Mikrut; Stacy Daniel,22,0,24,2
1739703403231,BILD 4,A04,850252,Ochoa Mikrut; Stacy Daniel,23,0,24,1
1739703403231,BILD 4,A05,850253,Ochoa Mikrut; Stacy Daniel,24,0,24,0
1739703403231,BILD 4,A06,850254,Ochoa Mikrut; Stacy Daniel,24,0,24,0
1739703403231,BILD 4,A07,850255,Ochoa Mikrut; Stacy Daniel,24,0,24,0
1739703403231,BILD 4,A08,850257,Ochoa Mikrut; Stacy Daniel,23,0,24,1
1739703403231,BILD 4,B01,850259,Reuther; Keefe,18,0,24,6
1739703403231,BILD 4,B02,850260,Reuther; Keefe,22,0,24,2
1739703403231,BILD 4,B03,850261,Reuther; Keefe,24,0,24,0
1739703403231,BILD 4,B04,850263,Reuther; Keefe,22,0,24,2
1739703403231,BILD 4,B05,850264,Reuther; Keefe,23,0,24,1
1739703403231,BILD 4,B06,850265,Reuther; Keefe,24,0,24,0
1739703403231,BILD 4,B07,850266,Reuther; Keefe,24,0,24,0
1739703403231,BILD 4,B08,850267,Reuther; Keefe,24,0,24,0
1739703403231,BILD 4,C01,850269,Gonzalez Gamboa; Ivonne,19,0,24,5
1739703403231,BILD 4,C02,850270,Gonzalez Gamboa; Ivonne,24,0,24,0
1739703403231,BILD 4,C03,850271,Gonzalez Gamboa; Ivonne,24,0,24,0
1739703403231,BILD 4,C04,850273,Gonzalez Gamboa; Ivonne,24,0,24,0
1739703403231,BILD 4,C05,850283,Gonzalez Gamboa; Ivonne,23,0,24,1
1739703403231,BILD 4,C06,850329,Gonzalez Gamboa; Ivonne,23,0,24,1
1739703403231,BILD 4,C07,850331,Gonzalez Gamboa; Ivonne,24,0,24,0
1739703403231,BILD 4,C08,850336,Gonzalez Gamboa; Ivonne,23,0,24,1
1739703404262,BILD 5,A01,860586,Reuther; Keefe,63,0,65,2
1739703404262,BILD 5,A02,860597,Reuther; Keefe,62,0,65,3
1739703404262,BILD 5,A03,860600,Reuther; Keefe,65,0,65,0
1739703404262,BILD 5,A04,860672,Reuther; Keefe,64,0,65,1
1739703404262,BILD 5,B01,860673,Yang; Mingyu,65,0,65,0
1739703404262,BILD 5,B02,860681,Yang; Mingyu,64,0,65,1
1739703404262,BILD 5,B03,860686,Yang; Mingyu,65,0,65,0
1739703404262,BILD 5,B04,860687,Yang; Mingyu,65,0,65,0
1739703404262,BILD 5,C01,860694,Day; Christopher D,62,0,65,3
1739703404262,BILD 5,C02,860697,Day; Christopher D,65,0,65,0
1739703404262,BILD 5,C03,860709,Day; Christopher D,63,0,65,2
1739703404262,BILD 5,C04,860714,Day; Christopher D,65,0,65,0
1739703405288,BILD 30,A01,850343,Madigan; Cressida Ariana,28,0,28,0
1739703405288,BILD 30,A02,850344,Madigan; Cressida Ariana,28,0,28,0
1739703405288,BILD 30,A03,850345,Madigan; Cressida Ariana,26,0,28,2
1739703405288,BILD 30,A04,850349,Madigan; Cressida Ariana,30,0,31,1
1739703406312,BILD 88,A00,850480,Kurle; Carolyn M.,20,0,20,0
1739703407343,BIMM 100,A01,860726,Farley; Emma Kristen,35,0,48,13
1739703407343,BIMM 100,A02,860737,Farley; Emma Kristen,43,0,48,5
1739703407343,BIMM 100,A03,860771,Farley; Emma Kristen,46,0,48,2
1739703407343,BIMM 100,A04,860812,Farley; Emma Kristen,45,0,48,3
1739703407343,BIMM 100,B01,860817,Wildonger; Jill Cathleen,35,0,48,13
1739703407343,BIMM 100,B02,860838,Wildonger; Jill Cathleen,38,0,48,10
1739703407343,BIMM 100,B03,860839,Wildonger; Jill Cathleen,44,0,48,4
1739703407343,BIMM 100,B04,860840,Wildonger; Jill Cathleen,46,0,48,2
1739703408378,BIMM 101,A01,850871,Meaders; Clara Leigh,0,0,24,24
1739703408378,BIMM 101,A02,850872,Meaders; Clara Leigh,1,0,24,23
1739703408378,BIMM 101,B01,850876,Day; Christopher D,23,0,24,1
1739703408378,BIMM 101,B02,850877,Day; Christopher D,22,0,24,2
1739703408378,BIMM 101,C01,850880,Cooper; Andrew Michael,17,0,24,7
1739703408378,BIMM 101,C02,850887,Cooper; Andrew Michael,22,0,24,2
1739703408378,BIMM 101,D01,850890,Grossman; Emily N,19,0,24,5
1739703408378,BIMM 101,D02,850894,Grossman; Emily N,20,0,24,4
1739703408378,BIMM 101,E01,850897,Grossman; Emily N,19,0,24,5
1739703408378,BIMM 101,E02,850900,Grossman; Emily N,22,0,24,2
1739703408378,BIMM 101,F01,850906,Rusert; Jessica Marie,21,0,24,3
1739703408378,BIMM 101,F02,850910,Rusert; Jessica Marie,24,0,24,0
1739703408378,BIMM 101,G01,850920,Rusert; Jessica Marie,20,0,24,4
1739703408378,BIMM 101,G02,850921,Rusert; Jessica Marie,24,0,24,0
1739703409408,BIMM 118,A01,850923,David; Michael,26,0,29,3
1739703409408,BIMM 118,A02,850926,David; Michael,27,0,29,2
1739703409408,BIMM 118,A03,850927,David; Michael,25,0,29,4
1739703409408,BIMM 118,A04,850928,David; Michael,27,0,28,1
1739703410436,BIMM 120,A01,850932,Saier; Milton H.,78,0,87,9
1739703410436,BIMM 120,A02,850934,Saier; Milton H.,71,0,87,16
1739703410436,BIMM 120,A03,850986,Saier; Milton H.,81,0,87,6
1739703410436,BIMM 120,A04,851000,Saier; Milton H.,84,0,87,3
1739703411522,BIMM 121,A01,851020,Gustafson-Brown; Cindy,18,0,24,6
1739703411522,BIMM 121,A02,851023,Gustafson-Brown; Cindy,23,0,24,1
1739703411522,BIMM 121,B01,851032,Gustafson-Brown; Cindy,15,0,24,9
1739703411522,BIMM 121,B02,851058,Gustafson-Brown; Cindy,19,0,24,5
1739703411522,BIMM 121,C01,851077,Staff,2,0,24,22
1739703411522,BIMM 121,C02,851081,Staff,19,0,24,5
1739703411522,BIMM 121,D01,851152,Staff,15,0,24,9
1739703411522,BIMM 121,D02,851169,Staff,23,0,24,1
1739703412550,BIMM 134,A01,851210,Burg; Michael,94,0,103,9
1739703412550,BIMM 134,A02,851211,Burg; Michael,93,0,103,10
1739703412550,BIMM 134,A03,851212,Burg; Michael,93,0,103,10
1739703412550,BIMM 134,A04,851213,Burg; Michael,96,0,101,5
1739703413579,BIMM 143,A01,851215,Grant; Barry J,28,0,40,12
1739703413579,BIMM 143,B01,851218,Bozinovic; Goran,38,0,40,2
1739703413579,BIMM 143,C01,851220,Bozinovic; Goran,40,0,40,0
1739703414621,BIMM 182,A01,851597,Bafna; Vineet,31,0,50,19
1739703415647,BIMM 194,A00,851222,Russell; Alistair B,23,0,32,9
1739703416675,BIOM 202,A01,806511,Sheikh; Farah,21,0,40,19
1739703417701,BIOM 218,A00,806606,Gagneux; Pascal,10,0,12,2
1739703418725,BIOM 219,A00,806612,Ross; Camille,1,0,1,0
1739703419749,BIOM 222,A00,872553,Esko; Jeffrey D.,0,0,0,0
1739703420774,BIOM 229,A00,806613,Gagneux; Pascal,12,0,12,0
1739703421799,BIOM 231,A00,881485,Daneman; Richard & Newton; Alexandra C.,0,0,0,0
1739703421799,BIOM 231,B00,881487,Staff,0,0,0,0
1739703421799,BIOM 231,C00,881488,Schoeneberg; Johannes,0,0,0,0
1739703422823,BIOM 234,A00,881480,Newton; Alexandra C.,0,0,0,0
1739703423848,BIOM 242,A00,806624,Hamilton; Bruce Alan,0,0,0,0
1739703424877,BIOM 246,A00,872559,Gordts; Philip & Lewis; Amanda Lark & Godula; Kamil & Gagneux; Pascal & Esko; Jeffrey D. & Bode; Lars,0,0,0,0
1739703425908,BIOM 252,A00,806625,Ayyagari; Radha,7,0,20,13
1739703426932,BIOM 283,A00,806628,Ghassemian; Majid,0,0,0,0
1739703427958,BIOM 295,A00,806638,Joiner; William J.,0,0,0,0
1739703428986,BIPN 100,A01,860405,Augustine; Vineet,32,0,36,4
1739703428986,BIPN 100,A02,860406,Augustine; Vineet,35,0,36,1
1739703428986,BIPN 100,A03,860407,Augustine; Vineet,35,0,36,1
1739703428986,BIPN 100,A04,860408,Augustine; Vineet,36,0,37,1
1739703428986,BIPN 100,B01,860409,George; Monique Leana,27,0,36,9
1739703428986,BIPN 100,B02,860410,George; Monique Leana,33,0,36,3
1739703428986,BIPN 100,B03,860411,George; Monique Leana,31,0,36,5
1739703428986,BIPN 100,B04,860412,George; Monique Leana,31,0,37,6
1739703428986,BIPN 100,C01,860413,Maita; Isabella Vincenza,36,0,36,0
1739703428986,BIPN 100,C02,860414,Maita; Isabella Vincenza,35,0,36,1
1739703428986,BIPN 100,C03,860415,Maita; Isabella Vincenza,33,0,36,3
1739703428986,BIPN 100,C04,860416,Maita; Isabella Vincenza,36,0,37,1
1739703428986,BIPN 100,D01,860417,Marino; Marc J,47,0,50,3
1739703428986,BIPN 100,D02,860418,Marino; Marc J,48,0,50,2
1739703428986,BIPN 100,D03,860419,Marino; Marc J,48,0,50,2
1739703428986,BIPN 100,D04,860420,Marino; Marc J,50,0,50,0
1739703428986,BIPN 100,E01,860421,Yang; Mingyu,36,0,36,0
1739703428986,BIPN 100,E02,860422,Yang; Mingyu,34,0,36,2
1739703428986,BIPN 100,E03,860423,Yang; Mingyu,36,0,36,0
1739703428986,BIPN 100,E04,860424,Yang; Mingyu,37,0,37,0
1739703430016,BIPN 102,A01,851476,Reyes Gonzalez; Catalina,45,0,54,9
1739703430016,BIPN 102,A02,851477,Reyes Gonzalez; Catalina,48,0,54,6
1739703430016,BIPN 102,A03,851478,Reyes Gonzalez; Catalina,53,0,54,1
1739703430016,BIPN 102,A04,851479,Reyes Gonzalez; Catalina,51,0,54,3
1739703431042,BIPN 105,A01,851482,Armour; Jon Christopher,13,0,21,8
1739703431042,BIPN 105,A02,851483,Armour; Jon Christopher,20,0,21,1
1739703431042,BIPN 105,B01,851487,Armour; Jon Christopher,10,0,21,11
1739703431042,BIPN 105,B02,851488,Armour; Jon Christopher,20,0,21,1
1739703432071,BIPN 140,A01,851492,Owens; Melinda Tsao-Ying,37,0,40,3
1739703432071,BIPN 140,A02,851493,Owens; Melinda Tsao-Ying,38,0,40,2
1739703432071,BIPN 140,A03,851494,Owens; Melinda Tsao-Ying,39,0,40,1
1739703432071,BIPN 140,A04,851495,Owens; Melinda Tsao-Ying,32,0,38,6
1739703433097,BIPN 144,A01,851498,Zou; Yimin,35,0,40,5
1739703433097,BIPN 144,A02,851499,Zou; Yimin,35,0,40,5
1739703433097,BIPN 144,A03,851500,Zou; Yimin,40,0,40,0
1739703433097,BIPN 144,A04,851501,Zou; Yimin,37,0,38,1
1739703434123,BIPN 145,A01,851505,Maita; Isabella Vincenza,33,0,42,9
1739703434123,BIPN 145,B01,851507,Juavinett; Ashley Lauren,36,0,42,6
1739703434123,BIPN 145,C01,851512,Marino; Marc J,34,0,42,8
1739703435155,BIPN 147,A01,851516,Sejnowski; Terrence J,5,0,16,11
1739703435155,BIPN 147,A02,851517,Sejnowski; Terrence J,16,0,16,0
1739703435155,BIPN 147,A03,851520,Sejnowski; Terrence J,13,0,16,3
1739703435155,BIPN 147,A04,851521,Sejnowski; Terrence J,14,0,16,2
1739703436184,BIPN 152,A01,860841,Halpain; Shelley,32,0,44,12
1739703436184,BIPN 152,A02,860842,Halpain; Shelley,43,0,44,1
1739703436184,BIPN 152,A03,860843,Halpain; Shelley,42,0,44,2
1739703436184,BIPN 152,A04,860844,Halpain; Shelley,40,0,43,3
1739703437209,BIPN 162,A01,851524,Aoi; Mikio C,7,0,8,1
1739703437209,BIPN 162,A02,851525,Aoi; Mikio C,7,0,8,1
1739703437209,BIPN 162,A03,851527,Aoi; Mikio C,6,0,8,2
1739703437209,BIPN 162,A04,851529,Aoi; Mikio C,6,0,6,0
1739703438235,BIPN 164,A01,851531,Benna; Marcus K & Aljadeff; Johnatan,13,0,14,1
1739703438235,BIPN 164,A02,851532,Benna; Marcus K & Aljadeff; Johnatan,13,0,14,1
1739703438235,BIPN 164,A03,851533,Benna; Marcus K & Aljadeff; Johnatan,13,0,14,1
1739703438235,BIPN 164,A04,851535,Benna; Marcus K & Aljadeff; Johnatan,12,0,12,0
1739703439261,BIPN 194,A00,851536,Glasgow; Stacey Marie,29,0,32,3
1739703439261,BIPN 194,B00,851537,Augustine; Vineet,28,0,32,4
1739703439261,BIPN 194,C00,851539,Reinagel; Pam,31,0,32,1
1739703440289,BISP 170,A00,851540,French; Kathleen Ann,28,0,30,2
1739703441313,BISP 182,A00,869152,Pogliano; Joseph,9999,0,9999,0
1739703442342,BISP 194,A00,851542,Greenspan; Ralph J.,10,0,32,22
1739703442342,BISP 194,B00,851543,Nguyen; Vu Quang,25,0,32,7
1739703442342,BISP 194,C00,869153,Patrick; Gentry,23,0,32,9
1739703443367,BNFO 281,A00,805637,Gaasterland; Theresa,94,0,100,6
1739703444392,BNFO 283,A00,805640,Chavez; Alejandro & D'Antonio; Matteo,48,0,50,2
1739703444392,BNFO 283,B00,805642,Carter; Hannah Kathryn & Sanchez Roige; Alexandra,47,0,50,3
1739703445418,BNFO 285,A00,805666,Alexandrov; Ludmil B,6,0,8,2
1739703446442,BNFO 294,A01,805680,Ross; Camille,49,0,50,1
1739703447491,CAT 3,A01,813335,Marchisotto; Jennifer Anne,16,0,16,0
1739703447491,CAT 3,A02,813336,Marchisotto; Jennifer Anne,16,0,16,0
1739703447491,CAT 3,A03,813341,Marchisotto; Jennifer Anne,8,0,16,8
1739703447491,CAT 3,A04,813343,Marchisotto; Jennifer Anne,12,0,16,4
1739703447491,CAT 3,A05,813345,Marchisotto; Jennifer Anne,16,0,16,0
1739703447491,CAT 3,A06,813346,Marchisotto; Jennifer Anne,12,0,16,4
1739703447491,CAT 3,A07,813347,Marchisotto; Jennifer Anne,15,0,16,1
1739703447491,CAT 3,A08,813349,Marchisotto; Jennifer Anne,15,0,16,1
1739703447491,CAT 3,A09,813350,Marchisotto; Jennifer Anne,16,0,16,0
1739703447491,CAT 3,A10,813365,Marchisotto; Jennifer Anne,15,0,16,1
1739703447491,CAT 3,A11,813366,Marchisotto; Jennifer Anne,5,0,16,11
1739703447491,CAT 3,A12,813384,Marchisotto; Jennifer Anne,16,0,16,0
1739703447491,CAT 3,A13,813385,Marchisotto; Jennifer Anne,16,0,16,0
1739703447491,CAT 3,A14,813434,Marchisotto; Jennifer Anne,15,0,16,1
1739703447491,CAT 3,B01,813444,Popko; Elizabeth Ashley,16,0,16,0
1739703447491,CAT 3,B02,813445,Popko; Elizabeth Ashley,12,0,16,4
1739703447491,CAT 3,B03,813464,Popko; Elizabeth Ashley,14,0,16,2
1739703447491,CAT 3,B04,813465,Popko; Elizabeth Ashley,7,0,16,9
1739703447491,CAT 3,B05,813466,Popko; Elizabeth Ashley,12,0,16,4
1739703447491,CAT 3,B06,813475,Popko; Elizabeth Ashley,13,0,16,3
1739703447491,CAT 3,B07,813531,Popko; Elizabeth Ashley,15,0,16,1
1739703447491,CAT 3,B08,813538,Popko; Elizabeth Ashley,15,0,16,1
1739703447491,CAT 3,B09,813539,Popko; Elizabeth Ashley,11,0,16,5
1739703447491,CAT 3,B10,813543,Popko; Elizabeth Ashley,12,0,16,4
1739703447491,CAT 3,B11,813545,Popko; Elizabeth Ashley,16,0,16,0
1739703447491,CAT 3,B12,813551,Popko; Elizabeth Ashley,16,0,16,0
1739703447491,CAT 3,B13,813552,Popko; Elizabeth Ashley,15,0,16,1
1739703447491,CAT 3,B14,813554,Popko; Elizabeth Ashley,16,0,16,0
1739703447491,CAT 3,B15,813556,Popko; Elizabeth Ashley,16,0,16,0
1739703447491,CAT 3,B16,813558,Popko; Elizabeth Ashley,16,0,16,0
1739703447491,CAT 3,C01,813564,Glaser; Amelia,15,0,16,1
1739703447491,CAT 3,C02,813578,Glaser; Amelia,13,0,16,3
1739703447491,CAT 3,C03,813602,Glaser; Amelia,4,0,16,12
1739703447491,CAT 3,C04,813604,Glaser; Amelia,3,0,16,13
1739703447491,CAT 3,C05,813606,Glaser; Amelia,14,0,16,2
1739703447491,CAT 3,C06,813607,Glaser; Amelia,14,0,16,2
1739703447491,CAT 3,C07,813609,Glaser; Amelia,14,0,16,2
1739703447491,CAT 3,C08,813611,Glaser; Amelia,16,0,16,0
1739703447491,CAT 3,C09,813613,Glaser; Amelia,15,0,16,1
1739703447491,CAT 3,C10,813614,Glaser; Amelia,13,0,16,3
1739703447491,CAT 3,C11,813617,Glaser; Amelia,14,0,16,2
1739703447491,CAT 3,C12,813618,Glaser; Amelia,16,0,16,0
1739703447491,CAT 3,C13,813622,Glaser; Amelia,15,0,16,1
1739703447491,CAT 3,C14,813623,Glaser; Amelia,15,0,16,1
1739703447491,CAT 3,D01,813625,Bigham; David Joseph,11,0,16,5
1739703447491,CAT 3,D02,813627,Bigham; David Joseph,8,0,16,8
1739703447491,CAT 3,D03,813632,Bigham; David Joseph,15,0,16,1
1739703447491,CAT 3,D04,813637,Bigham; David Joseph,15,0,16,1
1739703447491,CAT 3,D05,813641,Bigham; David Joseph,16,0,16,0
1739703447491,CAT 3,D06,813642,Bigham; David Joseph,15,0,16,1
1739703447491,CAT 3,D07,813644,Bigham; David Joseph,15,0,16,1
1739703447491,CAT 3,D08,813645,Bigham; David Joseph,15,0,16,1
1739703447491,CAT 3,D09,813648,Bigham; David Joseph,15,0,16,1
1739703447491,CAT 3,D10,813651,Bigham; David Joseph,16,0,16,0
1739703447491,CAT 3,D11,813654,Bigham; David Joseph,16,0,16,0
1739703447491,CAT 3,D12,813656,Bigham; David Joseph,16,0,16,0
1739703447491,CAT 3,D13,813657,Bigham; David Joseph,16,0,16,0
1739703447491,CAT 3,D14,813658,Bigham; David Joseph,16,0,16,0
1739703447491,CAT 3,D15,813662,Bigham; David Joseph,15,0,16,1
1739703447491,CAT 3,D16,813663,Bigham; David Joseph,16,0,16,0
1739703448517,CAT 3CE,A01,813665,Bronstein; Phoebe Malan,25,0,25,0
1739703449542,CAT 87,A00,813667,Bronstein; Phoebe Malan,20,0,20,0
1739703449542,CAT 87,B00,886854,Geibel; William,20,0,20,0
1739703450570,CAT 98,001,881482,Geibel; William,20,0,20,0
1739703451599,CAT 124,A01,813672,Geibel; William,20,0,20,0
1739703451599,CAT 124,B01,813675,Rose; Becca Rae,20,0,20,0
1739703452628,CAT 125,A00,813692,Marchisotto; Jennifer Anne,17,0,20,3
1739703452628,CAT 125,B00,813696,Bigham; David Joseph,18,0,20,2
1739703452628,CAT 125,C00,813698,Vanderschuit; Maya Alysia,20,0,20,0
1739703452628,CAT 125,D00,813700,Vanderschuit; Maya Alysia,20,0,20,0
1739703452628,CAT 125,E00,813703,Vanderschuit; Maya Alysia,20,0,20,0
1739703452628,CAT 125,F00,813711,Morales; Celeste Georgianna,19,0,20,1
1739703452628,CAT 125,G00,813714,Morales; Celeste Georgianna,18,0,20,2
1739703452628,CAT 125,H00,813717,Morales; Celeste Georgianna,20,0,20,0
1739703452628,CAT 125,I00,813720,Rose; Becca Rae,20,0,20,0
1739703452628,CAT 125,J00,813744,Rose; Becca Rae,19,0,20,1
1739703452628,CAT 125,K00,813761,Tosun; Adriana,18,0,20,2
1739703452628,CAT 125,L00,813762,Tosun; Adriana,19,0,20,1
1739703452628,CAT 125,M00,872512,Delaville; Romain,19,0,20,1
1739703452628,CAT 125,N00,872514,Irwin; Matthew Joseph,18,0,20,2
1739703452628,CAT 125,O00,872516,Irwin; Matthew Joseph,20,0,20,0
1739703452628,CAT 125,P00,872517,Irwin; Matthew Joseph,19,0,20,1
1739703453654,CAT 125R,A00,813763,Smith; Lauryn Alissa,17,0,20,3
1739703453654,CAT 125R,B00,813764,Smith; Lauryn Alissa,18,0,20,2
1739703453654,CAT 125R,C00,813765,Smith; Lauryn Alissa,20,0,20,0
1739703453654,CAT 125R,D00,813766,Hyland; Tina Mae,16,0,20,4
1739703453654,CAT 125R,E00,813767,Hyland; Tina Mae,15,0,20,5
1739703453654,CAT 125R,F00,813768,Hyland; Tina Mae,19,0,20,1
1739703453654,CAT 125R,G00,813769,Tosun; Adriana,17,0,20,3
1739703454684,CCE 1,A00,815913,Merryman; Ashley,39,0,40,1
1739703454684,CCE 1,D00,815916,Garcia; Kathryn Mary,39,0,40,1
1739703454684,CCE 1,E00,815918,Labat Ii; Michael Luis,36,0,40,4
1739703454684,CCE 1,F00,815919,Bigley; Michele Heather,39,0,40,1
1739703454684,CCE 1,G00,815921,Santos; Vabianna Daria,40,0,40,0
1739703454684,CCE 1,H00,815922,Lee; Kassandra,39,0,40,1
1739703455721,CCE 3,001,815923,Kenley; Nicole,15,0,20,5
1739703455721,CCE 3,002,815924,Quijada; David,19,0,20,1
1739703455721,CCE 3,003,815926,Crawford; James,20,0,20,0
1739703455721,CCE 3,004,815963,Williams; Danielle,20,0,20,0
1739703455721,CCE 3,005,815964,Merryman; Ashley,20,0,20,0
1739703455721,CCE 3,006,815965,Merryman; Ashley,20,0,20,0
1739703455721,CCE 3,007,815966,Lee; Kassandra,19,0,20,1
1739703455721,CCE 3,008,815967,Lee; Kassandra,20,0,20,0
1739703455721,CCE 3,009,816009,Garcia; Kathryn Mary,19,0,20,1
1739703455721,CCE 3,010,816011,Garcia; Kathryn Mary,19,0,20,1
1739703455721,CCE 3,011,816012,Labat Ii; Michael Luis,18,0,20,2
1739703455721,CCE 3,012,816013,Labat Ii; Michael Luis,20,0,20,0
1739703455721,CCE 3,013,816014,Bigley; Michele Heather,18,0,20,2
1739703455721,CCE 3,014,816015,Santos; Vabianna Daria,20,0,20,0
1739703455721,CCE 3,015,816016,Santos; Vabianna Daria,20,0,20,0
1739703455721,CCE 3,016,889148,Crawford; James,39,0,40,1
1739703456749,CENG 101B,A00,808970,Chen; Shaochen,50,0,50,0
1739703457774,CENG 101C,A00,808971,Li; Yanran,144,0,146,2
1739703458804,CENG 113,A00,808993,Li; Wan-Lu,67,0,70,3
1739703458804,CENG 113,B00,808994,Chen; Zheng,70,0,70,0
1739703459833,CENG 124B,A00,808995,Drews; Aaron,46,0,60,14
1739703459833,CENG 124B,B00,809012,Powell; Alyssa,51,0,60,9
1739703460858,CENG 160,A00,809013,Powell; Alyssa,65,0,70,5
1739703461883,CENG 170,A01,809059,Drews; Aaron,28,0,30,2
1739703462911,CENG 176B,A01,809097,Opatkiewicz; Justin Paul,55,0,60,5
1739703462911,CENG 176B,B01,809104,Shah; Nisarg,47,0,48,1
1739703463937,CENG 205,A00,809106,Jahed Motlagh; Zeinab,41,0,60,19
1739703464963,CENG 260,A00,809107,Powell; Alyssa,30,0,30,0
1739703465991,CENG 273,A00,809114,Shah; Nisarg,23,0,30,7
1739703467019,CGS 2B,A01,812749,Whitley; Leila Marie,23,0,25,2
1739703467019,CGS 2B,A02,812761,Whitley; Leila Marie,24,0,24,0
1739703468044,CGS 87,A00,812765,Wesling; Megan E.,20,0,20,0
1739703469069,CGS 100B,A00,812766,Whitley; Leila Marie,30,0,33,3
1739703470094,CGS 105,A01,812868,Wesling; Megan E.,22,0,23,1
1739703470094,CGS 105,A02,812869,Wesling; Megan E.,22,0,23,1
1739703470094,CGS 105,A03,812872,Wesling; Megan E.,23,0,23,0
1739703471119,CGS 106,A00,812873,Whitley; Leila Marie,46,0,50,4
1739703472144,CGS 112,A00,812902,Cuong; Marisol,30,0,30,0
1739703473168,CGS 114,A00,812906,Cuong; Marisol,20,0,22,2
1739703474194,CGS 117,A00,812907,Martin Sandino; Amanda Maria Yoland,13,0,16,3
1739703475220,CGS 120,A00,812908,Hankins; Joseph D.,21,0,22,1
1739703476248,CGS 121,A00,812916,Martin Sandino; Amanda Maria Yoland,20,0,20,0
1739703477273,CGS 122,A00,812917,Martin Sandino; Amanda Maria Yoland,19,0,20,1
1739703478298,CGS 147,A00,872913,Staff,20,0,20,0
1739703479327,CGS 196B,A00,812923,Taylor-Garcia; Daphne,0,0,0,0
1739703479327,CGS 196B,B00,812971,Hankins; Joseph D.,0,0,0,0
1739703479327,CGS 196B,C00,812978,Perez; Roy,0,0,0,0
1739703480357,CGS 198,001,812980,Anderson; Patrick W.,0,0,0,0
1739703480357,CGS 198,002,813054,Anderson; Patrick W.,0,0,0,0
1739703480357,CGS 198,003,813102,Anderson; Patrick W.,0,0,0,0
1739703480357,CGS 198,004,813257,Anderson; Patrick W.,0,0,0,0
1739703481381,CGS 200,A00,813286,Okonkwo; Holly,0,0,0,0
1739703482408,CHEM 6A,A01,860027,Lam; Tin Yiu,40,0,40,0
1739703482408,CHEM 6A,A02,860042,Lam; Tin Yiu,37,0,40,3
1739703482408,CHEM 6A,A03,860049,Lam; Tin Yiu,35,0,40,5
1739703482408,CHEM 6A,A04,860050,Lam; Tin Yiu,37,0,40,3
1739703482408,CHEM 6A,A05,860051,Lam; Tin Yiu,35,0,40,5
1739703482408,CHEM 6A,A06,860052,Lam; Tin Yiu,40,0,40,0
1739703482408,CHEM 6A,A07,860065,Lam; Tin Yiu,40,0,40,0
1739703482408,CHEM 6A,A08,860068,Lam; Tin Yiu,39,0,40,1
1739703483434,CHEM 6B,A01,859962,Lam; Tin Yiu,39,0,40,1
1739703483434,CHEM 6B,A02,859975,Lam; Tin Yiu,40,0,40,0
1739703483434,CHEM 6B,A03,859990,Lam; Tin Yiu,36,0,40,4
1739703483434,CHEM 6B,A04,859994,Lam; Tin Yiu,39,0,40,1
1739703483434,CHEM 6B,A05,859999,Lam; Tin Yiu,40,0,40,0
1739703483434,CHEM 6B,A06,860019,Lam; Tin Yiu,40,0,40,0
1739703483434,CHEM 6B,A07,860024,Lam; Tin Yiu,40,0,40,0
1739703483434,CHEM 6B,B01,861221,Zajac; Eva L,34,0,40,6
1739703483434,CHEM 6B,B02,861224,Zajac; Eva L,36,0,40,4
1739703483434,CHEM 6B,B03,861229,Zajac; Eva L,39,0,40,1
1739703483434,CHEM 6B,B04,861232,Zajac; Eva L,38,0,40,2
1739703483434,CHEM 6B,B05,861239,Zajac; Eva L,37,0,40,3
1739703483434,CHEM 6B,B06,861240,Zajac; Eva L,36,0,40,4
1739703483434,CHEM 6B,B07,861242,Zajac; Eva L,40,0,40,0
1739703484471,CHEM 6C,A01,861431,Hopkins; Patrycja Anna,35,0,40,5
1739703484471,CHEM 6C,A02,861466,Hopkins; Patrycja Anna,38,0,40,2
1739703484471,CHEM 6C,A03,861467,Hopkins; Patrycja Anna,40,0,40,0
1739703484471,CHEM 6C,A04,861530,Hopkins; Patrycja Anna,40,0,40,0
1739703484471,CHEM 6C,A05,861531,Hopkins; Patrycja Anna,38,0,40,2
1739703484471,CHEM 6C,A06,861622,Hopkins; Patrycja Anna,40,0,40,0
1739703484471,CHEM 6C,A07,861649,Hopkins; Patrycja Anna,39,0,40,1
1739703484471,CHEM 6C,A08,861650,Hopkins; Patrycja Anna,0,0,0,0
1739703484471,CHEM 6C,B01,861651,Zajac; Eva L,31,0,40,9
1739703484471,CHEM 6C,B02,861763,Zajac; Eva L,37,0,40,3
1739703484471,CHEM 6C,B03,861768,Zajac; Eva L,38,0,40,2
1739703484471,CHEM 6C,B04,861770,Zajac; Eva L,38,0,40,2
1739703484471,CHEM 6C,B05,861771,Zajac; Eva L,35,0,40,5
1739703484471,CHEM 6C,B06,861773,Zajac; Eva L,39,0,40,1
1739703484471,CHEM 6C,B07,861777,Zajac; Eva L,40,0,40,0
1739703484471,CHEM 6C,B08,861781,Zajac; Eva L,0,0,0,0
1739703484471,CHEM 6C,D01,859938,Stallings; Dontarie M,39,0,40,1
1739703484471,CHEM 6C,D02,859942,Stallings; Dontarie M,32,0,40,8
1739703484471,CHEM 6C,D03,859943,Stallings; Dontarie M,38,0,40,2
1739703484471,CHEM 6C,D04,859952,Stallings; Dontarie M,38,0,40,2
1739703484471,CHEM 6C,D05,859953,Stallings; Dontarie M,19,0,40,21
1739703484471,CHEM 6C,D06,859959,Stallings; Dontarie M,37,0,40,3
1739703484471,CHEM 6C,D07,859960,Stallings; Dontarie M,37,0,40,3
1739703484471,CHEM 6C,D08,859961,Stallings; Dontarie M,0,0,0,0
1739703484471,CHEM 6C,E01,861810,Debelouchina; Galia T,40,0,40,0
1739703484471,CHEM 6C,E02,861860,Debelouchina; Galia T,40,0,40,0
1739703484471,CHEM 6C,E03,861879,Debelouchina; Galia T,39,0,40,1
1739703484471,CHEM 6C,E04,861880,Debelouchina; Galia T,39,0,40,1
1739703484471,CHEM 6C,E05,861890,Debelouchina; Galia T,39,0,40,1
1739703484471,CHEM 6C,E06,861908,Debelouchina; Galia T,40,0,40,0
1739703484471,CHEM 6C,E07,861910,Debelouchina; Galia T,40,0,40,0
1739703484471,CHEM 6C,E08,861911,Debelouchina; Galia T,0,0,0,0
1739703485497,CHEM 6CH,A01,859928,Tezcan; Faik,39,0,40,1
1739703486524,CHEM 7L,A01,844470,Piercy; Marc Anthony,17,0,24,7
1739703486524,CHEM 7L,A02,844472,Piercy; Marc Anthony,21,0,24,3
1739703486524,CHEM 7L,A03,844473,Piercy; Marc Anthony,22,0,24,2
1739703486524,CHEM 7L,A04,844475,Piercy; Marc Anthony,24,0,24,0
1739703486524,CHEM 7L,A05,844476,Piercy; Marc Anthony,23,0,24,1
1739703486524,CHEM 7L,A06,844482,Piercy; Marc Anthony,22,0,24,2
1739703486524,CHEM 7L,A07,844490,Piercy; Marc Anthony,20,0,24,4
1739703486524,CHEM 7L,A08,844493,Piercy; Marc Anthony,24,0,24,0
1739703486524,CHEM 7L,A09,844496,Piercy; Marc Anthony,23,0,24,1
1739703486524,CHEM 7L,A10,844503,Piercy; Marc Anthony,24,0,24,0
1739703486524,CHEM 7L,B01,844506,Piercy; Marc Anthony,2,0,24,22
1739703486524,CHEM 7L,B02,844508,Piercy; Marc Anthony,23,0,24,1
1739703486524,CHEM 7L,B03,844661,Piercy; Marc Anthony,22,0,24,2
1739703486524,CHEM 7L,B04,844716,Piercy; Marc Anthony,24,0,24,0
1739703486524,CHEM 7L,B05,844717,Piercy; Marc Anthony,21,0,24,3
1739703486524,CHEM 7L,B06,844719,Piercy; Marc Anthony,22,0,24,2
1739703486524,CHEM 7L,B07,844841,Piercy; Marc Anthony,24,0,24,0
1739703486524,CHEM 7L,B08,845021,Piercy; Marc Anthony,23,0,24,1
1739703486524,CHEM 7L,B09,845022,Piercy; Marc Anthony,23,0,24,1
1739703486524,CHEM 7L,B10,845184,Piercy; Marc Anthony,24,0,24,0
1739703487550,CHEM 7LM,A01,845187,Leigh; Brian,24,0,24,0
1739703487550,CHEM 7LM,A02,845321,Leigh; Brian,21,0,21,0
1739703487550,CHEM 7LM,A03,845322,Leigh; Brian,24,0,24,0
1739703487550,CHEM 7LM,A04,845340,Leigh; Brian,19,0,21,2
1739703487550,CHEM 7LM,A05,845350,Leigh; Brian,23,0,24,1
1739703487550,CHEM 7LM,A06,845398,Leigh; Brian,21,0,21,0
1739703487550,CHEM 7LM,A07,845399,Leigh; Brian,18,0,24,6
1739703487550,CHEM 7LM,A08,845406,Leigh; Brian,20,0,21,1
1739703488574,CHEM 11,A01,861914,Albizati; Kim F.,37,0,40,3
1739703488574,CHEM 11,A02,861934,Albizati; Kim F.,38,0,40,2
1739703488574,CHEM 11,A03,861939,Albizati; Kim F.,40,0,40,0
1739703488574,CHEM 11,A04,861940,Albizati; Kim F.,40,0,40,0
1739703488574,CHEM 11,A05,861951,Albizati; Kim F.,36,0,40,4
1739703488574,CHEM 11,A06,861975,Albizati; Kim F.,40,0,40,0
1739703489604,CHEM 40A,A01,861976,Hopkins; Patrycja Anna,32,0,40,8
1739703489604,CHEM 40A,A02,861977,Hopkins; Patrycja Anna,36,0,40,4
1739703489604,CHEM 40A,A03,861978,Hopkins; Patrycja Anna,37,0,40,3
1739703489604,CHEM 40A,A04,862061,Hopkins; Patrycja Anna,38,0,40,2
1739703489604,CHEM 40A,A05,862062,Hopkins; Patrycja Anna,38,0,40,2
1739703489604,CHEM 40A,A06,862063,Hopkins; Patrycja Anna,37,0,40,3
1739703489604,CHEM 40A,A07,862064,Hopkins; Patrycja Anna,39,0,40,1
1739703489604,CHEM 40A,A08,862065,Hopkins; Patrycja Anna,37,0,40,3
1739703490633,CHEM 40B,A01,862066,Weizman; Haim,29,0,40,11
1739703490633,CHEM 40B,A02,862067,Weizman; Haim,38,0,40,2
1739703490633,CHEM 40B,A03,862077,Weizman; Haim,40,0,40,0
1739703490633,CHEM 40B,A04,862085,Weizman; Haim,37,0,40,3
1739703490633,CHEM 40B,A05,862086,Weizman; Haim,34,0,40,6
1739703490633,CHEM 40B,A06,862087,Weizman; Haim,40,0,40,0
1739703490633,CHEM 40B,A07,862088,Weizman; Haim,39,0,40,1
1739703490633,CHEM 40B,A08,862089,Weizman; Haim,0,0,0,0
1739703491662,CHEM 41B,A01,860069,Klosterman; Jeremy K,32,0,40,8
1739703491662,CHEM 41B,A02,860074,Klosterman; Jeremy K,38,0,40,2
1739703491662,CHEM 41B,A03,860081,Klosterman; Jeremy K,39,0,40,1
1739703492691,CHEM 41C,A01,862090,Romero; Nathan A,39,0,40,1
1739703492691,CHEM 41C,A02,862091,Romero; Nathan A,40,0,40,0
1739703492691,CHEM 41C,A03,862092,Romero; Nathan A,39,0,40,1
1739703492691,CHEM 41C,A04,862213,Romero; Nathan A,39,0,40,1
1739703492691,CHEM 41C,A05,862214,Romero; Nathan A,38,0,40,2
1739703492691,CHEM 41C,A06,862215,Romero; Nathan A,40,0,40,0
1739703492691,CHEM 41C,A07,862216,Romero; Nathan A,38,0,40,2
1739703493718,CHEM 43A,A01,845450,Ternansky; Robert J.,15,0,24,9
1739703493718,CHEM 43A,A02,845676,Ternansky; Robert J.,21,0,24,3
1739703493718,CHEM 43A,A03,845679,Ternansky; Robert J.,21,0,24,3
1739703493718,CHEM 43A,A04,845682,Ternansky; Robert J.,23,0,24,1
1739703493718,CHEM 43A,A05,845684,Ternansky; Robert J.,22,0,24,2
1739703493718,CHEM 43A,A06,845686,Ternansky; Robert J.,19,0,24,5
1739703493718,CHEM 43A,A07,845692,Ternansky; Robert J.,22,0,24,2
1739703493718,CHEM 43A,A08,845694,Ternansky; Robert J.,17,0,24,7
1739703493718,CHEM 43A,A09,845697,Ternansky; Robert J.,24,0,24,0
1739703493718,CHEM 43A,A10,845698,Ternansky; Robert J.,23,0,24,1
1739703493718,CHEM 43A,A11,845700,Ternansky; Robert J.,23,0,24,1
1739703493718,CHEM 43A,A12,845702,Ternansky; Robert J.,24,0,24,0
1739703493718,CHEM 43A,A13,845704,Ternansky; Robert J.,22,0,24,2
1739703493718,CHEM 43A,B01,845707,Ternansky; Robert J.,23,0,24,1
1739703493718,CHEM 43A,B02,845712,Ternansky; Robert J.,22,0,24,2
1739703493718,CHEM 43A,B03,845794,Ternansky; Robert J.,14,0,24,10
1739703493718,CHEM 43A,B04,845797,Ternansky; Robert J.,20,0,24,4
1739703493718,CHEM 43A,B05,845800,Ternansky; Robert J.,22,0,24,2
1739703493718,CHEM 43A,B06,845801,Ternansky; Robert J.,20,0,24,4
1739703493718,CHEM 43A,B07,845816,Ternansky; Robert J.,21,0,24,3
1739703493718,CHEM 43A,B08,845817,Ternansky; Robert J.,19,0,24,5
1739703493718,CHEM 43A,B09,845827,Ternansky; Robert J.,23,0,24,1
1739703493718,CHEM 43A,B10,845832,Ternansky; Robert J.,22,0,24,2
1739703493718,CHEM 43A,B11,845866,Ternansky; Robert J.,22,0,24,2
1739703493718,CHEM 43A,B12,845867,Ternansky; Robert J.,21,0,24,3
1739703494742,CHEM 96,A00,845868,Brydges; Stacey,18,0,20,2
1739703495767,CHEM 100A,A01,845921,Staff,0,0,0,0
1739703495767,CHEM 100A,A02,845922,Staff,0,0,0,0
1739703495767,CHEM 100A,A03,845983,Staff,0,0,0,0
1739703495767,CHEM 100A,A04,845984,Staff,0,0,0,0
1739703495767,CHEM 100A,A05,845985,Staff,0,0,0,0
1739703495767,CHEM 100A,A06,845986,Staff,0,0,0,0
1739703496795,CHEM 100B,A01,845988,Pomeroy; Robert S.,27,0,30,3
1739703497822,CHEM 105A,A01,845991,Young; Mark,33,0,40,7
1739703498849,CHEM 108,A01,845993,Mrse; Anthony Adrian,18,0,20,2
1739703498849,CHEM 108,A02,845994,Mrse; Anthony Adrian,18,0,24,6
1739703498849,CHEM 108,B01,845996,Mrse; Anthony Adrian,16,0,20,4
1739703498849,CHEM 108,B02,845997,Mrse; Anthony Adrian,23,0,24,1
1739703499878,CHEM 109,A01,845999,McHugh; Colleen A,11,0,20,9
1739703499878,CHEM 109,A02,846000,McHugh; Colleen A,24,0,24,0
1739703499878,CHEM 109,B01,846002,McHugh; Colleen A,18,0,20,2
1739703499878,CHEM 109,B02,846003,McHugh; Colleen A,23,0,24,1
1739703500904,CHEM 114B,A01,862223,Mishanina; Tatiana V,37,0,40,3
1739703500904,CHEM 114B,A02,862224,Mishanina; Tatiana V,40,0,40,0
1739703500904,CHEM 114B,A03,862225,Mishanina; Tatiana V,40,0,40,0
1739703501934,CHEM 114C,A01,859769,Joseph; Simpson,35,0,40,5
1739703501934,CHEM 114C,A02,859782,Joseph; Simpson,29,0,40,11
1739703501934,CHEM 114C,A03,859790,Joseph; Simpson,25,0,40,15
1739703501934,CHEM 114C,A04,859791,Joseph; Simpson,40,0,40,0
1739703501934,CHEM 114C,A05,859793,Joseph; Simpson,37,0,40,3
1739703501934,CHEM 114C,A06,859804,Joseph; Simpson,37,0,40,3
1739703501934,CHEM 114C,A07,859805,Joseph; Simpson,0,0,0,0
1739703501934,CHEM 114C,A08,859810,Joseph; Simpson,0,0,0,0
1739703502962,CHEM 114D,A00,846006,Ghosh; Gourisankar,19,0,25,6
1739703503988,CHEM 118,A01,862235,Donoghue; Daniel J.,28,0,40,12
1739703503988,CHEM 118,A02,862236,Donoghue; Daniel J.,38,0,40,2
1739703503988,CHEM 118,A03,862238,Donoghue; Daniel J.,28,0,40,12
1739703503988,CHEM 118,A04,862240,Donoghue; Daniel J.,39,0,40,1
1739703503988,CHEM 118,A05,862242,Donoghue; Daniel J.,39,0,40,1
1739703503988,CHEM 118,A06,862243,Donoghue; Daniel J.,39,0,40,1
1739703505014,CHEM 120B,A01,859811,Staff,32,0,40,8
1739703505014,CHEM 120B,A02,859812,Staff,39,0,40,1
1739703505014,CHEM 120B,A03,859813,Staff,0,0,0,0
1739703506040,CHEM 123,A00,846009,Schimpf; Alina M,0,0,0,2
1739703507066,CHEM 125,A00,846010,Tezcan; Faik,17,0,20,3
1739703508093,CHEM 126B,A01,859888,Tauber; Michael,27,0,40,13
1739703508093,CHEM 126B,A02,859927,Tauber; Michael,0,0,0,0
1739703509120,CHEM 132,A01,862270,Tauber; Michael,39,0,40,1
1739703509120,CHEM 132,A02,862271,Tauber; Michael,36,0,40,4
1739703510145,CHEM 135,A01,860846,Xiong; Wei,14,0,15,1
1739703511171,CHEM 143B,A01,846015,Klosterman; Jeremy K,20,0,24,4
1739703511171,CHEM 143B,A02,846016,Klosterman; Jeremy K,15,0,24,9
1739703512197,CHEM 156,A00,846017,Romero; Erik Anthony,29,0,30,1
1739703513222,CHEM 157,A00,846018,Tor; Yitzhak,74,0,80,6
1739703514248,CHEM 158,A00,846020,Molinski; Tadeusz,9,0,10,1
1739703515327,CHEM 167,A01,862285,Deshmukh; Lalit,36,0,40,4
1739703515327,CHEM 167,A02,862286,Deshmukh; Lalit,39,0,40,1
1739703515327,CHEM 167,A03,862287,Deshmukh; Lalit,37,0,40,3
1739703515327,CHEM 167,A04,862288,Deshmukh; Lalit,39,0,40,1
1739703516352,CHEM 173,A00,846023,Young; Mark,36,0,40,4
1739703517380,CHEM 174,A01,851594,Pomeroy; Robert S.,58,0,60,2
1739703518409,CHEM 185,A00,846025,Paesani; Francesco,21,0,26,5
1739703519436,CHEM 188,A00,846026,Brydges; Stacey,20,0,20,0
1739703520462,CHEM 207,A00,846088,Deshmukh; Lalit,23,0,30,7
1739703521486,CHEM 214,A00,846089,Ghosh; Gourisankar,5,0,15,10
1739703522512,CHEM 217,A00,846092,Joseph; Simpson,15,0,30,15
1739703523536,CHEM 225,A00,846095,Tezcan; Faik,5,0,10,5
1739703524563,CHEM 227,A00,846097,Schimpf; Alina M,30,0,30,0
1739703525588,CHEM 229,A00,846100,Stauber; Julia Megan,19,0,20,1
1739703526614,CHEM 235,A01,860847,Xiong; Wei,17,0,20,3
1739703527640,CHEM 236,A00,846106,Kummel; Andrew C,5,0,15,10
1739703528669,CHEM 237,A00,872555,Esko; Jeffrey D.,7,0,7,0
1739703529695,CHEM 250,A00,846107,Weizman; Haim,0,0,0,0
1739703530719,CHEM 256,A00,846108,Romero; Erik Anthony,20,0,20,0
1739703531744,CHEM 257,A00,846109,Tor; Yitzhak,28,0,30,2
1739703532771,CHEM 258,A00,846110,Molinski; Tadeusz,13,0,15,2
1739703533796,CHEM 262,A00,846111,Kubiak; Clifford Paul,26,0,30,4
1739703534829,CHEM 273,A00,846118,Young; Mark,15,0,20,5
1739703535853,CHEM 276,A00,846119,Mc Culloch; Andrew Douglas,4,0,5,1
1739703536879,CHEM 283,A00,846120,Ghassemian; Majid,10,0,10,0
1739703537904,CHEM 285,A00,846121,Paesani; Francesco,18,0,20,2
1739703538930,CHEM 291,A00,846122,Debelouchina; Galia T,20,0,20,0
1739703539956,CHEM 294,A00,846123,Pun; Andrew Brian,48,0,50,2
1739703540984,CHIN 10CD,A01,809156,Liu; Mingming,17,0,17,0
1739703540984,CHIN 10CD,A02,809192,Liu; Mingming,18,0,18,0
1739703542010,CHIN 10CM,A01,809196,Chen; Pei-Chia,15,0,15,0
1739703542010,CHIN 10CM,A02,809197,Chen; Pei-Chia,19,0,20,1
1739703543034,CHIN 10CN,A01,809203,Xu; Li,12,0,14,2
1739703543034,CHIN 10CN,A03,809218,Xu; Li,14,0,14,0
1739703543034,CHIN 10CN,B01,809296,Xu; Li,13,0,14,1
1739703543034,CHIN 10CN,B02,809307,Xu; Li,10,0,14,4
1739703543034,CHIN 10CN,B03,809361,Xu; Li,14,0,14,0
1739703544063,CHIN 20CM,A01,809437,Wang; Xiao,10,0,10,0
1739703544063,CHIN 20CM,A02,809458,Wang; Xiao,10,0,10,0
1739703545092,CHIN 20CN,A01,809462,Anderson; Qin-Hong,12,0,12,0
1739703545092,CHIN 20CN,A02,809463,Anderson; Qin-Hong,12,0,12,0
1739703545092,CHIN 20CN,A03,871383,Anderson; Qin-Hong,12,0,12,0
1739703545092,CHIN 20CN,B01,809488,Anderson; Qin-Hong,12,0,12,0
1739703546118,CHIN 100CM,A00,809489,Anderson; Qin-Hong,23,0,24,1
1739703547143,CHIN 100CN,A00,809490,Chen; Pei-Chia,24,0,24,0
1739703548168,CHIN 169B,A00,809720,Wang; Xiao,20,0,20,0
1739703549194,CHIN 182B,A00,809728,Liu; Mingming,17,0,20,3
1739703550221,CLAS 196B,A00,869154,Myerston Santana; Jacobo,1,0,1,0
1739703551250,CLIN 294C,A00,870690,Wierenga; Christina E & Banks; Sarah Jane,20,0,20,0
1739703552275,CLIN 296,001,870694,Brookman; Lauren Irene,100,0,100,0
1739703552275,CLIN 296,002,870695,Brookman; Lauren Irene,10,0,10,0
1739703552275,CLIN 296,003,870696,Wall; Tamara Lynn,100,0,100,0
1739703553301,CLRE 238R,A00,809924,Mehta; Ravindra L.,9999,0,9999,0
1739703554327,CLRE 254,A00,809952,Vaida; Florin,9999,0,9999,0
1739703555356,CLRE 255,A01,809989,Cuomo; Raphael Eduardo,9999,0,9999,0
1739703556382,CLRE 256,A01,810211,Morris; Sheldon,9999,0,9999,0
1739703557407,CLRE 257,A00,810214,Mehta; Ravindra L.,9999,0,9999,0
1739703558432,CLRE 258,A00,810216,Mehta; Ravindra L.,9999,0,9999,0
1739703559458,CLRE 260,A00,810217,Cuomo; Raphael Eduardo,9999,0,9999,0
1739703560483,CLRE 265,A00,810220,Vaida; Florin,9999,0,9999,0
1739703561511,CLRE 297,001,810222,Cuomo; Raphael Eduardo,9999,0,9999,0
1739703562539,CLX 87,A00,809115,Castro; Robert Jess,20,0,20,0
1739703563567,CMM 225,A00,872556,Esko; Jeffrey D.,7,0,7,0
1739703564594,CMM 246,A00,872560,Gordts; Philip & Lewis; Amanda Lark & Godula; Kamil & Gagneux; Pascal & Esko; Jeffrey D. & Bode; Lars,10,0,10,0
1739703565623,CMM 250,A00,884466,Willert; Karl Heinrich,60,0,60,0
1739703566649,COGR 201D,A00,808201,Serlin; David,10,0,10,0
1739703567676,COGR 219,A00,808207,Harb; Anthony Joseph,5,0,10,5
1739703568703,COGR 225B,A00,808212,Gere; Catherina M.,10,0,10,0
1739703569728,COGR 225C,A00,808214,McKenzie; Kerry V.,10,0,10,0
1739703570757,COGR 275,A00,808219,Jack; Caroline Sarah,8,0,10,2
1739703571782,COGR 296,A00,808221,Ybarra; Megan,5,0,5,0
1739703572811,COGS 1,A01,810294,Deak; Gedeon O.,58,0,60,2
1739703572811,COGS 1,A02,810296,Deak; Gedeon O.,57,0,60,3
1739703572811,COGS 1,A03,810298,Deak; Gedeon O.,56,0,60,4
1739703572811,COGS 1,A04,810299,Deak; Gedeon O.,57,0,60,3
1739703572811,COGS 1,A05,810300,Deak; Gedeon O.,60,0,60,0
1739703572811,COGS 1,A06,810301,Deak; Gedeon O.,59,0,60,1
1739703572811,COGS 1,A07,810302,Deak; Gedeon O.,57,0,57,0
1739703573836,COGS 2,A01,810304,Boyle; Mary E. T.,54,0,56,2
1739703573836,COGS 2,A02,810305,Boyle; Mary E. T.,56,0,56,0
1739703573836,COGS 2,A03,810307,Boyle; Mary E. T.,54,0,56,2
1739703573836,COGS 2,A04,810309,Boyle; Mary E. T.,57,0,60,3
1739703573836,COGS 2,A05,810310,Boyle; Mary E. T.,67,0,67,0
1739703574866,COGS 9,A01,810312,Shannon; Kyle Michael,49,0,50,1
1739703574866,COGS 9,A02,810313,Shannon; Kyle Michael,49,0,50,1
1739703574866,COGS 9,A03,810314,Shannon; Kyle Michael,49,0,50,1
1739703574866,COGS 9,A04,810316,Shannon; Kyle Michael,50,0,50,0
1739703574866,COGS 9,A05,810320,Shannon; Kyle Michael,50,0,50,0
1739703574866,COGS 9,A06,810321,Shannon; Kyle Michael,49,0,50,1
1739703575894,COGS 11,A01,810324,Boroditsky; Lera,134,0,140,6
1739703576922,COGS 13,A01,810328,Rossano; Federico,42,0,50,8
1739703576922,COGS 13,A02,810329,Rossano; Federico,48,0,49,1
1739703576922,COGS 13,A03,810330,Rossano; Federico,48,0,50,2
1739703576922,COGS 13,A04,810331,Rossano; Federico,48,0,49,1
1739703576922,COGS 13,A05,810332,Rossano; Federico,48,0,49,1
1739703576922,COGS 13,A06,810333,Rossano; Federico,49,0,49,0
1739703577951,COGS 14A,A01,810335,Barrera; Steven James,45,0,50,5
1739703577951,COGS 14A,A02,810336,Barrera; Steven James,47,0,50,3
1739703577951,COGS 14A,A03,810338,Barrera; Steven James,49,0,50,1
1739703577951,COGS 14A,A04,810339,Barrera; Steven James,56,0,60,4
1739703577951,COGS 14A,A05,810340,Barrera; Steven James,50,0,50,0
1739703577951,COGS 14A,A06,810341,Barrera; Steven James,50,0,50,0
1739703577951,COGS 14A,A07,810343,Barrera; Steven James,54,0,56,2
1739703578981,COGS 14B,A01,810346,Hoffman; Drew Ellen,54,0,57,3
1739703578981,COGS 14B,A02,810347,Hoffman; Drew Ellen,55,0,55,0
1739703578981,COGS 14B,A03,810348,Hoffman; Drew Ellen,52,0,55,3
1739703578981,COGS 14B,A04,810350,Hoffman; Drew Ellen,54,0,55,1
1739703578981,COGS 14B,A05,810351,Hoffman; Drew Ellen,53,0,55,2
1739703580006,COGS 17,A01,810353,Johnson; Christine M.,49,0,50,1
1739703580006,COGS 17,A02,810354,Johnson; Christine M.,48,0,50,2
1739703580006,COGS 17,A03,810356,Johnson; Christine M.,48,0,50,2
1739703580006,COGS 17,A04,810357,Johnson; Christine M.,47,0,50,3
1739703580006,COGS 17,A05,810359,Johnson; Christine M.,49,0,50,1
1739703580006,COGS 17,A06,810360,Johnson; Christine M.,50,0,50,0
1739703580006,COGS 17,A07,810361,Johnson; Christine M.,52,0,55,3
1739703580006,COGS 17,A08,810362,Johnson; Christine M.,54,0,55,1
1739703581032,COGS 18,A01,810366,Ellis; Shannon Elizabeth,31,0,35,4
1739703581032,COGS 18,A02,810367,Ellis; Shannon Elizabeth,31,0,35,4
1739703581032,COGS 18,A03,810371,Ellis; Shannon Elizabeth,30,0,35,5
1739703581032,COGS 18,A04,810372,Ellis; Shannon Elizabeth,34,0,35,1
1739703581032,COGS 18,A05,810373,Ellis; Shannon Elizabeth,32,0,35,3
1739703581032,COGS 18,A06,810374,Ellis; Shannon Elizabeth,35,0,35,0
1739703581032,COGS 18,A07,810375,Ellis; Shannon Elizabeth,35,0,35,0
1739703581032,COGS 18,A08,810376,Ellis; Shannon Elizabeth,34,0,35,1
1739703581032,COGS 18,A09,810377,Ellis; Shannon Elizabeth,35,0,35,0
1739703581032,COGS 18,B01,810379,Ellis; Shannon Elizabeth,33,0,35,2
1739703581032,COGS 18,B02,810384,Ellis; Shannon Elizabeth,34,0,35,1
1739703581032,COGS 18,B03,810385,Ellis; Shannon Elizabeth,34,0,35,1
1739703581032,COGS 18,B04,810388,Ellis; Shannon Elizabeth,34,0,35,1
1739703581032,COGS 18,B05,810389,Ellis; Shannon Elizabeth,31,0,35,4
1739703581032,COGS 18,B06,810390,Ellis; Shannon Elizabeth,31,0,35,4
1739703581032,COGS 18,B07,810392,Ellis; Shannon Elizabeth,34,0,35,1
1739703581032,COGS 18,B08,810393,Ellis; Shannon Elizabeth,34,0,35,1
1739703581032,COGS 18,B09,810395,Ellis; Shannon Elizabeth,32,0,35,3
1739703582057,COGS 87,A00,810426,Deak; Gedeon O.,20,0,20,0
1739703583082,COGS 100,A01,810564,Morgan; Eric,49,0,56,7
1739703583082,COGS 100,A02,810582,Morgan; Eric,54,0,56,2
1739703583082,COGS 100,A03,810589,Morgan; Eric,55,0,56,1
1739703583082,COGS 100,A04,810651,Morgan; Eric,54,0,56,2
1739703583082,COGS 100,A05,810684,Morgan; Eric,56,0,56,0
1739703583082,COGS 100,A06,810690,Morgan; Eric,54,0,56,2
1739703584111,COGS 101A,A01,810697,Morgan; Eric,49,0,50,1
1739703584111,COGS 101A,A02,810701,Morgan; Eric,49,0,50,1
1739703584111,COGS 101A,A03,810707,Morgan; Eric,49,0,50,1
1739703584111,COGS 101A,A04,810708,Morgan; Eric,50,0,50,0
1739703585138,COGS 101B,A01,810716,Barrera; Steven James,49,0,50,1
1739703585138,COGS 101B,A02,810718,Barrera; Steven James,45,0,50,5
1739703585138,COGS 101B,A03,810719,Barrera; Steven James,47,0,50,3
1739703585138,COGS 101B,A04,810730,Barrera; Steven James,38,0,50,12
1739703586168,COGS 101C,A01,810737,Cooperrider; Kensy A,50,0,50,0
1739703586168,COGS 101C,A02,810742,Cooperrider; Kensy A,43,0,50,7
1739703586168,COGS 101C,A03,810743,Cooperrider; Kensy A,48,0,50,2
1739703587196,COGS 102A,A01,810750,Allen; Michael Gordon,49,0,50,1
1739703587196,COGS 102A,A02,810751,Allen; Michael Gordon,50,0,50,0
1739703587196,COGS 102A,A03,810754,Allen; Michael Gordon,44,0,49,5
1739703588225,COGS 107A,A01,810756,Boyle; Mary E. T.,54,0,56,2
1739703588225,COGS 107A,A02,810757,Boyle; Mary E. T.,52,0,56,4
1739703588225,COGS 107A,A03,810760,Boyle; Mary E. T.,55,0,56,1
1739703588225,COGS 107A,A04,810767,Boyle; Mary E. T.,54,0,56,2
1739703588225,COGS 107A,A05,810769,Boyle; Mary E. T.,54,0,56,2
1739703588225,COGS 107A,A06,810777,Boyle; Mary E. T.,55,0,56,1
1739703589252,COGS 107B,A03,810800,Mooshagian; Eric Frederick,41,0,50,9
1739703589252,COGS 107B,A04,810810,Mooshagian; Eric Frederick,33,0,50,17
1739703589252,COGS 107B,A05,810811,Mooshagian; Eric Frederick,44,0,50,6
1739703590277,COGS 107C,A01,810815,Chiba; Andrea,41,0,47,6
1739703590277,COGS 107C,A02,810816,Chiba; Andrea,35,0,50,15
1739703590277,COGS 107C,A03,810853,Chiba; Andrea,44,0,49,5
1739703591308,COGS 108,A01,810862,Fleischer; Jason G,42,0,50,8
1739703591308,COGS 108,A02,810870,Fleischer; Jason G,42,0,50,8
1739703591308,COGS 108,A03,810871,Fleischer; Jason G,50,0,50,0
1739703591308,COGS 108,A04,810874,Fleischer; Jason G,49,0,50,1
1739703591308,COGS 108,A05,810876,Fleischer; Jason G,47,0,50,3
1739703591308,COGS 108,A06,810879,Fleischer; Jason G,48,0,50,2
1739703591308,COGS 108,A07,810896,Fleischer; Jason G,50,0,50,0
1739703591308,COGS 108,B01,810950,Fleischer; Jason G,54,0,56,2
1739703591308,COGS 108,B02,810960,Fleischer; Jason G,54,0,56,2
1739703591308,COGS 108,B03,810961,Fleischer; Jason G,52,0,56,4
1739703591308,COGS 108,B04,810962,Fleischer; Jason G,43,0,60,17
1739703591308,COGS 108,B05,810963,Fleischer; Jason G,58,0,60,2
1739703591308,COGS 108,B06,810964,Fleischer; Jason G,57,0,60,3
1739703591308,COGS 108,B07,810965,Fleischer; Jason G,62,0,62,0
1739703593360,COGS 112,A01,811001,Hoffman; Drew Ellen,33,0,50,17
1739703593360,COGS 112,A02,811020,Hoffman; Drew Ellen,42,0,50,8
1739703593360,COGS 112,A03,811045,Hoffman; Drew Ellen,44,0,50,6
1739703593360,COGS 112,A04,811047,Hoffman; Drew Ellen,49,0,50,1
1739703594387,COGS 124,A00,811065,Guo; Philip J,1,0,25,24
1739703595425,COGS 125,A00,811079,Klemmer; Scott R,43,0,50,7
1739703596454,COGS 142,A01,811081,Rossano; Federico,50,0,50,0
1739703597480,COGS 143,A01,811108,Staff,46,0,50,4
1739703598508,COGS 150,A01,811185,Trott; Sean Thomas,35,0,50,15
1739703598508,COGS 150,A02,811319,Trott; Sean Thomas,50,0,50,0
1739703598508,COGS 150,A03,811360,Trott; Sean Thomas,41,0,49,8
1739703599535,COGS 157,A00,811371,Creel; Sarah,66,0,75,9
1739703600566,COGS 160,A00,872440,Saygin; Ayse P,29,0,30,1
1739703600566,COGS 160,B00,872441,Saygin; Ayse P,30,0,30,0
1739703600566,COGS 160,C00,872442,Kirsh; David Joel,30,0,30,0
1739703601592,COGS 172,A01,811389,Greene; Deanna Jacquelyn,46,0,50,4
1739703601592,COGS 172,A02,811390,Greene; Deanna Jacquelyn,48,0,50,2
1739703601592,COGS 172,A03,811391,Greene; Deanna Jacquelyn,45,0,50,5
1739703601592,COGS 172,A04,811392,Greene; Deanna Jacquelyn,47,0,50,3
1739703603648,COGS 179,A01,811401,Staff,43,0,50,7
1739703604678,COGS 184,A01,811403,Johnson; Christine M.,46,0,50,4
1739703605702,COGS 185,A01,811514,Tu; Zhuowen,38,0,50,12
1739703605702,COGS 185,A02,811580,Tu; Zhuowen,46,0,50,4
1739703606730,COGS 187A,A01,811589,Allen; Michael Gordon,45,0,50,5
1739703606730,COGS 187A,A02,811590,Allen; Michael Gordon,46,0,50,4
1739703606730,COGS 187A,A03,811591,Allen; Michael Gordon,44,0,49,5
1739703607758,COGS 190C,001,811592,Chiba; Andrea,9999,0,9999,0
1739703607758,COGS 190C,002,811601,Fleischer; Jason G,9999,0,9999,0
1739703607758,COGS 190C,003,811602,Boyle; Mary E. T.,9999,0,9999,0
1739703607758,COGS 190C,004,811604,Nitz; Douglas A.,9999,0,9999,0
1739703607758,COGS 190C,005,811605,Rangel; Lara M,9999,0,9999,0
1739703607758,COGS 190C,006,811609,Hoffman; Drew Ellen,9999,0,9999,0
1739703607758,COGS 190C,007,811610,Deak; Gedeon O.,9999,0,9999,0
1739703607758,COGS 190C,008,811613,Kiyonaga; Anastasia,9999,0,9999,0
1739703607758,COGS 190C,009,811716,Creel; Sarah,9999,0,9999,0
1739703607758,COGS 190C,010,811733,Voytek; Bradley Thomas,9999,0,9999,0
1739703607758,COGS 190C,011,811836,Beatty-Martinez; Anne,9999,0,9999,0
1739703607758,COGS 190C,012,811838,De Sa; Virginia,9999,0,9999,0
1739703607758,COGS 190C,013,811839,Kirsh; David Joel,9999,0,9999,0
1739703607758,COGS 190C,014,811843,Jernigan; Terry Lynne,9999,0,9999,0
1739703607758,COGS 190C,015,811844,Tu; Zhuowen,9999,0,9999,0
1739703608783,COGS 190D,A00,811922,Voytek; Bradley Thomas,25,0,25,0
1739703609810,COGS 194,A00,811949,Hill; Seth J,9999,0,9999,0
1739703610837,COGS 202,A00,872444,Khosla; Meenakshi,12,0,25,13
1739703611865,COGS 205,A00,812100,Chiba; Andrea,20,0,20,0
1739703612890,COGS 209,A00,812101,Mukamel; Eran A,25,0,46,21
1739703613919,COGS 210C,A00,812186,Kirsh; David Joel,9999,0,9999,0
1739703613919,COGS 210C,B00,812192,Greene; Deanna Jacquelyn,9999,0,9999,0
1739703613919,COGS 210C,C00,812199,Xia; Haijun,9999,0,9999,0
1739703613919,COGS 210C,D00,812206,Nitz; Douglas A.,9999,0,9999,0
1739703613919,COGS 210C,E00,812207,Hollan; James D.,9999,0,9999,0
1739703613919,COGS 210C,F00,812260,De Sa; Virginia,9999,0,9999,0
1739703613919,COGS 210C,G00,812261,Rossano; Federico,9999,0,9999,0
1739703613919,COGS 210C,H00,812262,Kiyonaga; Anastasia,9999,0,9999,0
1739703613919,COGS 210C,I00,812263,Guo; Philip J,9999,0,9999,0
1739703613919,COGS 210C,J00,812264,Dow; Steven P,9999,0,9999,0
1739703613919,COGS 210C,K00,812265,Bergen; Benjamin,9998,0,9999,1
1739703613919,COGS 210C,L00,812266,Coulson; Seana M,9999,0,9999,0
1739703613919,COGS 210C,M00,812267,Rangel; Lara M,9999,0,9999,0
1739703614960,COGS 211C,A00,812268,Boroditsky; Lera,19,0,20,1
1739703615984,COGS 229,A00,812269,Irani; Lilly C & Shvartzberg Carrio; Manuel,10,0,10,0
1739703617013,COGS 231,A00,812270,Guo; Philip J,0,0,20,20
1739703618037,COGS 238,A00,812271,Bergen; Benjamin,18,0,20,2
1739703619125,COMM 10,A01,807316,Whitworth-Smith; Andrew C,22,0,23,1
1739703619125,COMM 10,A02,807320,Whitworth-Smith; Andrew C,23,0,23,0
1739703619125,COMM 10,A03,807321,Whitworth-Smith; Andrew C,23,0,23,0
1739703619125,COMM 10,A04,807324,Whitworth-Smith; Andrew C,23,0,23,0
1739703619125,COMM 10,A05,807328,Whitworth-Smith; Andrew C,17,0,23,6
1739703619125,COMM 10,A06,807329,Whitworth-Smith; Andrew C,21,0,23,2
1739703619125,COMM 10,A07,807330,Whitworth-Smith; Andrew C,21,0,23,2
1739703619125,COMM 10,A08,807333,Whitworth-Smith; Andrew C,21,0,22,1
1739703619125,COMM 10,A09,807334,Whitworth-Smith; Andrew C,23,0,23,0
1739703619125,COMM 10,A11,807363,Whitworth-Smith; Andrew C,0,0,0,0
1739703619125,COMM 10,A12,807364,Whitworth-Smith; Andrew C,0,0,0,0
1739703619125,COMM 10,A13,807366,Whitworth-Smith; Andrew C,23,0,23,0
1739703619125,COMM 10,A15,807374,Whitworth-Smith; Andrew C,0,0,0,0
1739703619125,COMM 10,A16,807427,Whitworth-Smith; Andrew C,23,0,23,0
1739703619125,COMM 10,A17,807428,Whitworth-Smith; Andrew C,23,0,23,0
1739703619125,COMM 10,A18,807429,Whitworth-Smith; Andrew C,0,0,0,0
1739703620153,COMM 20,A01,807435,Hill; Erin Truesdell,72,0,75,3
1739703621179,COMM 30,A00,807436,Metcalf; Kathryne Young,73,0,75,2
1739703622205,COMM 50,A00,807438,Armenta; John E,22,0,25,3
1739703623233,COMM 80,A01,807440,Campbell; Robert Harold,0,0,0,0
1739703624261,COMM 100B,A01,807446,Serlin; David,20,0,25,5
1739703624261,COMM 100B,A02,807447,Serlin; David,23,0,25,2
1739703624261,COMM 100B,A03,807450,Serlin; David,25,0,25,0
1739703624261,COMM 100B,A05,807453,Serlin; David,23,0,25,2
1739703624261,COMM 100B,A06,807454,Serlin; David,25,0,25,0
1739703624261,COMM 100B,A07,807455,Serlin; David,18,0,25,7
1739703624261,COMM 100B,A08,807458,Serlin; David,22,0,25,3
1739703624261,COMM 100B,A09,807459,Serlin; David,21,0,25,4
1739703624261,COMM 100B,A10,807462,Serlin; David,25,0,25,0
1739703624261,COMM 100B,A11,807464,Serlin; David,25,0,25,0
1739703625289,COMM 101,A01,807470,Davis; Zeinabu I.,15,0,15,0
1739703625289,COMM 101,A02,807513,Davis; Zeinabu I.,15,0,15,0
1739703625289,COMM 101,A03,807516,Davis; Zeinabu I.,15,0,15,0
1739703625289,COMM 101,A04,807517,Davis; Zeinabu I.,14,0,15,1
1739703626314,COMM 101D,A00,807570,Halm; Gavin Patrick,18,0,18,0
1739703627340,COMM 101K,A00,807571,Martinico; Daniel J,16,0,16,0
1739703628367,COMM 101N,A00,807572,Martinico; Daniel J,16,0,16,0
1739703629391,COMM 101T,A00,807573,Halm; Gavin Patrick,17,0,18,1
1739703629391,COMM 101T,B00,807588,Dewey; Matthew D,10,0,10,0
1739703629391,COMM 101T,C00,807592,Dewey; Matthew D,9,0,10,1
1739703630415,COMM 102C,A01,807604,Campion; Camille E,6,0,6,0
1739703630415,COMM 102C,A02,807605,Campion; Camille E,6,0,6,0
1739703630415,COMM 102C,A03,807612,Campion; Camille E,3,0,6,3
1739703631442,COMM 102M,A01,807638,Ahn; Patricia Jeehyun,9,0,9,0
1739703631442,COMM 102M,A02,807639,Ahn; Patricia Jeehyun,7,0,9,2
1739703632470,COMM 106F,A00,807672,McKenna; Denise,69,0,75,6
1739703633496,COMM 106I,A00,807926,Irani; Lilly C,71,0,75,4
1739703634524,COMM 109P,A00,807927,Jack; Caroline Sarah,39,0,40,1
1739703635550,COMM 110M,A00,807928,Abuelhiga; Soraya Jill,40,0,40,0
1739703636576,COMM 113T,A00,807929,Dominguez Rubio; Fernando,39,0,40,1
1739703637604,COMM 114A,A00,807930,Zilberg; Elana,37,0,40,3
1739703638632,COMM 114F,A00,808016,Rojo Solis; Juan Jose,38,0,40,2
1739703639658,COMM 114P,A00,808034,Abuelhiga; Soraya Jill,38,0,40,2
1739703640682,COMM 114W,A00,808035,Walkover; Lillian B,17,0,20,3
1739703641709,COMM 115,A00,808037,Alac; Morana,33,0,35,2
1739703642737,COMM 132,A00,808058,McKenna; Denise,37,0,40,3
1739703643763,COMM 139,A00,808063,Davis; Zeinabu I.,23,0,30,7
1739703644789,COMM 143,A00,808064,Rojo Solis; Juan Jose,38,0,40,2
1739703645814,COMM 146,A00,808068,Ahn; Patricia Jeehyun,34,0,35,1
1739703646839,COMM 155,A00,808072,Pavon Aramburu; Maria Laur,39,0,40,1
1739703647863,COMM 158,A00,808073,Fields; Gary,40,0,40,0
1739703648892,COMM 171,A00,808082,Zilberg; Elana,24,0,25,1
1739703649917,COMM 172,A00,808083,Staff,23,0,25,2
1739703650941,COMM 173,A00,808091,Alac; Morana,25,0,25,0
1739703651966,COMM 180,A00,808162,Leuning; Grant Maurstad,25,0,25,0
1739703652994,COMM 190,A00,808168,Dominguez Rubio; Fernando,22,0,23,1
1739703652994,COMM 190,B00,808169,Harb; Anthony Joseph,22,0,23,1
1739703652994,COMM 190,C00,808170,Rojo Solis; Juan Jose,22,0,23,1
1739703652994,COMM 190,D00,870218,Boateng; Boatema,22,0,23,1
1739703654023,COMM 194,A00,851599,Staff,0,0,0,0
1739703655048,CSE 6R,A01,842851,Moshiri; Niema,142,0,149,7
1739703655048,CSE 6R,B01,876602,Moshiri; Niema,50,0,50,0
1739703656074,CSE 8A,A50,842974,Porter; Leonard Emerson,38,0,38,0
1739703656074,CSE 8A,A51,843001,Porter; Leonard Emerson,37,0,38,1
1739703656074,CSE 8A,A52,843011,Porter; Leonard Emerson,38,0,38,0
1739703656074,CSE 8A,A53,843012,Porter; Leonard Emerson,37,0,38,1
1739703656074,CSE 8A,A54,874345,Porter; Leonard Emerson,38,0,38,0
1739703656074,CSE 8A,A55,874414,Porter; Leonard Emerson,35,0,38,3
1739703656074,CSE 8A,A56,874418,Porter; Leonard Emerson,38,0,38,0
1739703657100,CSE 11,A01,860850,Ochoa; Benjamin Lawrence,300,0,320,20
1739703658124,CSE 12,A01,860851,Cao; Yingjun,117,0,120,3
1739703658124,CSE 12,B01,865865,Cao; Yingjun,109,0,120,11
1739703659150,CSE 20,A01,865892,Jones; Miles E,97,0,100,3
1739703659150,CSE 20,A02,865908,Jones; Miles E,97,0,100,3
1739703660175,CSE 21,A01,865911,Jones; Miles E,97,0,100,3
1739703660175,CSE 21,A02,865914,Jones; Miles E,94,0,100,6
1739703661200,CSE 29,A50,843454,Solares; Edwin A,9,0,10,1
1739703661200,CSE 29,A51,843459,Solares; Edwin A,10,0,10,0
1739703661200,CSE 29,A52,843460,Solares; Edwin A,8,0,10,2
1739703661200,CSE 29,A53,843549,Solares; Edwin A,5,0,5,0
1739703661200,CSE 29,B50,843559,Soosai Raj; Adalbert Geral,5,0,10,5
1739703661200,CSE 29,B51,843750,Soosai Raj; Adalbert Geral,4,0,10,6
1739703661200,CSE 29,B52,843757,Soosai Raj; Adalbert Geral,8,0,10,2
1739703661200,CSE 29,B53,843758,Soosai Raj; Adalbert Geral,4,0,5,1
1739703662229,CSE 30,A01,864415,Chin; Bryan W.,120,0,125,5
1739703662229,CSE 30,B01,864419,Chin; Bryan W.,99,0,100,1
1739703663257,CSE 87,A00,875925,Moshiri; Niema,20,0,20,0
1739703664286,CSE 89,A00,872519,Minnes Kemp; Mor Mia,100,0,100,0
1739703664286,CSE 89,B00,872520,Minnes Kemp; Mor Mia,100,0,100,0
1739703665311,CSE 95,A00,843802,Cao; Yingjun,100,0,100,0
1739703666336,CSE 100,A01,864420,Sahoo; Debashis,100,0,120,20
1739703667361,CSE 101,A01,860868,Impagliazzo; Russell,0,0,10,10
1739703667361,CSE 101,A02,860869,Impagliazzo; Russell,0,0,10,10
1739703667361,CSE 101,A03,860870,Impagliazzo; Russell,6,0,10,4
1739703668386,CSE 105,A01,864426,Lovett; Shachar,222,0,250,28
1739703669410,CSE 107,A01,864427,Bellare; Mihir,92,0,96,4
1739703670440,CSE 110,A50,843823,Powell; Thomas Allan,111,0,116,5
1739703670440,CSE 110,A51,843827,Powell; Thomas Allan,93,0,116,23
1739703670440,CSE 110,A52,843828,Powell; Thomas Allan,106,0,116,10
1739703671464,CSE 120,A01,860871,Ousterhout; Amy,300,0,328,28
1739703672489,CSE 124,A01,864431,Porter; George M,138,0,196,58
1739703673517,CSE 125,A00,843848,Voelker; Geoffrey M.,30,0,30,0
1739703674541,CSE 127,A01,865915,Fernandes; Earlence T,173,0,192,19
1739703675570,CSE 130,A01,865928,Polikarpova; Nadezhda,176,0,192,16
1739703676597,CSE 131,A01,865936,Ding; Yufei,65,0,75,10
1739703677623,CSE 140,A01,865937,Eldon; John,184,0,196,12
1739703678651,CSE 140L,A01,843892,Eldon; John,173,0,196,23
1739703679676,CSE 141,A01,865939,Pannuto; Patrick William,165,0,192,27
1739703680702,CSE 141L,A01,843910,Eldon; John,158,0,196,38
1739703681727,CSE 145,A00,843915,Kastner; Ryan Charles,25,0,25,0
1739703682756,CSE 150A,A01,860873,Bonjour; Trevor,181,0,196,15
1739703683782,CSE 150B,A01,864429,Gao; Sicun,329,0,362,33
1739703684807,CSE 151A,A01,860874,Dasgupta; Sanjoy,297,0,325,28
1739703685833,CSE 151B,A01,864435,Yu; Qi,164,0,192,28
1739703686857,CSE 152B,A01,874283,Chandraker; Manmohan Krishna,57,0,70,13
1739703687882,CSE 153,A01,872732,McAuley; Julian John,181,0,196,15
1739703688908,CSE 153R,A01,872798,McAuley; Julian John,215,0,250,35
1739703688908,CSE 153R,B01,877492,Staff,50,0,50,0
1739703689937,CSE 165,A01,844081,Weibel; Nadir,23,0,35,12
1739703690962,CSE 168,A01,860875,Ramamoorthi; Ravi,23,0,28,5
1739703690962,CSE 168,A02,860876,Ramamoorthi; Ravi,26,0,28,2
1739703691990,CSE 175,A01,865941,Kumar; Rakesh,50,0,50,0
1739703694042,CSE 182,A01,851596,Bafna; Vineet,44,0,49,5
1739703695067,CSE 185,A01,844113,Moshiri; Niema,25,0,45,20
1739703695067,CSE 185,A02,844118,Moshiri; Niema,38,0,45,7
1739703696093,CSE 190,A00,844121,Grier; Daniel T,52,0,52,0
1739703696093,CSE 190,B00,844124,Soosai Raj; Adalbert Geral,81,0,100,19
1739703696093,CSE 190,C00,881308,Prithviraj; Ammanabrolu,45,0,50,5
1739703696093,CSE 190,D00,844127,Stefan; Deian,50,0,50,0
1739703697117,CSE 191,A00,844133,Minnes Kemp; Mor Mia,9999,0,9999,0
1739703698141,CSE 205A,A00,844166,Vianu; Victor Dan,0,0,0,0
1739703699166,CSE 209A,A00,844205,Impagliazzo; Russell,0,0,0,0
1739703700192,CSE 209B,A00,844216,Bellare; Mihir,0,0,0,0
1739703701217,CSE 217,A01,844235,Weibel; Nadir,0,0,0,0
1739703702245,CSE 219,A00,844246,Irani; Lilly C & Shvartzberg Carrio; Manuel,0,0,0,0
1739703703271,CSE 223B,A00,844249,Snoeren; Alex C.,0,0,0,0
1739703704295,CSE 224,A01,864433,Porter; George M,0,0,0,0
1739703705322,CSE 227,A00,844270,Stefan; Deian,0,0,0,0
1739703706348,CSE 229A,A00,844274,Ousterhout; Amy,0,0,0,0
1739703707372,CSE 229C,A00,844280,Fernandes; Earlence T,0,0,0,0
1739703708401,CSE 230,A00,844311,D'Antoni; Loris,0,0,0,0
1739703709429,CSE 237D,A00,844312,Kastner; Ryan Charles,0,0,0,0
1739703710453,CSE 239A,A00,844313,Vianu; Victor Dan,0,0,0,0
1739703711478,CSE 239B,A00,844314,Coblenz; Michael J,0,0,0,0
1739703712506,CSE 240A,A00,844315,Zhao; Jishen,0,0,0,0
1739703713532,CSE 241A,A00,844316,Kahng; Andrew Byun,0,0,0,0
1739703714557,CSE 250A,A00,844317,Bonjour; Trevor,0,0,0,0
1739703715583,CSE 251B,A01,864438,Yu; Qi,0,0,0,0
1739703716608,CSE 252D,A00,844320,Chandraker; Manmohan Krishna,0,0,0,0
1739703717637,CSE 253,A01,872796,McAuley; Julian John,0,0,0,0
1739703718661,CSE 253R,A01,872838,McAuley; Julian John,0,0,0,0
1739703720714,CSE 276F,A01,872476,Su; Hao,0,0,0,0
1739703721739,CSE 283,A00,844332,Bafna; Vineet & Zhong; Sheng,0,0,0,0
1739703722823,CSE 290,A00,844338,Gao; Sicun,0,0,0,0
1739703722823,CSE 290,B00,844366,Pannuto; Patrick William,0,0,0,0
1739703722823,CSE 290,C00,844379,Stefan; Deian,0,0,0,0
1739703722823,CSE 290,D00,881470,Yu; Qi,0,0,0,0
1739703722823,CSE 290,E00,844387,Chern; Albert Ren-Haur,0,0,0,0
1739703722823,CSE 290,F00,891163,Ding; Yufei,0,0,0,0
1739703723851,CSE 291,A00,844398,Bandeira; Nuno Filipe Cabrita,0,0,0,0
1739703723851,CSE 291,B00,844401,Li; Tzumao,0,0,0,0
1739703723851,CSE 291,C00,844402,Heninger; Nadia A,0,0,0,0
1739703723851,CSE 291,D00,844407,Chern; Albert Ren-Haur,0,0,0,0
1739703723851,CSE 291,E00,844409,Savage; Stefan,0,0,0,0
1739703723851,CSE 291,F00,881310,Niethammer; Marc S,0,0,0,0
1739703723851,CSE 291,H00,844419,Kahng; Andrew Byun,0,0,0,0
1739703724882,CSE 293,001,877922,Bafna; Vineet,9999,0,9999,0
1739703724882,CSE 293,002,877923,Bellare; Mihir,9999,0,9999,0
1739703724882,CSE 293,003,877942,Berg-Kirkpatrick; Taylor D,9999,0,9999,0
1739703724882,CSE 293,004,877943,Chandraker; Manmohan Krishna,9999,0,9999,0
1739703724882,CSE 293,005,877945,Cheng; Chung Kuan,9999,0,9999,0
1739703724882,CSE 293,006,877947,Christensen; Henrik I,9999,0,9999,0
1739703724882,CSE 293,007,877950,Coblenz; Michael J,9999,0,9999,0
1739703724882,CSE 293,008,877951,Cottrell; Garrison W,9999,0,9999,0
1739703724882,CSE 293,009,877952,Deutsch; Alin Bernard,9999,0,9999,0
1739703724882,CSE 293,010,877954,Esmaeilzadeh; Hadi,9999,0,9999,0
1739703724882,CSE 293,011,878049,Freund; Yoav,9999,0,9999,0
1739703724882,CSE 293,012,878145,Griswold; William G.,9999,0,9999,0
1739703724882,CSE 293,013,878152,Gymrek; Melissa Ann,9999,0,9999,0
1739703724882,CSE 293,014,878207,Heninger; Nadia A,9999,0,9999,0
1739703724882,CSE 293,015,878221,Impagliazzo; Russell,9999,0,9999,0
1739703724882,CSE 293,016,878223,Jhala; Ranjit,9999,0,9999,0
1739703724882,CSE 293,017,878262,Kahng; Andrew Byun,9999,0,9999,0
1739703724882,CSE 293,018,878267,Kane; Daniel Mertz,9999,0,9999,0
1739703724882,CSE 293,019,878270,Kriegman; David J,9999,0,9999,0
1739703724882,CSE 293,020,878273,Kumar; Arun Kumar,9999,0,9999,0
1739703724882,CSE 293,021,878275,Lerner; Sorin,9999,0,9999,0
1739703724882,CSE 293,022,878276,Lovett; Shachar,9999,0,9999,0
1739703724882,CSE 293,023,878311,McAuley; Julian John,9999,0,9999,0
1739703724882,CSE 293,024,878312,Micciancio; Daniele,9999,0,9999,0
1739703724882,CSE 293,025,878313,Orailoglu; Alex,9999,0,9999,0
1739703724882,CSE 293,026,878314,Pannuto; Patrick William,9999,0,9999,0
1739703724882,CSE 293,027,878315,Paturi; Ramamohan,9999,0,9999,0
1739703724882,CSE 293,028,878330,Polikarpova; Nadezhda,9999,0,9999,0
1739703724882,CSE 293,029,878358,Politz; Joseph Gibbs,9999,0,9999,0
1739703724882,CSE 293,030,878392,Porter; George M,9999,0,9999,0
1739703724882,CSE 293,031,878399,Porter; Leonard Emerson,9999,0,9999,0
1739703724882,CSE 293,032,878415,Ramamoorthi; Ravi,9999,0,9999,0
1739703724882,CSE 293,033,878416,Riek; Laurel D,9999,0,9999,0
1739703724882,CSE 293,034,878417,Sahoo; Debashis,9999,0,9999,0
1739703724882,CSE 293,035,878418,Saul; Lawrence,9999,0,9999,0
1739703724882,CSE 293,036,878419,Savage; Stefan,9999,0,9999,0
1739703724882,CSE 293,037,878420,Schulze; Jurgen P.,9999,0,9999,0
1739703724882,CSE 293,038,878421,Snoeren; Alex C.,9999,0,9999,0
1739703724882,CSE 293,039,878422,Shang; Jingbo,9999,0,9999,0
1739703724882,CSE 293,040,878423,Stefan; Deian,9999,0,9999,0
1739703724882,CSE 293,041,878424,Su; Hao,9999,0,9999,0
1739703724882,CSE 293,042,878425,Swanson; Steven James,9999,0,9999,0
1739703724882,CSE 293,043,878460,Tullsen; Dean Michael,9999,0,9999,0
1739703724882,CSE 293,044,878476,Vaccaro; Kristen Marie,9999,0,9999,0
1739703724882,CSE 293,045,878517,Voelker; Geoffrey M.,9999,0,9999,0
1739703724882,CSE 293,046,878541,Zhao; Jishen,9999,0,9999,0
1739703724882,CSE 293,047,878663,Zhou; Yuan-Yuan,9999,0,9999,0
1739703724882,CSE 293,048,878664,Gao; Sicun,9999,0,9999,0
1739703724882,CSE 293,049,878665,Weibel; Nadir,9999,0,9999,0
1739703724882,CSE 293,050,878666,Gupta; Rajesh K.,9999,0,9999,0
1739703724882,CSE 293,051,878667,Soosai Raj; Adalbert Geral,9999,0,9999,0
1739703724882,CSE 293,052,891170,Tu; Zhuowen,9999,0,9999,0
1739703725908,CSE 294,A00,844429,Voelker; Geoffrey M.,0,0,0,0
1739703726934,CSS 1,A01,864447,Staff,34,0,36,2
1739703726934,CSS 1,A02,864476,Staff,30,0,36,6
1739703726934,CSS 1,A03,864511,Staff,34,0,36,2
1739703726934,CSS 1,A04,864512,Staff,36,0,36,0
1739703727963,CSS 100,A01,864537,Trott; Sean Thomas,30,0,36,6
1739703727963,CSS 100,A02,864538,Trott; Sean Thomas,36,0,36,0
1739703728991,CSS 120,A01,864563,Mignozzetti; Umberto,28,0,28,0
1739703728991,CSS 120,A02,864564,Mignozzetti; Umberto,28,0,30,2
1739703730018,CSS 206,A00,812747,Mukamel; Eran A,6,0,24,18
1739703731046,CSS 209,A00,864566,Mignozzetti; Umberto,27,0,45,18
1739703732077,CSS 296,001,864568,Mignozzetti; Umberto,0,0,0,4
1739703732077,CSS 296,002,864569,Mignozzetti; Umberto,0,0,0,3
1739703732077,CSS 296,003,864571,Leas; Eric Craig,0,0,0,1
1739703732077,CSS 296,004,864577,Okonkwo; Holly,0,0,0,1
1739703732077,CSS 296,005,864605,Fleischer; Jason G,0,0,0,1
1739703732077,CSS 296,006,864634,Creel; Sarah,0,0,0,1
1739703732077,CSS 296,007,864661,Patel; Hemal,0,0,0,1
1739703732077,CSS 296,008,864688,Martin; Isaac,0,0,0,0
1739703732077,CSS 296,009,864697,Styler; William Francis,0,0,0,1
1739703732077,CSS 296,010,864751,Grigoryan; Aram,0,0,0,1
1739703732077,CSS 296,011,864752,Bonjour; Trevor,0,0,0,1
1739703732077,CSS 296,012,864753,Martin; Isaac,0,0,0,2
1739703733105,DDPM 210,A00,814899,Ma; Joseph David,29,0,32,3
1739703734130,DDPM 211,A00,814901,Ma; Joseph David,29,0,32,3
1739703735158,DDPM 214,A00,814907,Ma; Joseph David,29,0,32,3
1739703736184,DERM 296,001,866221,Eichenfield; Dawn Zhang,4,0,5,1
1739703736184,DERM 296,002,866222,Staff,5,0,5,0
1739703736184,DERM 296,003,866229,Staff,5,0,5,0
1739703737231,DOC 3,A01,813868,Staff,0,0,0,0
1739703737231,DOC 3,A02,813884,Staff,0,0,0,0
1739703737231,DOC 3,A03,813885,Staff,0,0,0,0
1739703737231,DOC 3,A04,813886,Staff,0,0,0,0
1739703737231,DOC 3,A05,813887,Staff,0,0,0,0
1739703737231,DOC 3,A06,813888,Staff,0,0,0,0
1739703737231,DOC 3,A07,813889,Staff,0,0,0,0
1739703737231,DOC 3,A08,813890,Staff,0,0,0,0
1739703737231,DOC 3,A09,813891,Staff,0,0,0,0
1739703737231,DOC 3,A10,813892,Staff,0,0,0,0
1739703737231,DOC 3,A11,813893,Staff,0,0,0,0
1739703737231,DOC 3,A12,813894,Staff,0,0,0,0
1739703737231,DOC 3,A13,813895,Staff,0,0,0,0
1739703737231,DOC 3,A14,813896,Staff,0,0,0,0
1739703737231,DOC 3,A15,813897,Staff,0,0,0,0
1739703737231,DOC 3,A16,813898,Staff,0,0,0,0
1739703737231,DOC 3,B01,813900,Staff,0,0,0,0
1739703737231,DOC 3,B02,813901,Staff,0,0,0,0
1739703737231,DOC 3,B03,813902,Staff,0,0,0,0
1739703737231,DOC 3,B04,813903,Staff,0,0,0,0
1739703737231,DOC 3,B05,813904,Staff,0,0,0,0
1739703737231,DOC 3,B06,813905,Staff,0,0,0,0
1739703737231,DOC 3,B07,813906,Staff,0,0,0,0
1739703737231,DOC 3,B08,813907,Staff,0,0,0,0
1739703737231,DOC 3,B09,813908,Staff,0,0,0,0
1739703737231,DOC 3,B10,813910,Staff,0,0,0,0
1739703737231,DOC 3,B11,813911,Staff,0,0,0,0
1739703737231,DOC 3,B12,813913,Staff,0,0,0,0
1739703737231,DOC 3,B13,813914,Staff,0,0,0,0
1739703737231,DOC 3,B14,813915,Staff,0,0,0,0
1739703737231,DOC 3,B15,813916,Staff,0,0,0,0
1739703737231,DOC 3,B16,813917,Staff,0,0,0,0
1739703737231,DOC 3,C01,813919,Staff,0,0,0,0
1739703737231,DOC 3,C02,813920,Staff,0,0,0,0
1739703737231,DOC 3,C03,813921,Staff,0,0,0,0
1739703737231,DOC 3,C04,813922,Staff,0,0,0,0
1739703737231,DOC 3,C05,813923,Staff,0,0,0,0
1739703737231,DOC 3,C06,813926,Staff,0,0,0,0
1739703737231,DOC 3,C07,813927,Staff,0,0,0,0
1739703737231,DOC 3,C08,813928,Staff,0,0,0,0
1739703737231,DOC 3,C09,813929,Staff,0,0,0,0
1739703737231,DOC 3,C10,813931,Staff,0,0,0,0
1739703737231,DOC 3,C11,813932,Staff,0,0,0,0
1739703737231,DOC 3,C12,813933,Staff,0,0,0,0
1739703737231,DOC 3,C13,813936,Staff,0,0,0,0
1739703737231,DOC 3,C14,813937,Staff,0,0,0,0
1739703737231,DOC 3,C15,813938,Staff,0,0,0,0
1739703737231,DOC 3,C16,813939,Staff,0,0,0,0
1739703737231,DOC 3,D01,813942,Staff,0,0,0,0
1739703737231,DOC 3,D02,813943,Staff,0,0,0,0
1739703737231,DOC 3,D03,813944,Staff,0,0,0,0
1739703737231,DOC 3,D04,813945,Staff,0,0,0,0
1739703737231,DOC 3,D05,813979,Staff,0,0,0,0
1739703737231,DOC 3,D06,813981,Staff,0,0,0,0
1739703737231,DOC 3,D07,813985,Staff,0,0,0,0
1739703737231,DOC 3,D08,813986,Staff,0,0,0,0
1739703737231,DOC 3,D09,813988,Staff,0,0,0,0
1739703737231,DOC 3,D10,813991,Staff,0,0,0,0
1739703737231,DOC 3,D11,813993,Staff,0,0,0,0
1739703737231,DOC 3,D12,813994,Staff,0,0,0,0
1739703737231,DOC 3,D13,814000,Staff,0,0,0,0
1739703737231,DOC 3,D14,814002,Staff,0,0,0,0
1739703737231,DOC 3,D15,814003,Staff,0,0,0,0
1739703737231,DOC 3,D16,814012,Staff,0,0,0,0
1739703737231,DOC 3,D17,814014,Staff,0,0,0,0
1739703738260,DOC 100D,A00,814015,Pass; Natalye,24,0,25,1
1739703738260,DOC 100D,B00,814017,Pass; Natalye,24,0,25,1
1739703739286,DSC 10,A01,841644,Tiefenbruck; Janine LoBue,146,0,146,0
1739703739286,DSC 10,B01,870243,Tiefenbruck; Janine LoBue,143,0,146,3
1739703740313,DSC 20,A01,841647,Langlois; Marina,60,0,60,0
1739703740313,DSC 20,B01,841649,Langlois; Marina,60,0,60,0
1739703741343,DSC 30,A01,841651,Liao; Soohyun Nam,189,0,190,1
1739703741343,DSC 30,B01,841653,Liao; Soohyun Nam,188,0,190,2
1739703742370,DSC 40A,A01,841659,Shannon; Kyle Michael,143,0,146,3
1739703743395,DSC 40B,A01,841663,Eldridge; Justin Matthew,175,0,180,5
1739703744424,DSC 80,A01,841667,Rahman; Tauhidur,116,0,120,4
1739703745451,DSC 95,A01,841669,Tiefenbruck; Janine LoBue,40,0,40,0
1739703746481,DSC 100,A01,841671,Salimi; Babak,146,0,146,0
1739703747505,DSC 102,A01,841674,Staff,293,0,300,7
1739703748531,DSC 106,B01,841679,Lau; Samuel Ethan,98,0,100,2
1739703748531,DSC 106,C01,841681,Lau; Samuel Ethan,100,0,100,0
1739703749556,DSC 140A,A01,841683,Ustun; Tevfik Berk,150,0,150,0
1739703750583,DSC 140B,A01,841687,Weng; Tsui-Wei (lily),121,0,125,4
1739703751610,DSC 161,A00,841688,Roberts; Margaret Earling,40,0,40,0
1739703752637,DSC 190,A01,841690,Silberman; Jack,30,0,30,0
1739703752637,DSC 190,B01,841692,Langlois; Marina,99,0,100,1
1739703752637,DSC 190,C01,841694,Weng; Tsui-Wei (lily),28,0,30,2
1739703752637,DSC 190,D01,841696,Ustun; Tevfik Berk,30,0,30,0
1739703753662,DSC 197,001,841699,Eldridge; Justin Matthew,9999,0,9999,0
1739703754690,DSC 204A,A00,841700,Bellur; Umesh,0,0,0,0
1739703755714,DSC 208R,A01,841703,Jin; Haojian,34,0,40,6
1739703756742,DSC 212,A00,841705,Staff,77,0,90,13
1739703757768,DSC 214,A00,841706,Wang; Yusu,0,0,60,60
1739703758794,DSC 232R,A01,841708,Solares; Edwin A,49,0,80,31
1739703759820,DSC 240,A00,841710,Belkin; Mikhail,114,0,120,6
1739703760846,DSC 241,A00,841712,Schwartzman; Armin,20,0,90,70
1739703761871,DSC 255R,A01,841714,Staff,32,0,40,8
1739703762897,DSC 258R,A01,841716,Shang; Jingbo,35,0,60,25
1739703763925,DSC 267R,A01,841718,Danks; David J,53,0,60,7
1739703764961,DSC 291,A00,841719,Ustun; Tevfik Berk,0,0,30,30
1739703764961,DSC 291,B00,841723,Huang; Biwei,3,0,60,57
1739703764961,DSC 291,C00,841724,Weng; Tsui-Wei (lily),0,0,30,30
1739703764961,DSC 291,D00,841725,Hu; Zhiting,54,0,90,36
1739703764961,DSC 291,E00,841726,Warstadt; Alexander Scott,7,0,60,53
1739703765989,DSC 293,A00,841727,Ustun; Tevfik Berk,9995,0,9999,4
1739703767013,DSC 297,001,872917,Rahman; Tauhidur,9999,0,9999,0
1739703768038,DSE 210,A00,869159,Staff,20,0,20,0
1739703769063,DSE 230,A00,813774,Staff,25,0,25,0
1739703770087,DSE 260B,A00,813775,Staff,25,0,25,0
1739703771114,DSGN 1,A01,810429,Klemmer; Scott R,49,0,50,1
1739703771114,DSGN 1,A02,810431,Klemmer; Scott R,49,0,50,1
1739703771114,DSGN 1,A03,810434,Klemmer; Scott R,50,0,50,0
1739703771114,DSGN 1,A04,810436,Klemmer; Scott R,48,0,50,2
1739703771114,DSGN 1,A05,810438,Klemmer; Scott R,39,0,40,1
1739703772151,DSGN 2,A01,810443,Hollan; James D.,49,0,50,1
1739703773177,DSGN 100,A01,811981,Rill; Bryan,18,0,18,0
1739703773177,DSGN 100,A02,811982,Rill; Bryan,10,0,18,8
1739703773177,DSGN 100,A03,811983,Rill; Bryan,15,0,18,3
1739703773177,DSGN 100,A04,812053,Rill; Bryan,6,0,16,10
1739703774203,DSGN 119,A00,812054,Irani; Lilly C & Shvartzberg Carrio; Manuel,63,0,80,17
1739703776253,DSGN 219,A00,812273,Irani; Lilly C & Shvartzberg Carrio; Manuel,12,0,15,3
1739703777282,ECE 5,A01,816583,Morris; Karcher William,0,0,0,0
1739703777282,ECE 5,A02,816584,Morris; Karcher William,0,0,0,0
1739703777282,ECE 5,A03,816586,Morris; Karcher William,22,0,22,0
1739703777282,ECE 5,A04,816589,Morris; Karcher William,22,0,22,0
1739703778306,ECE 15,A01,816591,Sahay; Rajeev,114,0,120,6
1739703779335,ECE 16,A01,816594,Wang; Edward Jay,25,0,30,5
1739703780361,ECE 17,A01,816599,Sahay; Rajeev,67,0,75,8
1739703781390,ECE 25,A50,816722,Dey; Sujit,30,0,30,0
1739703781390,ECE 25,A51,816734,Dey; Sujit,29,0,30,1
1739703782417,ECE 30,A50,816809,Mir Arabbaygi; Siavash,25,0,30,5
1739703782417,ECE 30,A51,816811,Mir Arabbaygi; Siavash,25,0,30,5
1739703782417,ECE 30,A52,816812,Mir Arabbaygi; Siavash,30,0,30,0
1739703782417,ECE 30,A53,816814,Mir Arabbaygi; Siavash,30,0,30,0
1739703782417,ECE 30,A54,816817,Mir Arabbaygi; Siavash,27,0,27,0
1739703783442,ECE 35,A50,816821,Ndao; Abdoulaye,25,0,26,1
1739703783442,ECE 35,A51,816822,Ndao; Abdoulaye,24,0,26,2
1739703783442,ECE 35,A52,816825,Ndao; Abdoulaye,26,0,26,0
1739703783442,ECE 35,A53,816826,Ndao; Abdoulaye,26,0,26,0
1739703784467,ECE 45,A01,816828,Zeger; Kenneth A.,187,0,192,5
1739703785498,ECE 65,A50,816873,Baghdadchi; Saharnaz,28,0,30,2
1739703785498,ECE 65,A51,816874,Baghdadchi; Saharnaz,28,0,30,2
1739703785498,ECE 65,A52,816877,Baghdadchi; Saharnaz,30,0,30,0
1739703785498,ECE 65,A53,816880,Baghdadchi; Saharnaz,30,0,30,0
1739703785498,ECE 65,A54,816882,Baghdadchi; Saharnaz,30,0,30,0
1739703785498,ECE 65,A55,816883,Baghdadchi; Saharnaz,29,0,30,1
1739703785498,ECE 65,A56,816884,Baghdadchi; Saharnaz,30,0,30,0
1739703786526,ECE 100,A01,816926,Hsueh; Tzu-Chien,29,0,30,1
1739703786526,ECE 100,A02,816939,Hsueh; Tzu-Chien,26,0,30,4
1739703786526,ECE 100,A03,816945,Hsueh; Tzu-Chien,29,0,30,1
1739703786526,ECE 100,A04,816950,Hsueh; Tzu-Chien,29,0,30,1
1739703786526,ECE 100,A05,816962,Hsueh; Tzu-Chien,29,0,30,1
1739703787554,ECE 101,A01,816993,Siegel; Paul H.,57,0,60,3
1739703787554,ECE 101,A02,817165,Siegel; Paul H.,57,0,60,3
1739703788580,ECE 103,A01,817352,Nomura; Kenji,43,0,50,7
1739703789609,ECE 108,A01,817373,Kang; Mingu,99,0,120,21
1739703790633,ECE 109,A01,817418,Orlitsky; Alon,72,0,73,1
1739703790633,ECE 109,A02,817420,Orlitsky; Alon,73,0,73,0
1739703791659,ECE 111,A01,817426,Eldon; John,167,0,180,13
1739703792689,ECE 115,A01,817432,Yip; Michael,20,0,26,6
1739703793715,ECE 123,A01,817448,Sievenpiper; Daniel F.,28,0,37,9
1739703794740,ECE 125B,A50,817453,Esmaili; Gholamreza,18,0,24,6
1739703794740,ECE 125B,A51,817455,Esmaili; Gholamreza,23,0,24,1
1739703795768,ECE 134,A00,817457,Ng; Tse Nga,47,0,50,3
1739703796796,ECE 136L,A01,817459,Dayeh; Shadi Ahmad,5,0,5,0
1739703796796,ECE 136L,A02,817461,Dayeh; Shadi Ahmad,2,0,5,3
1739703796796,ECE 136L,A03,817462,Dayeh; Shadi Ahmad,3,0,5,2
1739703796796,ECE 136L,A04,817463,Dayeh; Shadi Ahmad,4,0,5,1
1739703797820,ECE 139,A00,817537,Nomura; Kenji,29,0,30,1
1739703798845,ECE 140B,A50,817654,Khoshabeh; Ramsin & Gessner; Richard K.,23,0,24,1
1739703798845,ECE 140B,A51,817662,Khoshabeh; Ramsin & Gessner; Richard K.,22,0,24,2
1739703798845,ECE 140B,A52,817663,Khoshabeh; Ramsin & Gessner; Richard K.,22,0,22,0
1739703799871,ECE 141B,A01,872372,Gessner; Richard K.,26,0,30,4
1739703800899,ECE 148,A01,817698,Silberman; Jack,22,0,26,4
1739703801926,ECE 153,A01,817703,Naghizadeh Ardabili; Parinaz,74,0,90,16
1739703802951,ECE 157A,A01,817708,Bharadia; Dinesh,21,0,25,4
1739703803979,ECE 161C,A00,817865,Harris; Frederick Joel,48,0,50,2
1739703805010,ECE 165,A51,817880,Mercier; Patrick Philip,26,0,30,4
1739703805010,ECE 165,A52,817882,Mercier; Patrick Philip,23,0,30,7
1739703805010,ECE 165,A53,817885,Mercier; Patrick Philip,27,0,30,3
1739703805010,ECE 165,A54,817888,Mercier; Patrick Philip,29,0,30,1
1739703806038,ECE 171A,A01,817892,Zheng; Yang,93,0,100,7
1739703807062,ECE 175B,A01,817899,Xie; Pengtao,47,0,50,3
1739703808090,ECE 183,A01,817903,Mookherjea; Shayan,26,0,30,4
1739703809114,ECE 185,A01,817907,Liu; Zhaowei,20,0,20,0
1739703810140,ECE 196,A00,817908,Morris; Karcher William,15,0,24,9
1739703810140,ECE 196,B00,817913,Morris; Karcher William,26,0,28,2
1739703811166,ECE 197,001,816579,Mercier; Patrick Philip,9999,0,9999,0
1739703812192,ECE 198,001,816580,Nguyen; Truong Quang,9999,0,9999,0
1739703813217,ECE 204,A00,817918,Alexandrov; Ludmil B,0,0,0,0
1739703814246,ECE 208,A00,817920,Mir Arabbaygi; Siavash,0,0,0,0
1739703815271,ECE 212CN,A00,817921,Liu; Zhaowei,0,0,0,0
1739703816295,ECE 222D,A00,817922,Sievenpiper; Daniel F.,0,0,0,0
1739703817320,ECE 227,A00,817926,Franceschetti; Massimo,0,0,0,0
1739703818347,ECE 228,A00,817928,Shi; Yuanyuan,0,0,0,0
1739703819371,ECE 236B,A00,817929,Lo; Yu-Hwa,0,0,0,0
1739703820395,ECE 238B,A00,817934,Garay; Javier,0,0,0,0
1739703821424,ECE 240C,A00,818013,Mookherjea; Shayan,0,0,0,0
1739703822450,ECE 241A,A00,818014,Rubin; Noah,0,0,0,0
1739703823477,ECE 251B,A00,818015,Vasconcelos; Manuela,0,0,0,0
1739703824502,ECE 258B,A00,818016,Milstein; Laurence B.,0,0,0,0
1739703825527,ECE 260C,A00,818017,Kahng; Andrew Byun,0,0,0,0
1739703826609,ECE 264B,A00,818018,Galton; Ian A,0,0,0,0
1739703827635,ECE 265B,A00,818019,Gudem; Prasad S.S.,0,0,0,0
1739703828661,ECE 266,A01,818021,Hall; Drew A.,0,0,0,0
1739703829688,ECE 268,A00,818022,Koushanfar; Farinaz,0,0,0,0
1739703830717,ECE 272A,A01,818064,Poveda Fonseca; Jorge,0,0,0,0
1739703831745,ECE 273,A00,818065,Wang; Jun-Kun,0,0,0,0
1739703832771,ECE 275A,A00,818066,Meyer; Florian,0,0,0,0
1739703833797,ECE 276B,A00,818067,Atanasov; Nikolay A.,0,0,0,0
1739703834827,ECE 284,A00,818068,Wang; Edward,0,0,0,0
1739703835857,ECE 285,A00,818069,Wang; Xiaolong,0,0,0,0
1739703835857,ECE 285,B00,818070,Antipa; Nicholas A,0,0,0,0
1739703835857,ECE 285,C00,818071,Xie; Pengtao,0,0,0,0
1739703836883,ECE 287,A00,872497,Gonzalez Prelcic; Nuria,0,0,0,0
1739703837908,ECON 1,A01,814026,Famulari; Melissa,118,0,120,2
1739703837908,ECON 1,A02,814028,Famulari; Melissa,114,0,115,1
1739703837908,ECON 1,A03,814029,Famulari; Melissa,115,0,115,0
1739703837908,ECON 1,B01,814039,Famulari; Melissa,46,0,50,4
1739703838934,ECON 2,A01,814045,Crane; Meredith Helen,95,0,96,1
1739703839962,ECON 3,A01,814154,Crane; Meredith Helen,91,0,95,4
1739703839962,ECON 3,A02,814155,Crane; Meredith Helen,93,0,95,2
1739703839962,ECON 3,B01,814188,Crane; Meredith Helen,95,0,95,0
1739703839962,ECON 3,B02,814195,Crane; Meredith Helen,91,0,95,4
1739703840992,ECON 4,A01,814197,Levkoff; Steven B.,50,0,54,4
1739703840992,ECON 4,A02,814210,Levkoff; Steven B.,54,0,54,0
1739703840992,ECON 4,A03,814224,Levkoff; Steven B.,54,0,54,0
1739703840992,ECON 4,B01,814273,Brooks; Marcus Raymond,3,0,3,0
1739703842018,ECON 5,A01,814495,Arnold; David Hall,66,0,72,6
1739703842018,ECON 5,A02,814507,Arnold; David Hall,72,0,72,0
1739703842018,ECON 5,A03,814508,Arnold; David Hall,71,0,72,1
1739703842018,ECON 5,A04,814509,Arnold; David Hall,71,0,72,1
1739703842018,ECON 5,A05,814510,Arnold; David Hall,72,0,72,0
1739703842018,ECON 5,B01,814513,Dai; Yinlin,44,0,45,1
1739703842018,ECON 5,B02,814514,Dai; Yinlin,39,0,45,6
1739703843048,ECON 100A,A01,814516,Newhouse; Herbert S,76,0,79,3
1739703843048,ECON 100A,A02,814517,Newhouse; Herbert S,79,0,79,0
1739703843048,ECON 100A,B01,814519,Newhouse; Herbert S,82,0,83,1
1739703843048,ECON 100A,B02,814520,Newhouse; Herbert S,73,0,75,2
1739703844077,ECON 100AH,A00,814521,Famulari; Melissa,20,0,20,0
1739703845106,ECON 100B,A01,814523,Boomhower; Judson P,74,0,85,11
1739703845106,ECON 100B,A02,814524,Boomhower; Judson P,82,0,85,3
1739703845106,ECON 100B,A03,814525,Boomhower; Judson P,78,0,80,2
1739703845106,ECON 100B,B01,814527,Boomhower; Judson P,0,0,0,0
1739703846130,ECON 100BH,A00,814528,Boomhower; Judson P,20,0,20,0
1739703847156,ECON 100C,A01,814530,Newhouse; Herbert S,95,0,98,3
1739703847156,ECON 100C,A02,814531,Newhouse; Herbert S,98,0,98,0
1739703848187,ECON 101,A00,814532,Esfahani; Sara,112,0,120,8
1739703849215,ECON 109T,A00,814533,Trevino; Isabel,20,0,20,0
1739703850242,ECON 110A,A01,814535,Candido; Maria Teresa,97,0,100,3
1739703851270,ECON 110B,A01,814537,Herreno Lopera; Juan,91,0,100,9
1739703851270,ECON 110B,A02,814538,Herreno Lopera; Juan,100,0,100,0
1739703851270,ECON 110B,A03,814539,Herreno Lopera; Juan,99,0,100,1
1739703851270,ECON 110B,A04,814540,Herreno Lopera; Juan,98,0,100,2
1739703852296,ECON 120A,A01,814542,Dai; Yinlin,90,0,95,5
1739703852296,ECON 120A,A02,814543,Dai; Yinlin,94,0,95,1
1739703852296,ECON 120A,B01,814545,Dai; Yinlin,93,0,95,2
1739703852296,ECON 120A,B02,814546,Dai; Yinlin,94,0,95,1
1739703853328,ECON 120B,A01,814548,Candido; Maria Teresa,91,0,95,4
1739703853328,ECON 120B,A02,814549,Candido; Maria Teresa,89,0,95,6
1739703853328,ECON 120B,B01,814551,Candido; Maria Teresa,91,0,95,4
1739703853328,ECON 120B,B02,814552,Candido; Maria Teresa,95,0,95,0
1739703854359,ECON 120C,A01,814554,Sun; Yixiao,38,0,40,2
1739703854359,ECON 120C,B01,814556,Sun; Yixiao,33,0,40,7
1739703854359,ECON 120C,C01,814585,Sun; Yixiao,39,0,40,1
1739703855386,ECON 125,A00,814588,Vogl; Tom Saul,96,0,100,4
1739703856412,ECON 129,A00,814589,Eckert; Fabian Paul,99,0,100,1
1739703857441,ECON 132,A00,814595,Carson; Richard T,72,0,75,3
1739703857441,ECON 132,B00,814599,Carson; Richard T,73,0,75,2
1739703858466,ECON 132T,A00,814600,Carson; Richard T,20,0,20,0
1739703859490,ECON 134,A00,814601,Gelber; Alexander Michael,47,0,50,3
1739703860517,ECON 137,A00,814602,Niehaus; Paul,20,0,20,0
1739703861543,ECON 140,A00,814630,Clemens; Jeffrey,44,0,49,5
1739703862574,ECON 142,A00,814647,Trevino; Isabel,50,0,50,0
1739703862574,ECON 142,B00,814656,Trevino; Isabel,45,0,50,5
1739703863601,ECON 147,A00,814683,Betts; Julian,100,0,100,0
1739703864627,ECON 164,A00,814684,Muralidharan; Karthik,219,0,220,1
1739703865652,ECON 168,A00,814691,Maron; Asa,74,0,80,6
1739703866677,ECON 173B,A01,814700,Levkoff; Steven B.,39,0,40,1
1739703866677,ECON 173B,B01,814734,Levkoff; Steven B.,40,0,40,0
1739703867703,ECON 191A,A00,814768,Cullen; Julie,20,0,20,0
1739703868732,ECON 200C,A00,814811,Grigoryan; Aram & Trevino; Isabel & Sobel; Joel,24,0,25,1
1739703869770,ECON 210C,A00,814815,Herreno Lopera; Juan,25,0,25,0
1739703870796,ECON 220C,A00,814816,Sun; Yixiao,23,0,25,2
1739703871826,ECON 220F,A00,814817,Carson; Richard T,28,0,30,2
1739703872851,ECON 221,A00,814818,Zhu; Ying,15,0,15,0
1739703873876,ECON 241,A00,814819,Muralidharan; Karthik,14,0,15,1
1739703874940,ECON 243,A00,814820,Niehaus; Paul & Adhvaryu; Achyuta Rasendra,15,0,15,0
1739703875966,ECON 248,A00,814821,Eckert; Fabian Paul & Trottner; Fabian Gunter We,13,0,15,2
1739703876996,ECON 250C,A00,814840,Arnold; David Hall & Betts; Julian,24,0,25,1
1739703878023,ECON 281,A00,814850,Wu; Pak Yeung & Herreno Lopera; Juan,14,0,15,1
1739703879050,ECON 285,A00,814851,Eckert; Fabian Paul,25,0,25,0
1739703880076,ECON 286,A00,814852,Hamilton; James D.,20,0,20,0
1739703880076,ECON 286,B00,814853,Shishkin; Denis,19,0,20,1
1739703881105,ECON 296,A00,814854,Eckert; Fabian Paul,24,0,25,1
1739703882132,EDS 31,A00,815023,Brydges; Stacey,17,0,20,3
1739703883158,EDS 39,A01,815025,Heinzman; Erica M.,25,0,25,0
1739703884186,EDS 102,A01,815042,Hopkins; Megan Beth,40,0,45,5
1739703886240,EDS 115,A00,815058,Jones; Gabrielle Anastasia,48,0,50,2
1739703887266,EDS 117,A01,851605,Jones; Makeba,33,0,37,4
1739703887266,EDS 117,A02,851607,Jones; Makeba,35,0,37,2
1739703887266,EDS 117,A03,851608,Jones; Makeba,38,0,38,0
1739703887266,EDS 117,A04,851610,Jones; Makeba,36,0,38,2
1739703887266,EDS 117,B01,870849,Staff,24,0,25,1
1739703887266,EDS 117,B02,870920,Staff,25,0,25,0
1739703887266,EDS 117,B03,870978,Staff,25,0,25,0
1739703887266,EDS 117,B04,870979,Staff,25,0,25,0
1739703888290,EDS 118,A00,815184,Staff,57,0,60,3
1739703889316,EDS 123,A00,815186,Brydges; Stacey,20,0,20,0
1739703890339,EDS 124AR,A00,815196,Simon; Elizabeth A,189,0,200,11
1739703890339,EDS 124AR,B00,815197,Simon; Elizabeth A,99,0,100,1
1739703890339,EDS 124AR,C00,872649,Simon; Elizabeth A,40,0,40,0
1739703891363,EDS 124BR,A00,815259,Eguchi; Emi,57,0,75,18
1739703891363,EDS 124BR,B00,872641,Eguchi; Emi,25,0,25,0
1739703892390,EDS 125,A00,815260,Aragon; Maria Jose,55,0,60,5
1739703893415,EDS 126,A01,851619,Jones; Makeba,25,0,33,8
1739703893415,EDS 126,A02,815283,Jones; Makeba,31,0,33,2
1739703893415,EDS 126,A03,815284,Jones; Makeba,33,0,34,1
1739703894441,EDS 128B,A01,815311,Pappas; Elizabeth,24,0,25,1
1739703894441,EDS 128B,A02,815312,Pappas; Elizabeth,25,0,25,0
1739703894441,EDS 128B,A03,870748,Pappas; Elizabeth,20,0,20,0
1739703895467,EDS 129C,A01,815314,Millstone; Rachel Diana,60,0,60,0
1739703896492,EDS 130,A01,815383,Mendez; Kathrina Mendoza,18,0,20,2
1739703896492,EDS 130,A02,815384,Mendez; Kathrina Mendoza,20,0,20,0
1739703896492,EDS 130,A03,815390,Mendez; Kathrina Mendoza,20,0,20,0
1739703897522,EDS 133,A01,815456,Bintliff; Amy S.V.,12,0,15,3
1739703897522,EDS 133,A02,815457,Bintliff; Amy S.V.,15,0,15,0
1739703897522,EDS 133,A03,815458,Bintliff; Amy S.V.,14,0,15,1
1739703897522,EDS 133,A04,815459,Bintliff; Amy S.V.,10,0,10,0
1739703898552,EDS 136,A01,815462,Hemans; Patricia Ann Benitez,17,0,20,3
1739703898552,EDS 136,A02,815463,Hemans; Patricia Ann Benitez,20,0,20,0
1739703898552,EDS 136,A03,815467,Hemans; Patricia Ann Benitez,20,0,20,0
1739703899581,EDS 139,A00,815469,Pappas; Elizabeth,47,0,50,3
1739703899581,EDS 139,B00,815470,Millstone; Rachel Diana,60,0,60,0
1739703899581,EDS 139,C00,815471,Mendez; Kathrina Mendoza,58,0,60,2
1739703899581,EDS 139,D00,815472,Bintliff; Amy S.V.,57,0,60,3
1739703899581,EDS 139,E00,815473,Hemans; Patricia Ann Benitez,57,0,60,3
1739703899581,EDS 139,F00,815474,Mamas; Christoforos,32,0,35,3
1739703899581,EDS 139,G00,815583,Choi; Bailey Miyeon,30,0,30,0
1739703899581,EDS 139,H00,815588,Bintliff; Amy S.V.,20,0,20,0
1739703900609,EDS 141,A00,815592,Mamas; Christoforos,34,0,35,1
1739703901635,EDS 145,A01,815629,Choi; Bailey Miyeon,13,0,15,2
1739703901635,EDS 145,A02,815630,Choi; Bailey Miyeon,15,0,15,0
1739703902663,EDS 164R,A01,815632,Staff,37,0,40,3
1739703902663,EDS 164R,B01,872639,Staff,20,0,20,0
1739703903691,EDS 165,A00,815635,Jones; Gabrielle Anastasia,29,0,30,1
1739703904718,EDS 180,A00,815642,Chapman; Thandeka K,24,0,25,1
1739703904718,EDS 180,B00,886111,Eguchi; Emi,30,0,30,0
1739703905746,EDS 190,A00,889678,Bintliff; Amy S.V.,4,0,5,1
1739703906772,EDS 205B,A00,815645,Halter; Christopher P.,48,0,50,2
1739703907799,EDS 253,A00,815646,Staff,14,0,15,1
1739703908825,EDS 266,A00,815647,Phuong; Andrew,11,0,12,1
1739703909852,EDS 282,A00,815649,Daly; Alan J.,15,0,15,0
1739703910877,EDS 287B,A00,815650,Daly; Alan J.,15,0,15,0
1739703911902,EDS 288A,A00,815651,Bjorklund; Peter,15,0,15,0
1739703912930,EDS 288B,A00,815694,Chapman; Thandeka K,19,0,20,1
1739703913955,EDS 288C,A00,815695,Staff,15,0,15,0
1739703914980,EDS 289B,A01,815710,Daly; Alan J.,15,0,15,0
1739703916209,EDS 290,A00,815711,Millstone; Rachel Diana,20,0,20,0
1739703916209,EDS 290,B00,815712,Heinzman; Erica M.,20,0,20,0
1739703916209,EDS 290,C00,815717,Choi; Bailey Miyeon,21,0,21,0
1739703916209,EDS 290,D00,815727,Black; Alison Michelle,20,0,20,0
1739703917236,EDS 293B,A01,815735,Burrell; Sade Renee,15,0,15,0
1739703918264,EDS 294B,A00,815745,Meyerott; Theresa Ann,15,0,15,0
1739703919290,EDS 296,001,814911,Ambo; Theresa Jean,10,0,10,0
1739703919290,EDS 296,002,814917,Aragon; Maria Jose,9,0,10,1
1739703919290,EDS 296,003,814918,Bintliff; Amy S.V.,10,0,10,0
1739703919290,EDS 296,004,814922,Chapman; Thandeka K,10,0,10,0
1739703919290,EDS 296,005,814927,Cohen; Shana R,10,0,10,0
1739703919290,EDS 296,006,814929,Daly; Alan J.,10,0,10,0
1739703919290,EDS 296,007,814930,Eguchi; Emi,10,0,10,0
1739703919290,EDS 296,008,814947,Datnow; Amanda Lee,10,0,10,0
1739703919290,EDS 296,009,814948,Halter; Christopher P.,10,0,10,0
1739703919290,EDS 296,010,814953,Hofstetter; Carolyn,10,0,10,0
1739703919290,EDS 296,011,814954,Hopkins; Megan Beth,10,0,10,0
1739703919290,EDS 296,012,814955,Jones; Gabrielle Anastasia,10,0,10,0
1739703919290,EDS 296,013,814958,Jones; Makeba,10,0,10,0
1739703919290,EDS 296,014,814961,Mamas; Christoforos,10,0,10,0
1739703919290,EDS 296,015,814962,Museus; Samuel David,10,0,10,0
1739703919290,EDS 296,016,814966,Pollock; Mica,10,0,10,0
1739703919290,EDS 296,017,814967,Wishard Guerra; Alison G.,10,0,10,0
1739703919290,EDS 296,018,886234,Clarke; Sherice Nicole,10,0,10,0
1739703919290,EDS 296,019,886235,Cohen; Shana R,10,0,10,0
1739703919290,EDS 296,020,886236,Fine; Sarah,10,0,10,0
1739703920322,EMED 296,001,866359,Daniel; Michelle Marie,4,0,5,1
1739703920322,EMED 296,002,866361,Staff,5,0,5,0
1739703920322,EMED 296,003,866363,Staff,5,0,5,0
1739703921347,ENG 10,A00,813776,Evdokimenko; Ekaterina,60,0,60,0
1739703922371,ENG 30,A01,869879,Schurgers; Curt,30,0,30,0
1739703923399,ENG 100D,A00,813777,Ngo; Anh-Thu T.,43,0,50,7
1739703923399,ENG 100D,B00,887051,Ngo; Anh-Thu T.,48,0,50,2
1739703924425,ENG 100L,A00,813778,Kleissl; Jan,6,0,6,0
1739703924425,ENG 100L,B00,813780,Bratton; Maryann,8,0,8,0
1739703924425,ENG 100L,C00,813781,Yu; Paul K L,8,0,8,0
1739703924425,ENG 100L,D00,813782,Goldberg; Charles G.,6,0,6,0
1739703924425,ENG 100L,E00,813783,de Oliveira; Mauricio,8,0,8,0
1739703924425,ENG 100L,F00,813852,Bratton; Maryann,6,0,6,0
1739703924425,ENG 100L,G00,813856,Boyle; Mary E. T.,15,0,15,0
1739703924425,ENG 100L,H00,813860,Boyle; Mary E. T.,15,0,15,0
1739703925456,ENVR 102,A00,818253,Lin; Cindy Jih-Shing,23,0,25,2
1739703925456,ENVR 102,B00,818254,Montejo; Carolina,25,0,25,0
1739703925456,ENVR 102,C00,818255,Staff,24,0,25,1
1739703925456,ENVR 102,E00,818257,Daly; Heather Marie,18,0,20,2
1739703926487,ENVR 140,A01,818259,Siapno; Jacqueline A,13,0,15,2
1739703926487,ENVR 140,A02,818260,Siapno; Jacqueline A,13,0,15,2
1739703926487,ENVR 140,A03,818261,Siapno; Jacqueline A,13,0,15,2
1739703926487,ENVR 140,A04,818290,Siapno; Jacqueline A,14,0,15,1
1739703927518,ESYS 103,A01,818299,Lerner; Amy M,30,0,34,4
1739703927518,ESYS 103,A02,818300,Lerner; Amy M,33,0,34,1
1739703927518,ESYS 103,A03,818301,Lerner; Amy M,24,0,34,10
1739703927518,ESYS 103,A04,818302,Lerner; Amy M,32,0,34,2
1739703927518,ESYS 103,A05,818322,Lerner; Amy M,31,0,34,3
1739703927518,ESYS 103,A06,818385,Lerner; Amy M,30,0,30,0
1739703928543,ESYS 187C,A01,818387,Hetherington; Elizabeth Dorsey,32,0,40,8
1739703928543,ESYS 187C,A02,818388,Hetherington; Elizabeth Dorsey,39,0,40,1
1739703929570,ETHN 3R,A01,818390,Okonkwo; Holly,20,0,25,5
1739703929570,ETHN 3R,A02,818391,Okonkwo; Holly,24,0,25,1
1739703929570,ETHN 3R,A03,818392,Okonkwo; Holly,23,0,25,2
1739703929570,ETHN 3R,A04,818393,Okonkwo; Holly,23,0,25,2
1739703929570,ETHN 3R,A05,818394,Okonkwo; Holly,22,0,25,3
1739703929570,ETHN 3R,A06,818395,Okonkwo; Holly,22,0,25,3
1739703929570,ETHN 3R,A07,818396,Okonkwo; Holly,23,0,25,2
1739703929570,ETHN 3R,A08,818397,Okonkwo; Holly,25,0,25,0
1739703929570,ETHN 3R,A09,818398,Okonkwo; Holly,25,0,25,0
1739703929570,ETHN 3R,A10,818399,Okonkwo; Holly,23,0,25,2
1739703929570,ETHN 3R,A11,818400,Okonkwo; Holly,24,0,25,1
1739703929570,ETHN 3R,A12,818401,Okonkwo; Holly,24,0,25,1
1739703929570,ETHN 3R,A13,818402,Okonkwo; Holly,24,0,25,1
1739703929570,ETHN 3R,A14,818403,Okonkwo; Holly,23,0,25,2
1739703930652,ETHN 30,A01,818405,Fuste; Jose Ignacio,24,0,25,1
1739703930652,ETHN 30,A02,818406,Fuste; Jose Ignacio,22,0,25,3
1739703930652,ETHN 30,A03,818407,Fuste; Jose Ignacio,25,0,25,0
1739703930652,ETHN 30,A04,818408,Fuste; Jose Ignacio,25,0,25,0
1739703930652,ETHN 30,A05,818409,Fuste; Jose Ignacio,25,0,25,0
1739703930652,ETHN 30,A06,818410,Fuste; Jose Ignacio,25,0,25,0
1739703931679,ETHN 100C,A00,818411,Fuste; Jose Ignacio,32,0,36,4
1739703932708,ETHN 101,A01,818413,Marez; Curtis F.,23,0,25,2
1739703932708,ETHN 101,A02,818414,Marez; Curtis F.,24,0,25,1
1739703932708,ETHN 101,A03,818415,Marez; Curtis F.,25,0,25,0
1739703932708,ETHN 101,A04,818416,Marez; Curtis F.,23,0,25,2
1739703933735,ETHN 108,A00,818418,Hankins; Sarah E.,15,0,20,5
1739703934760,ETHN 110,A00,818419,Klann; Mary Cameron,23,0,30,7
1739703935786,ETHN 112C,A00,818420,Frank; Ross H.,28,0,30,2
1739703936813,ETHN 121R,A00,818422,Choi; Esther Min,35,0,45,10
1739703937839,ETHN 122B,A00,891172,Museus; Samuel David,50,0,50,0
1739703939887,ETHN 127,A00,818424,Cuong; Marisol,27,0,30,3
1739703940915,ETHN 140,A00,818426,Tran; Ly Thi Hai,30,0,30,0
1739703941944,ETHN 142,A00,818429,Wilson; Brenda K,27,0,30,3
1739703942972,ETHN 147,A00,872912,Staff,20,0,20,0
1739703943999,ETHN 171,A00,869845,Gallagher-Geurtsen; Tricia Meghan,29,0,30,1
1739703945024,ETHN 172,A00,818477,Childs; Dennis R.,20,0,20,0
1739703946048,ETHN 174,A00,818481,Childs; Dennis R.,20,0,20,0
1739703947076,ETHN 182,A00,818487,Streeby; Shelley,58,0,60,2
1739703948100,ETHN 183,A00,818489,Cuong; Marisol,21,0,22,1
1739703949126,ETHN 189,A00,818496,Museus; Samuel David,20,0,20,0
1739703950156,ETHN 196H,A00,885505,Fuste; Jose Ignacio,0,0,0,0
1739703950156,ETHN 196H,B00,885506,Klann; Mary Cameron,0,0,0,0
1739703950156,ETHN 196H,C00,885507,Museus; Samuel David,0,0,0,0
1739703950156,ETHN 196H,D00,885524,Taylor-Garcia; Daphne,0,0,0,0
1739703950156,ETHN 196H,E00,885706,Wilson; Brenda K,0,0,0,1
1739703951183,ETHN 200C,A00,818498,Frank; Ross H.,11,0,15,4
1739703952209,ETHN 230,A00,818501,Perreira; Christopher Michael,11,0,15,4
1739703953236,ETHN 291,A00,818504,Streeby; Shelley,15,0,15,0
1739703954263,ETIM 289,A00,818674,Marez; Curtis F.,11,0,15,4
1739703955287,EXPR 100,A00,871385,Staff,9999,0,9999,0
1739703956315,EXPR 105,A00,871455,Staff,9999,0,9999,0
1739703957339,EXPR 201,A00,871548,Staff,9999,0,9999,0
1739703958368,EXPR 205,A00,871602,Staff,9999,0,9999,0
1739703959392,FILM 71,A01,809813,Staff,9,0,10,1
1739703960417,FILM 72,A01,871143,Staff,9,0,10,1
1739703961442,FILM 73,A01,871145,Staff,8,0,10,2
1739703962471,FILM 87,A00,809816,Rahimi; Babak,20,0,20,0
1739703962471,FILM 87,B00,809859,Rahimi; Babak,20,0,20,0
1739703962471,FILM 87,C00,869076,Havis; Allan,19,0,20,1
1739703963502,FMPH 291,A00,818678,Boutelle; Kerri & Eichen; Dawn,13,0,15,2
1739703963502,FMPH 291,B00,818689,Lacroix; Andrea Zauderer,12,0,15,3
1739703963502,FMPH 291,C00,818694,Shadyab; Aladdin Hassan,15,0,15,0
1739703963502,FMPH 291,D00,818695,Salem; Rany Mansour,12,0,15,3
1739703963502,FMPH 291,E00,818704,Shadyab; Aladdin Hassan,14,0,15,1
1739703963502,FMPH 291,F00,872513,Araneta; Maria Rosario Gorrez,12,0,15,3
1739703963502,FMPH 291,G00,876306,Ross; Camille,13,0,15,2
1739703964527,FPM 276,A00,886086,Zhu; Shu-Hong,14,0,15,1
1739703965555,FPM 286,A00,866428,Johnson; Michelle Lee,0,0,0,0
1739703966580,FPM 296,001,866429,Johnson; Michelle Lee,4,0,5,1
1739703966580,FPM 296,002,866430,Araneta; Maria Rosario Gorrez,5,0,5,0
1739703966580,FPM 296,003,866433,Staff,5,0,5,0
1739703967606,FPM 297,001,881032,Strong; David R,9998,0,9999,1
1739703968631,GLBH 20,A00,818752,Elwardani; Nile Regina,143,0,146,3
1739703969658,GLBH 101,A00,818757,Sloane; Julia Kathryn,39,0,40,1
1739703970684,GLBH 107,A00,818758,Wilson; Brenda K,65,0,70,5
1739703971711,GLBH 108,A00,818759,Olivas Hernandez; Olga Lid,68,0,70,2
1739703972738,GLBH 111,A01,818761,Burgos; Jose L.,0,0,0,0
1739703972738,GLBH 111,B01,818763,Burgos; Jose L.,0,0,0,0
1739703973763,GLBH 114W,A00,818764,Walkover; Lillian B,16,0,17,1
1739703975812,GLBH 121,A00,870699,Villarino; Margarita,42,0,44,2
1739703976838,GLBH 130,A00,870701,Schonberg; Jeffrey,38,0,40,2
1739703977865,GLBH 131,A00,870812,Staff,43,0,44,1
1739703978893,GLBH 147,A00,818766,Stewart; Alexander B,38,0,40,2
1739703979918,GLBH 148,A00,818828,Schonberg; Jeffrey,95,0,100,5
1739703980945,GLBH 150B,A00,818838,Kaiser; Bronwyn Nicole,14,0,15,1
1739703981973,GLBH 181,A00,818842,Burgos; Jose L.,207,0,216,9
1739703983000,GLBH 190,A00,870700,Bhavsar; Radhika,44,0,44,0
1739703984025,GLBH 215,A00,818849,Walkover; Lillian B,7,0,16,9
1739703985049,GLBH 260,A00,818858,Elwardani; Nile Regina,16,0,16,0
1739703986073,GSS 20,A00,818859,Siapno; Jacqueline A,27,0,30,3
1739703987098,GSS 21,A00,818860,Gyamfi; Bright,29,0,30,1
1739703988123,HDS 1,A01,819050,Staff,29,0,30,1
1739703988123,HDS 1,A02,819053,Staff,28,0,30,2
1739703988123,HDS 1,A03,819074,Staff,29,0,30,1
1739703988123,HDS 1,A04,819075,Staff,30,0,30,0
1739703988123,HDS 1,A05,819076,Staff,29,0,30,1
1739703988123,HDS 1,A06,819077,Staff,30,0,30,0
1739703988123,HDS 1,A07,819078,Staff,29,0,30,1
1739703989147,HDS 60,A01,819095,Staff,32,0,35,3
1739703989147,HDS 60,A02,819096,Staff,35,0,35,0
1739703990171,HDS 95,A00,819097,Staff,36,0,40,4
1739703991198,HDS 120,A00,819098,Staff,91,0,100,9
1739703992223,HDS 122,A00,819099,Staff,96,0,100,4
1739703993250,HDS 150,A00,819100,Staff,12,0,12,0
1739703993250,HDS 150,B00,819122,Staff,12,0,12,0
1739703993250,HDS 150,C00,819123,Staff,12,0,12,0
1739703994276,HDS 175,A00,819142,Staff,32,0,35,3
1739703995301,HDS 181,A01,819144,Staff,35,0,35,0
1739703996326,HDS 191,A01,819146,Staff,20,0,20,0
1739703996326,HDS 191,B01,819223,Staff,20,0,20,0
1739703997352,HIAF 112,A00,841742,Gyamfi; Bright,45,0,46,1
1739703998380,HIEA 114,A00,841743,Matsumura; Wendy Y,36,0,50,14
1739703999406,HIEA 131,A00,841744,Muscolino; Micah S,41,0,44,3
1739704000431,HIEA 138,A00,841747,Lu; Weijing,30,0,30,0
1739704001456,HIEA 144,A00,870811,Henry; Todd A.,24,0,25,1
1739704002480,HIEU 128,A00,841749,Hansen; Jan Eric,66,0,70,4
1739704003508,HIEU 138,A00,841750,Devereux; Andrew W,53,0,56,3
1739704004536,HIEU 146,A00,841751,Radcliff; Pamela B.,44,0,50,6
1739704005560,HIEU 148,A00,841753,Biess; Frank Peter,116,0,120,4
1739704006587,HIEU 160,A00,841754,Demetriou; Denise,11,0,15,4
1739704007611,HIEU 183,A00,870697,Gallant; Thomas W.,10,0,10,0
1739704008636,HIEU 184,A00,841757,Patterson; Patrick H.,15,0,15,0
1739704009660,HIEU 283,A00,870698,Gallant; Thomas W.,10,0,10,0
1739704010689,HIGL 126,A00,841758,Gerth; Karl G.,34,0,34,0
1739704011716,HIGR 209,A00,841771,Hanna; Mark G.,10,0,10,0
1739704012741,HIGR 210,A00,841772,Gerth; Karl G.,9,0,10,1
1739704013769,HIGR 220,A00,872411,Strasser; Ulrike,9,0,10,1
1739704014795,HIGR 239,A00,841774,Gere; Catherina M.,9,0,10,1
1739704015821,HIGR 240,A00,841777,McKenzie; Kerry V.,9,0,10,1
1739704016846,HIGR 248B,A00,841778,Vitz; Matthew,10,0,10,0
1739704017874,HIGR 280,A00,841779,Devereux; Andrew W,10,0,10,0
1739704018899,HIGR 282,A00,871856,Henry; Todd A.,10,0,10,0
1739704019928,HILA 132,A00,841759,Vitz; Matthew,141,0,146,5
1739704020956,HILA 144P,A00,869962,Murillo; Dana V.,49,0,50,1
1739704021984,HILD 2C,A01,862763,Hendrickson; Gerald M.,30,0,32,2
1739704021984,HILD 2C,A02,862769,Hendrickson; Gerald M.,30,0,32,2
1739704021984,HILD 2C,A03,862772,Hendrickson; Gerald M.,32,0,32,0
1739704021984,HILD 2C,A04,862774,Hendrickson; Gerald M.,32,0,32,0
1739704021984,HILD 2C,A05,862777,Hendrickson; Gerald M.,31,0,32,1
1739704021984,HILD 2C,A06,862778,Hendrickson; Gerald M.,32,0,32,0
1739704023011,HILD 7B,A01,862780,Martinez-Matsuda; Veronica,32,0,32,0
1739704023011,HILD 7B,A02,862781,Martinez-Matsuda; Veronica,32,0,32,0
1739704023011,HILD 7B,A03,862782,Martinez-Matsuda; Veronica,29,0,32,3
1739704023011,HILD 7B,A04,862783,Martinez-Matsuda; Veronica,31,0,32,1
1739704023011,HILD 7B,A05,862784,Martinez-Matsuda; Veronica,28,0,32,4
1739704023011,HILD 7B,A06,862788,Martinez-Matsuda; Veronica,31,0,32,1
1739704023011,HILD 7B,A07,862789,Martinez-Matsuda; Veronica,32,0,32,0
1739704023011,HILD 7B,A08,862797,Martinez-Matsuda; Veronica,32,0,32,0
1739704023011,HILD 7B,A09,862798,Martinez-Matsuda; Veronica,32,0,32,0
1739704023011,HILD 7B,A10,862799,Martinez-Matsuda; Veronica,30,0,32,2
1739704023011,HILD 7B,A11,862801,Martinez-Matsuda; Veronica,32,0,32,0
1739704023011,HILD 7B,A12,862802,Martinez-Matsuda; Veronica,32,0,32,0
1739704024041,HILD 12,A01,862804,Matsumura; Wendy Y,31,0,32,1
1739704024041,HILD 12,A02,862987,Matsumura; Wendy Y,31,0,32,1
1739704024041,HILD 12,A03,862989,Matsumura; Wendy Y,0,0,0,0
1739704024041,HILD 12,A04,862991,Matsumura; Wendy Y,0,0,0,0
1739704024041,HILD 12,A05,863014,Matsumura; Wendy Y,31,0,32,1
1739704024041,HILD 12,A06,863015,Matsumura; Wendy Y,32,0,32,0
1739704025070,HILD 42,A01,863016,Gere; Catherina M.,31,0,32,1
1739704025070,HILD 42,A02,863017,Gere; Catherina M.,32,0,32,0
1739704026097,HINE 115,A00,841762,Balberg; Mira,44,0,56,12
1739704027124,HINE 116,A00,869964,Gokatalay; Semih,35,0,35,0
1739704028150,HINE 120,A00,869963,Gokatalay; Semih,35,0,35,0
1739704029177,HISA 101,A00,871799,De; Aniket,35,0,35,0
1739704030205,HISA 120,A00,871840,De; Aniket,34,0,35,1
1739704031230,HITO 87,A00,841738,Patterson; Patrick H.,15,0,15,0
1739704031230,HITO 87,B00,841740,Patterson; Patrick H.,14,0,15,1
1739704032257,HITO 100,B00,841764,Kwak; Nancy,23,0,25,2
1739704033281,HITO 170,A00,841765,Watts; Edward J.,9,0,10,1
1739704034363,HITO 193,A00,851603,Staff,0,0,0,0
1739704035387,HIUS 104,A00,841766,Hanna; Mark G.,142,0,146,4
1739704036416,HIUS 114A,A00,841767,Lewandoski; Julia Mavis,48,0,50,2
1739704037444,HIUS 144,B00,841769,Daly; Heather Marie,39,0,40,1
1739704038486,HUM 2,A01,832551,Crum; Matthew Stephen,15,0,15,0
1739704038486,HUM 2,A02,832552,Crum; Matthew Stephen,14,0,15,1
1739704038486,HUM 2,A03,832553,Crum; Matthew Stephen,15,0,15,0
1739704038486,HUM 2,A04,832554,Crum; Matthew Stephen,14,0,15,1
1739704038486,HUM 2,A05,832555,Crum; Matthew Stephen,15,0,15,0
1739704038486,HUM 2,A06,832557,Crum; Matthew Stephen,14,0,15,1
1739704038486,HUM 2,A07,832600,Crum; Matthew Stephen,14,0,15,1
1739704038486,HUM 2,A08,832662,Crum; Matthew Stephen,15,0,15,0
1739704038486,HUM 2,A09,832667,Crum; Matthew Stephen,13,0,15,2
1739704038486,HUM 2,A10,832671,Crum; Matthew Stephen,15,0,15,0
1739704038486,HUM 2,A11,832673,Crum; Matthew Stephen,15,0,15,0
1739704038486,HUM 2,A12,832675,Crum; Matthew Stephen,15,0,15,0
1739704038486,HUM 2,A13,832680,Crum; Matthew Stephen,15,0,15,0
1739704038486,HUM 2,A14,832682,Crum; Matthew Stephen,15,0,15,0
1739704038486,HUM 2,B01,832686,Watts; Edward J.,7,0,15,8
1739704038486,HUM 2,B02,832688,Watts; Edward J.,14,0,15,1
1739704038486,HUM 2,B03,832693,Watts; Edward J.,15,0,15,0
1739704038486,HUM 2,B04,832694,Watts; Edward J.,15,0,15,0
1739704038486,HUM 2,B05,832739,Watts; Edward J.,15,0,15,0
1739704038486,HUM 2,B06,832742,Watts; Edward J.,14,0,15,1
1739704038486,HUM 2,B07,832756,Watts; Edward J.,15,0,15,0
1739704038486,HUM 2,B08,832760,Watts; Edward J.,13,0,15,2
1739704038486,HUM 2,B09,832762,Watts; Edward J.,15,0,15,0
1739704038486,HUM 2,B10,832764,Watts; Edward J.,13,0,15,2
1739704038486,HUM 2,B11,832767,Watts; Edward J.,15,0,15,0
1739704038486,HUM 2,B12,832770,Watts; Edward J.,14,0,15,1
1739704038486,HUM 2,B13,832775,Watts; Edward J.,13,0,15,2
1739704038486,HUM 2,B14,832776,Watts; Edward J.,12,0,15,3
1739704038486,HUM 2,C01,832784,Markman; Kristina,15,0,15,0
1739704038486,HUM 2,C02,832785,Markman; Kristina,15,0,15,0
1739704038486,HUM 2,C03,832787,Markman; Kristina,14,0,15,1
1739704038486,HUM 2,C04,832789,Markman; Kristina,6,0,15,9
1739704038486,HUM 2,C05,832790,Markman; Kristina,15,0,15,0
1739704038486,HUM 2,C06,832793,Markman; Kristina,15,0,15,0
1739704038486,HUM 2,C07,832794,Markman; Kristina,15,0,15,0
1739704038486,HUM 2,C08,832804,Markman; Kristina,15,0,15,0
1739704038486,HUM 2,C09,832805,Markman; Kristina,15,0,15,0
1739704038486,HUM 2,C10,832946,Markman; Kristina,14,0,15,1
1739704038486,HUM 2,C11,833014,Markman; Kristina,15,0,15,0
1739704038486,HUM 2,C12,833037,Markman; Kristina,15,0,15,0
1739704038486,HUM 2,C13,833075,Markman; Kristina,15,0,15,0
1739704038486,HUM 2,C14,833078,Markman; Kristina,13,0,15,2
1739704039512,HUM 5,A01,833083,Lyon; Antony J.,21,0,28,7
1739704039512,HUM 5,A02,833086,Lyon; Antony J.,28,0,28,0
1739704039512,HUM 5,A03,833090,Lyon; Antony J.,27,0,28,1
1739704039512,HUM 5,A04,833095,Lyon; Antony J.,26,0,28,2
1739704039512,HUM 5,A05,833096,Lyon; Antony J.,27,0,28,1
1739704039512,HUM 5,A06,833099,Lyon; Antony J.,26,0,28,2
1739704039512,HUM 5,A07,833110,Lyon; Antony J.,26,0,28,2
1739704039512,HUM 5,A08,833112,Lyon; Antony J.,27,0,28,1
1739704039512,HUM 5,B01,833118,Rodriguez; Bretton Sigfred,24,0,28,4
1739704039512,HUM 5,B02,833122,Rodriguez; Bretton Sigfred,25,0,28,3
1739704039512,HUM 5,B03,833128,Rodriguez; Bretton Sigfred,19,0,28,9
1739704039512,HUM 5,B04,833129,Rodriguez; Bretton Sigfred,24,0,28,4
1739704039512,HUM 5,B05,833133,Rodriguez; Bretton Sigfred,27,0,28,1
1739704039512,HUM 5,B06,833138,Rodriguez; Bretton Sigfred,27,0,28,1
1739704039512,HUM 5,B07,833140,Rodriguez; Bretton Sigfred,27,0,28,1
1739704039512,HUM 5,B08,833141,Rodriguez; Bretton Sigfred,28,0,28,0
1739704039512,HUM 5,C01,833158,West; Geoffrey Scott,20,0,28,8
1739704039512,HUM 5,C02,833159,West; Geoffrey Scott,23,0,28,5
1739704039512,HUM 5,C03,833163,West; Geoffrey Scott,28,0,28,0
1739704039512,HUM 5,C04,833165,West; Geoffrey Scott,27,0,28,1
1739704039512,HUM 5,C05,833168,West; Geoffrey Scott,26,0,28,2
1739704039512,HUM 5,C06,833171,West; Geoffrey Scott,23,0,28,5
1739704039512,HUM 5,C07,833172,West; Geoffrey Scott,26,0,28,2
1739704039512,HUM 5,C08,833176,West; Geoffrey Scott,24,0,28,4
1739704040538,HUM 100,A00,833179,Shenoy; Niyati,16,0,16,0
1739704040538,HUM 100,B00,833180,Shenoy; Niyati,16,0,16,0
1739704040538,HUM 100,C00,833187,Zavodny; Tatiana Sophia,15,0,16,1
1739704040538,HUM 100,D00,833190,Zavodny; Tatiana Sophia,15,0,16,1
1739704040538,HUM 100,E00,833196,West; Geoffrey Scott,15,0,16,1
1739704040538,HUM 100,F00,833199,West; Geoffrey Scott,15,0,16,1
1739704041568,INTL 100,A01,819235,Feuer; Anna Stagg,24,0,25,1
1739704041568,INTL 100,A02,819246,Feuer; Anna Stagg,24,0,25,1
1739704041568,INTL 100,A03,819251,Feuer; Anna Stagg,25,0,25,0
1739704041568,INTL 100,A04,819252,Feuer; Anna Stagg,21,0,25,4
1739704041568,INTL 100,A05,819256,Feuer; Anna Stagg,25,0,25,0
1739704041568,INTL 100,A06,819260,Feuer; Anna Stagg,25,0,25,0
1739704042597,INTL 101,A01,819264,McCord; Gordon Carlos,27,0,35,8
1739704042597,INTL 101,A02,819266,McCord; Gordon Carlos,32,0,35,3
1739704043623,INTL 102,A01,819271,Fisk; David Lee,29,0,35,6
1739704043623,INTL 102,A02,819279,Fisk; David Lee,27,0,35,8
1739704044650,INTL 190,A00,819281,Lettieri; Michael Joseph,0,0,0,2
1739704044650,INTL 190,B00,819301,Vos; Stacie N.,0,0,0,0
1739704044650,INTL 190,C00,819303,McIntosh; Justin,0,0,0,2
1739704044650,INTL 190,D00,819389,Segui; Alan S,0,0,0,2
1739704044650,INTL 190,E00,819393,Segui; Alan S,0,0,0,1
1739704044650,INTL 190,F00,819394,Auerbach; Bradford C,0,0,0,0
1739704044650,INTL 190,G00,819395,Samphantharak; Krislert,0,0,0,2
1739704045681,JAPN 10C,A01,819403,Maruyama; Rie,14,0,15,1
1739704045681,JAPN 10C,B01,819406,McKee; Mayumi Mochizuki,13,0,15,2
1739704045681,JAPN 10C,C01,819448,Ross; Kayoko F,14,0,15,1
1739704045681,JAPN 10C,D01,819450,Sato; Kyoko,15,0,15,0
1739704045681,JAPN 10C,E01,819454,Kamioka; Sachiko,13,0,15,2
1739704045681,JAPN 10C,F01,819457,McKee; Mayumi Mochizuki,10,0,15,5
1739704045681,JAPN 10C,G01,819459,Tipton; Yuko,12,0,15,3
1739704045681,JAPN 10C,H01,819466,Sato; Kyoko,15,0,15,0
1739704045681,JAPN 10C,I01,819486,Homma; Kunihiko,14,0,15,1
1739704045681,JAPN 10C,J01,819536,Tipton; Yuko,15,0,15,0
1739704045681,JAPN 10C,K01,819584,Kamioka; Sachiko,14,0,15,1
1739704046706,JAPN 10CR,A01,819684,Inada; Minori,12,0,12,0
1739704046706,JAPN 10CR,B01,819741,McKee; Mayumi Mochizuki,12,0,12,0
1739704047739,JAPN 20C,A01,819791,Iwamoto; Naoki,13,0,13,0
1739704047739,JAPN 20C,B01,819874,Homma; Kunihiko,12,0,13,1
1739704047739,JAPN 20C,C01,819904,Iwamoto; Naoki,12,0,13,1
1739704047739,JAPN 20C,D01,819934,Takeda; Izumi,12,0,13,1
1739704047739,JAPN 20C,E01,819936,Simpson; Junko Tokuda,13,0,13,0
1739704048765,JAPN 130C,A01,819938,Maruyama; Rie,12,0,12,0
1739704048765,JAPN 130C,B01,820148,Kamioka; Sachiko,9,0,12,3
1739704049794,JAPN 135C,A00,820169,Ross; Kayoko F,11,0,12,1
1739704049794,JAPN 135C,B00,820192,Iwamoto; Naoki,10,0,12,2
1739704050821,JAPN 137C,A00,820201,Simpson; Junko Tokuda,17,0,20,3
1739704051846,JAPN 140C,A00,820210,Takeda; Izumi,19,0,20,1
1739704052875,JWSP 3,A01,820218,Shuster; Alana,15,0,15,0
1739704053921,LATI 10,A01,820230,Kennemore; Amy Michelle,28,0,30,2
1739704053921,LATI 10,A02,820286,Kennemore; Amy Michelle,29,0,30,1
1739704053921,LATI 10,A03,820289,Kennemore; Amy Michelle,29,0,30,1
1739704053921,LATI 10,A04,820293,Kennemore; Amy Michelle,29,0,30,1
1739704053921,LATI 10,A05,820380,Kennemore; Amy Michelle,30,0,30,0
1739704053921,LATI 10,A06,820381,Kennemore; Amy Michelle,29,0,30,1
1739704054949,LATI 50,A01,820465,Kokinis; Troy Andreas,29,0,30,1
1739704054949,LATI 50,A02,820466,Kokinis; Troy Andreas,30,0,30,0
1739704054949,LATI 50,A03,820470,Kokinis; Troy Andreas,0,0,0,0
1739704054949,LATI 50,A04,820490,Kokinis; Troy Andreas,0,0,0,0
1739704054949,LATI 50,A05,872455,Kokinis; Troy Andreas,0,0,0,0
1739704055979,LATI 130,A00,820527,Alvarez; Camila Huerta,46,0,46,0
1739704057009,LATI 131,A00,869142,Villafuerte Vazquez; Nadia,30,0,30,0
1739704059060,LATI 166,A00,886084,Kokinis; Troy Andreas,42,0,42,0
1739704060083,LATI 180,A00,820555,Kennemore; Amy Michelle,40,0,44,4
1739704061112,LIAB 1C,B00,820742,Saab; Dima,12,0,14,2
1739704061112,LIAB 1C,C00,820744,Saab; Dima,12,0,14,2
1739704062137,LIAB 1CX,A00,820745,El Cheddadi; Youniss,25,0,28,3
1739704063165,LIAB 1F,A00,872423,El Cheddadi; Youniss,15,0,15,0
1739704064191,LIDS 19,001,886201,Goodall; Grant Todd,9999,0,9999,0
1739704064191,LIDS 19,002,886202,Goodall; Grant Todd,9999,0,9999,0
1739704064191,LIDS 19,003,886204,Goodall; Grant Todd,9999,0,9999,0
1739704064191,LIDS 19,004,886207,Goodall; Grant Todd,9999,0,9999,0
1739704064191,LIDS 19,005,886208,Goodall; Grant Todd,9999,0,9999,0
1739704064191,LIDS 19,006,886209,Goodall; Grant Todd,9999,0,9999,0
1739704064191,LIDS 19,007,886210,Goodall; Grant Todd,9999,0,9999,0
1739704064191,LIDS 19,008,886211,Goodall; Grant Todd,9999,0,9999,0
1739704064191,LIDS 19,009,886213,Goodall; Grant Todd,9999,0,9999,0
1739704064191,LIDS 19,010,886214,Goodall; Grant Todd,9999,0,9999,0
1739704064191,LIDS 19,011,886215,Goodall; Grant Todd,9999,0,9999,0
1739704064191,LIDS 19,012,886216,Goodall; Grant Todd,9999,0,9999,0
1739704065215,LIFR 1A,C00,820857,Van Moer; Vinciane G,12,0,14,2
1739704065215,LIFR 1A,D00,820858,Van Moer; Vinciane G,14,0,14,0
1739704066239,LIFR 1AX,B00,820861,Van Moer; Vinciane G,27,0,28,1
1739704067264,LIFR 1C,A00,820862,Van Moer; Vinciane G,12,0,14,2
1739704067264,LIFR 1C,B00,820916,Van Moer; Vinciane G,12,0,14,2
1739704067264,LIFR 1C,C00,820970,Van Moer; Vinciane G,14,0,14,0
1739704067264,LIFR 1C,D00,820971,Van Moer; Vinciane G,13,0,14,1
1739704068291,LIFR 1CX,A00,820972,Van Moer; Vinciane G,26,0,28,2
1739704068291,LIFR 1CX,B00,820973,Van Moer; Vinciane G,26,0,28,2
1739704069317,LIFR 1D,A00,820974,Van Moer; Vinciane G,13,0,14,1
1739704069317,LIFR 1D,B00,820975,Van Moer; Vinciane G,11,0,14,3
1739704069317,LIFR 1D,C00,820976,Van Moer; Vinciane G,14,0,14,0
1739704069317,LIFR 1D,D00,820977,Van Moer; Vinciane G,14,0,14,0
1739704070346,LIFR 1DX,A00,820978,Van Moer; Vinciane G,25,0,28,3
1739704070346,LIFR 1DX,B00,820979,Van Moer; Vinciane G,28,0,28,0
1739704071370,LIFR 11,001,820980,Goodall; Grant Todd,9999,0,9999,0
1739704072394,LIGM 1C,A00,820981,Fischer-Grunski; Eva K,14,0,14,0
1739704072394,LIGM 1C,B00,820982,Fischer-Grunski; Eva K,11,0,14,3
1739704073419,LIGM 1CX,A00,820985,Fischer-Grunski; Eva K,13,0,14,1
1739704073419,LIGM 1CX,B00,820986,Fischer-Grunski; Eva K,13,0,14,1
1739704074444,LIGM 11,001,820987,Goodall; Grant Todd,9999,0,9999,0
1739704075471,LIGN 8,A00,821976,McIntosh; Justin,238,0,250,12
1739704076496,LIGN 17,A00,821977,Kehler; Andrew Scott,247,0,250,3
1739704077525,LIGN 101,A01,821980,Staff,35,0,35,0
1739704077525,LIGN 101,A02,821982,Staff,35,0,35,0
1739704077525,LIGN 101,A03,821983,Staff,35,0,35,0
1739704077525,LIGN 101,A04,821984,Staff,35,0,35,0
1739704078550,LIGN 113,A00,821985,Styler; William Francis,88,0,90,2
1739704079577,LIGN 117,A00,869927,Kehler; Andrew Scott,42,0,50,8
1739704080606,LIGN 120,A01,821987,Caballero; Gabriela Hernandez,23,0,25,2
1739704080606,LIGN 120,A02,821988,Caballero; Gabriela Hernandez,22,0,25,3
1739704080606,LIGN 120,A03,821990,Caballero; Gabriela Hernandez,20,0,25,5
1739704081633,LIGN 146,A00,821992,Lott; Margaret S.,27,0,30,3
1739704082659,LIGN 165,A00,821993,Bergen; Leon,50,0,70,20
1739704083685,LIGN 180,A00,821994,Kluender; Robert,63,0,70,7
1739704084711,LIGN 188R,A00,821996,Clem; Emily,40,0,40,0
1739704085737,LIGN 200,A00,821997,Warstadt; Alexander Scott,35,0,35,0
1739704086765,LIGN 211,A00,821999,Bakovic; Eric John,20,0,20,0
1739704087791,LIGN 220,A00,822003,Caballero; Gabriela Hernandez,18,0,20,2
1739704088816,LIGN 225,A00,822004,Goodall; Grant Todd,20,0,20,0
1739704089840,LIGN 238,A00,822005,Bergen; Benjamin,20,0,20,0
1739704090865,LIGN 252,A00,822006,Bergen; Leon,14,0,15,1
1739704091891,LIGN 279,A00,822007,Dudley; Rachel,17,0,20,3
1739704092920,LIGN 296,001,821907,Ackerman; Farrell,5,0,5,0
1739704092920,LIGN 296,002,821908,Bakovic; Eric John,5,0,5,0
1739704092920,LIGN 296,003,821909,Bergen; Leon,5,0,5,0
1739704092920,LIGN 296,004,821910,Caballero; Gabriela Hernandez,5,0,5,0
1739704092920,LIGN 296,005,821912,Caponigro; Ivano,5,0,5,0
1739704092920,LIGN 296,006,821913,Clem; Emily,5,0,5,0
1739704092920,LIGN 296,007,821914,Dudley; Rachel,5,0,5,0
1739704092920,LIGN 296,008,821916,Garellek; Marc,5,0,5,0
1739704092920,LIGN 296,009,821917,Goodall; Grant Todd,5,0,5,0
1739704092920,LIGN 296,010,821918,Kehler; Andrew Scott,5,0,5,0
1739704092920,LIGN 296,011,821919,Kluender; Robert,5,0,5,0
1739704092920,LIGN 296,012,821920,Mayberry; Rachel,5,0,5,0
1739704092920,LIGN 296,013,821921,Rose; Sharon,5,0,5,0
1739704092920,LIGN 296,014,821924,Styler; William Francis,5,0,5,0
1739704092920,LIGN 296,015,821925,Warstadt; Alexander Scott,5,0,5,0
1739704093944,LIHL 112P,A00,820733,Pagkalinawan; Leticia Cant,29,0,30,1
1739704094969,LIHL 114P,A00,820734,Nguyen; Hoan Thi,29,0,30,1
1739704095998,LIHL 117P,A00,820735,Sadegholvad; Elham,28,0,28,0
1739704097024,LIHL 118,A00,820736,Chen; Areana Yen,30,0,30,0
1739704098048,LIHL 124P,A00,820737,Nguyen; Hoan Thi,26,0,28,2
1739704099074,LIHL 132P,A00,820738,Pagkalinawan; Leticia Cant,28,0,28,0
1739704100101,LIHL 134P,A00,820739,Nguyen; Hoan Thi,28,0,28,0
1739704101125,LIHL 138,A00,820740,Chen; Areana Yen,15,0,16,1
1739704102152,LIIT 1C,A00,820988,Carnelos; Chiara,13,0,14,1
1739704102152,LIIT 1C,B00,820989,Carnelos; Chiara,9,0,14,5
1739704103175,LIIT 1CX,A00,820990,Carnelos; Chiara,23,0,28,5
1739704104199,LIPO 1C,A00,820991,Paladini; Denise,14,0,14,0
1739704104199,LIPO 1C,B00,820992,Paladini; Denise,14,0,14,0
1739704105227,LIPO 1CX,A00,820993,De Abreu; Cassia,28,0,28,0
1739704106253,LISL 1A,A00,820994,Lott; Margaret S.,13,0,14,1
1739704106253,LISL 1A,B00,820995,Lott; Margaret S.,14,0,14,0
1739704106253,LISL 1A,C00,820996,Lott; Margaret S.,13,0,14,1
1739704106253,LISL 1A,D00,820997,Lott; Margaret S.,14,0,14,0
1739704106253,LISL 1A,E00,820998,Lott; Margaret S.,14,0,14,0
1739704106253,LISL 1A,F00,820999,Lott; Margaret S.,14,0,14,0
1739704107276,LISL 1AR,A00,821000,Lott; Margaret S.,12,0,15,3
1739704107276,LISL 1AR,B00,821001,Lott; Margaret S.,12,0,15,3
1739704107276,LISL 1AR,C00,885716,Lott; Margaret S.,3,0,3,0
1739704107276,LISL 1AR,D00,885778,Lott; Margaret S.,3,0,3,0
1739704108304,LISL 1AX,A00,821002,Lott; Margaret S.,27,0,28,1
1739704108304,LISL 1AX,B00,821003,Lott; Margaret S.,28,0,28,0
1739704108304,LISL 1AX,C00,821004,Lott; Margaret S.,27,0,28,1
1739704109334,LISL 1C,A00,821009,Lott; Margaret S.,12,0,14,2
1739704109334,LISL 1C,B00,821010,Lott; Margaret S.,14,0,14,0
1739704109334,LISL 1C,C00,821011,Lott; Margaret S.,13,0,14,1
1739704109334,LISL 1C,D00,821012,Lott; Margaret S.,14,0,14,0
1739704109334,LISL 1C,E00,821022,Lott; Margaret S.,12,0,14,2
1739704109334,LISL 1C,F00,821023,Lott; Margaret S.,14,0,14,0
1739704110359,LISL 1CX,A00,821024,Lott; Margaret S.,26,0,28,2
1739704110359,LISL 1CX,B00,821027,Lott; Margaret S.,23,0,28,5
1739704110359,LISL 1CX,C00,821029,Lott; Margaret S.,28,0,28,0
1739704111388,LISL 1D,A00,821030,Lott; Margaret S.,13,0,14,1
1739704111388,LISL 1D,B00,821083,Lott; Margaret S.,14,0,14,0
1739704111388,LISL 1D,C00,821084,Lott; Margaret S.,14,0,14,0
1739704111388,LISL 1D,D00,821148,Lott; Margaret S.,8,0,14,6
1739704112417,LISL 1DX,A00,821160,Lott; Margaret S.,23,0,28,5
1739704112417,LISL 1DX,B00,821165,Lott; Margaret S.,27,0,28,1
1739704113446,LISP 1A,001,821174,Munoz Sanchez; Alicia,12,0,14,2
1739704113446,LISP 1A,002,821175,Munoz Sanchez; Alicia,12,0,14,2
1739704113446,LISP 1A,003,821179,Munoz Sanchez; Alicia,12,0,14,2
1739704113446,LISP 1A,004,821180,Munoz Sanchez; Alicia,13,0,14,1
1739704114472,LISP 1AX,001,821196,Munoz Sanchez; Alicia,26,0,28,2
1739704114472,LISP 1AX,002,821204,Munoz Sanchez; Alicia,26,0,28,2
1739704115499,LISP 1C,001,821226,Munoz Sanchez; Alicia,14,0,14,0
1739704115499,LISP 1C,002,821250,Munoz Sanchez; Alicia,13,0,14,1
1739704115499,LISP 1C,003,821251,Munoz Sanchez; Alicia,12,0,14,2
1739704115499,LISP 1C,004,821259,Munoz Sanchez; Alicia,14,0,14,0
1739704115499,LISP 1C,005,821274,Munoz Sanchez; Alicia,12,0,14,2
1739704115499,LISP 1C,006,821280,Munoz Sanchez; Alicia,13,0,14,1
1739704115499,LISP 1C,007,821281,Munoz Sanchez; Alicia,13,0,14,1
1739704115499,LISP 1C,009,821299,Munoz Sanchez; Alicia,13,0,14,1
1739704115499,LISP 1C,010,821300,Munoz Sanchez; Alicia,14,0,14,0
1739704116525,LISP 1CX,001,821305,Munoz Sanchez; Alicia,30,0,32,2
1739704116525,LISP 1CX,002,821312,Munoz Sanchez; Alicia,31,0,32,1
1739704116525,LISP 1CX,004,821314,Munoz Sanchez; Alicia,28,0,32,4
1739704116525,LISP 1CX,005,821343,Munoz Sanchez; Alicia,28,0,32,4
1739704117558,LISP 1D,002,821390,Munoz Sanchez; Alicia,13,0,14,1
1739704117558,LISP 1D,003,821391,Munoz Sanchez; Alicia,14,0,14,0
1739704117558,LISP 1D,004,821392,Munoz Sanchez; Alicia,14,0,14,0
1739704117558,LISP 1D,005,821393,Munoz Sanchez; Alicia,13,0,14,1
1739704117558,LISP 1D,006,821395,Munoz Sanchez; Alicia,13,0,14,1
1739704117558,LISP 1D,007,821396,Munoz Sanchez; Alicia,14,0,14,0
1739704117558,LISP 1D,008,821397,Munoz Sanchez; Alicia,14,0,14,0
1739704117558,LISP 1D,009,821398,Munoz Sanchez; Alicia,14,0,14,0
1739704117558,LISP 1D,011,821400,Munoz Sanchez; Alicia,13,0,14,1
1739704117558,LISP 1D,012,821401,Munoz Sanchez; Alicia,12,0,14,2
1739704117558,LISP 1D,013,821402,Munoz Sanchez; Alicia,14,0,14,0
1739704117558,LISP 1D,014,821403,Munoz Sanchez; Alicia,14,0,14,0
1739704117558,LISP 1D,015,821404,Munoz Sanchez; Alicia,12,0,14,2
1739704117558,LISP 1D,016,821405,Munoz Sanchez; Alicia,11,0,14,3
1739704117558,LISP 1D,017,821406,Munoz Sanchez; Alicia,14,0,14,0
1739704117558,LISP 1D,018,821407,Munoz Sanchez; Alicia,14,0,14,0
1739704117558,LISP 1D,019,821408,Munoz Sanchez; Alicia,14,0,14,0
1739704117558,LISP 1D,020,821409,Munoz Sanchez; Alicia,14,0,14,0
1739704117558,LISP 1D,021,821410,Munoz Sanchez; Alicia,13,0,14,1
1739704117558,LISP 1D,022,821411,Munoz Sanchez; Alicia,14,0,14,0
1739704117558,LISP 1D,023,821412,Munoz Sanchez; Alicia,14,0,14,0
1739704117558,LISP 1D,024,821413,Munoz Sanchez; Alicia,14,0,14,0
1739704118592,LISP 1DX,001,821414,Munoz Sanchez; Alicia,27,0,28,1
1739704118592,LISP 1DX,002,821415,Munoz Sanchez; Alicia,28,0,28,0
1739704118592,LISP 1DX,003,821416,Munoz Sanchez; Alicia,27,0,28,1
1739704118592,LISP 1DX,004,821417,Munoz Sanchez; Alicia,24,0,28,4
1739704118592,LISP 1DX,005,821418,Munoz Sanchez; Alicia,28,0,28,0
1739704118592,LISP 1DX,006,821419,Munoz Sanchez; Alicia,24,0,28,4
1739704118592,LISP 1DX,007,821420,Munoz Sanchez; Alicia,28,0,28,0
1739704118592,LISP 1DX,008,821430,Munoz Sanchez; Alicia,26,0,28,2
1739704118592,LISP 1DX,009,821434,Munoz Sanchez; Alicia,28,0,28,0
1739704118592,LISP 1DX,010,821478,Munoz Sanchez; Alicia,27,0,28,1
1739704118592,LISP 1DX,011,821489,Munoz Sanchez; Alicia,28,0,28,0
1739704119616,LISP 17,001,821599,Munoz Sanchez; Alicia,17,0,20,3
1739704120642,LISP 18,001,821606,Munoz Sanchez; Alicia,18,0,20,2
1739704121665,LTAM 111,A00,822939,Johnson; Sara E.,39,0,40,1
1739704122691,LTCH 101,A00,822940,Liao; Ping H,119,0,120,1
1739704123718,LTCO 287,A00,823141,Vitkus; Daniel J.,14,0,15,1
1739704124747,LTCS 12,A00,822033,Staff,40,0,40,0
1739704125775,LTCS 87,A00,822034,Nguyen; Hoang Tan,19,0,20,1
1739704125775,LTCS 87,B00,822035,Nguyen; Hoang Tan,20,0,20,0
1739704126801,LTCS 111,A00,822941,Bessett; Ryan Matthew,39,0,40,1
1739704127826,LTCS 222,A00,823145,Nguyen; Hoang Tan,12,0,15,3
1739704128853,LTCS 250,A00,823151,Myerston Santana; Jacobo,13,0,15,2
1739704129880,LTEA 100B,A00,822944,Fiss; Geraldine Anna,37,0,40,3
1739704130904,LTEA 110C,A00,822945,Zhu; Ping,39,0,40,1
1739704131932,LTEA 120A,A00,822946,Zhu; Ping,297,0,300,3
1739704132962,LTEN 22,A01,822037,Lu; Lillian,28,0,28,0
1739704132962,LTEN 22,A02,822039,Lu; Lillian,28,0,28,0
1739704132962,LTEN 22,A03,822040,Lu; Lillian,26,0,28,2
1739704132962,LTEN 22,A04,822042,Lu; Lillian,27,0,28,1
1739704133988,LTEN 28,A01,822044,Suzuki; Erin M.,27,0,28,1
1739704133988,LTEN 28,A02,822045,Suzuki; Erin M.,28,0,28,0
1739704133988,LTEN 28,A03,822046,Suzuki; Erin M.,27,0,28,1
1739704133988,LTEN 28,A04,822047,Suzuki; Erin M.,28,0,28,0
1739704133988,LTEN 28,A05,822049,Suzuki; Erin M.,28,0,28,0
1739704133988,LTEN 28,A06,822054,Suzuki; Erin M.,27,0,28,1
1739704133988,LTEN 28,A07,822056,Suzuki; Erin M.,26,0,28,2
1739704133988,LTEN 28,A08,822057,Suzuki; Erin M.,28,0,28,0
1739704135013,LTEN 110,A00,822947,Dhar; Amrita,36,0,40,4
1739704136040,LTEN 127,A00,822948,Garofalo; Devin,36,0,40,4
1739704137065,LTEN 148,A00,822949,Suzuki; Erin M.,35,0,40,5
1739704138147,LTEN 149,A00,872375,Wesling; Megan E.,34,0,40,6
1739704139172,LTEN 181,A00,822950,Mukherjee; Silpa,56,0,60,4
1739704140199,LTEN 183,A00,822951,Childs; Dennis R.,18,0,20,2
1739704141226,LTEN 185,A00,822952,Childs; Dennis R.,19,0,20,1
1739704142250,LTEN 231,A00,823152,Lu; Lillian,13,0,15,2
1739704143276,LTEN 254,A00,823160,Ruiz; Ariana,15,0,15,0
1739704144304,LTEU 110,A00,822953,Kontje; Todd Curtis,38,0,40,2
1739704145330,LTEU 140,A00,872377,De Marchi Gherini; Adriana,38,0,40,2
1739704146358,LTEU 154,A00,872369,Morse; Ainsley,34,0,35,1
1739704147384,LTFR 2A,A01,822059,Ploye; Catherine,28,0,28,0
1739704148413,LTFR 2C,A00,822060,Ploye; Catherine,25,0,25,0
1739704149438,LTFR 141,A00,822955,Zhiri; Oumelbanine,25,0,25,0
1739704150466,LTGK 3,A00,822062,Murray; Kourtney Kristine,31,0,31,0
1739704151495,LTGM 2C,A00,822067,Fischer-Grunski; Eva K,23,0,25,2
1739704152522,LTIT 50,A00,822068,De Marchi Gherini; Adriana,25,0,25,0
1739704153554,LTKO 1C,A01,822071,Jung; Ji Yun,26,0,28,2
1739704153554,LTKO 1C,B01,822075,Jung; Ji Yun,27,0,28,1
1739704153554,LTKO 1C,C01,822078,Lim; Meeyoung,28,0,28,0
1739704153554,LTKO 1C,D01,822098,Yim; Nancy,27,0,28,1
1739704153554,LTKO 1C,E01,822104,Yim; Nancy,28,0,28,0
1739704154580,LTKO 2C,A01,822289,Yim; Nancy,26,0,28,2
1739704155609,LTKO 130P,A00,822956,Lee; Jeyseon,25,0,25,0
1739704156635,LTKO 135,A00,822992,Lee; Jeyseon,25,0,25,0
1739704157664,LTLA 3,A00,822472,Murray; Kourtney Kristine,45,0,45,0
1739704158690,LTRU 1C,A01,822476,Wells; Patricia Rebecca,27,0,28,1
1739704159716,LTRU 104A,A01,823009,Wells; Patricia Rebecca,27,0,28,1
1739704160744,LTRU 150,A00,872370,Morse; Ainsley,5,0,5,0
1739704161770,LTSP 2A,A01,822483,Lampell; Toni,27,0,28,1
1739704162796,LTSP 2B,A01,822508,Mastromartino; Alexandra L,27,0,28,1
1739704163821,LTSP 2C,A01,822534,Lampell; Toni,27,0,28,1
1739704163821,LTSP 2C,B01,822616,Lampell; Toni,28,0,28,0
1739704164850,LTSP 2F,A00,822619,Mastromartino; Alexandra L,25,0,25,0
1739704165874,LTSP 3F,A00,822629,Dominguez; Noelia,25,0,25,0
1739704165874,LTSP 3F,B00,822669,Dominguez; Noelia,25,0,25,0
1739704166903,LTSP 100A,A00,823023,Dominguez; Noelia,24,0,25,1
1739704167928,LTSP 100F,A00,823027,Bessett; Ryan Matthew,25,0,25,0
1739704167928,LTSP 100F,B00,823028,Martin-Cabrera; Luis,24,0,25,1
1739704168954,LTSP 134,A00,823035,Arcos Herrera; Carol,40,0,40,0
1739704169979,LTSP 155,A00,823036,Mendoza; Andrea,39,0,40,1
1739704171006,LTSP 169,A00,823037,Martin-Cabrera; Luis,38,0,40,2
1739704172031,LTSP 175,A00,823038,Arcos Herrera; Carol,39,0,40,1
1739704173056,LTSP 272,A00,823162,Chacon; Gloria Elizabeth,15,0,15,0
1739704174081,LTTH 210C,A00,823163,Glaser; Amelia,15,0,15,0
1739704175113,LTTH 250,A00,823180,Carroll; Amy Sara,12,0,15,3
1739704176138,LTTH 260,A00,823181,Mendoza; Andrea,29,0,30,1
1739704177164,LTWL 12,A00,822679,Villafuerte Vazquez; Nadia,40,0,40,0
1739704178188,LTWL 19C,A00,822710,Kelting; Edward William,37,0,40,3
1739704179211,LTWL 101,A00,823039,Kelting; Edward William,35,0,40,5
1739704180237,LTWL 114,A00,823040,Morse; Ainsley,40,0,40,0
1739704181265,LTWL 128,A00,823041,Cohen; Alain J. J.,39,0,40,1
1739704182289,LTWL 138,A00,823042,Fiss; Geraldine Anna,40,0,40,0
1739704183313,LTWL 180,A00,823045,Mukherjee; Silpa,39,0,40,1
1739704184341,LTWL 184,A00,823046,Cohen; Alain J. J.,40,0,40,0
1739704185366,LTWL 192,A00,823047,Blanco; John D,20,0,20,0
1739704186393,LTWL 194A,A00,823048,Suzuki; Erin M.,27,0,30,3
1739704187418,LTWR 8A,A01,822713,Jemc; Jaclyn,28,0,28,0
1739704187418,LTWR 8A,A02,822863,Jemc; Jaclyn,27,0,28,1
1739704187418,LTWR 8A,A03,822923,Jemc; Jaclyn,28,0,28,0
1739704187418,LTWR 8A,A04,822932,Jemc; Jaclyn,26,0,28,2
1739704188447,LTWR 8C,A01,822935,Wilkinson; Marco,26,0,28,2
1739704188447,LTWR 8C,A02,822936,Wilkinson; Marco,27,0,28,1
1739704188447,LTWR 8C,A03,822937,Wilkinson; Marco,27,0,28,1
1739704188447,LTWR 8C,A04,822938,Wilkinson; Marco,25,0,28,3
1739704189471,LTWR 100W,A00,854460,Terry; Christopher,6,0,15,9
1739704190501,LTWR 102W,A00,823049,Doller; Ben,12,0,15,3
1739704191527,LTWR 106C,A00,823050,Terry; Christopher,27,0,30,3
1739704192553,LTWR 109C,A00,823080,Doller; Ben,28,0,30,2
1739704193579,LTWR 113C,A00,823093,Som; Brandon D,29,0,30,1
1739704194607,LTWR 115W,A00,823096,Springer; Anna Joy,13,0,15,2
1739704195632,LTWR 119C,A00,823099,Copp; Corina,28,0,30,2
1739704196660,LTWR 124W,A00,823102,Copp; Corina,15,0,15,0
1739704197686,LTWR 126C,A00,823108,Terry; Christopher,29,0,30,1
1739704198711,LTWR 140,A00,823133,Carroll; Amy Sara,30,0,30,0
1739704199737,LTWR 148,A00,823136,Wilkinson; Marco,39,0,40,1
1739704200766,LTWR 215,A00,823218,Jemc; Jaclyn,18,0,20,2
1739704201793,MAE 3,A01,825269,Delson; Nathan Joseph,13,0,16,3
1739704201793,MAE 3,A02,825273,Delson; Nathan Joseph,13,0,16,3
1739704201793,MAE 3,A03,825278,Delson; Nathan Joseph,11,0,16,5
1739704201793,MAE 3,A04,825280,Delson; Nathan Joseph,14,0,16,2
1739704201793,MAE 3,B01,825301,Morimoto; Tania,12,0,16,4
1739704201793,MAE 3,B02,825303,Morimoto; Tania,6,0,16,10
1739704201793,MAE 3,B03,825312,Morimoto; Tania,16,0,16,0
1739704201793,MAE 3,B04,825343,Morimoto; Tania,16,0,16,0
1739704202820,MAE 8,A01,825350,Qian; Kai,93,0,100,7
1739704203847,MAE 30B,A00,825352,Lubarda; Marko,96,0,100,4
1739704203847,MAE 30B,B00,825362,Ghazinejad; Maziar,84,0,100,16
1739704204875,MAE 87,A00,872412,Mullin; Jennifer S & Twomey; Robert Daniel,10,0,10,0
1739704205900,MAE 101B,A00,825363,Nomura; Keiko K.,142,0,146,4
1739704206928,MAE 101C,A00,825364,Staff,0,0,0,0
1739704207955,MAE 101D,A00,825378,Coimbra; Carlos F.,16,0,25,9
1739704208981,MAE 104,A00,825379,Pham; Hieu Tan,91,0,100,9
1739704210006,MAE 105,A00,825380,Bandaru; Prabhakar,95,0,100,5
1739704211032,MAE 107,A00,825381,Lindsey; Stephanie,94,0,100,6
1739704212060,MAE 119,A00,825382,Hidalgo-Gonzalez; Patricia,123,0,146,23
1739704213085,MAE 131A,A00,825385,Qi; Huihui,84,0,100,16
1739704213085,MAE 131A,B00,825435,Luan; Haiwen,99,0,100,1
1739704214110,MAE 143B,A00,825498,Diagne; Mamadou Lamine,61,0,80,19
1739704214110,MAE 143B,B00,825499,Kramer; Boris,92,0,96,4
1739704215139,MAE 148,A01,825502,Silberman; Jack,17,0,26,9
1739704216164,MAE 150,A00,825505,Friend; James Robert,114,0,120,6
1739704217194,MAE 152,A00,886080,Llewellyn Smith; Stefan G.,16,0,16,0
1739704217194,MAE 152,B00,886081,Llewellyn Smith; Stefan G.,16,0,16,0
1739704217194,MAE 152,C00,886082,Llewellyn Smith; Stefan G.,14,0,16,2
1739704217194,MAE 152,D00,886083,Llewellyn Smith; Stefan G.,16,0,16,0
1739704218222,MAE 155B,A01,825508,Anderson; Mark Ronald,17,0,50,33
1739704218222,MAE 155B,B01,825515,Hwang; John T,36,0,50,14
1739704219252,MAE 156B,D01,825618,Tustaniwskyj; Jerry I,30,0,35,5
1739704219252,MAE 156B,A01,825549,Delson; Nathan Joseph,34,0,35,1
1739704219252,MAE 156B,B01,825595,Ghazinejad; Maziar,30,0,35,5
1739704219252,MAE 156B,C01,825604,Pawlak; Geno Ronald,32,0,35,3
1739704219252,MAE 156B,F01,825626,Saha; Abhishek,34,0,35,1
1739704219252,MAE 156B,G01,825631,Qi; Huihui,32,0,35,3
1739704220280,MAE 170,A01,825636,Lubarda; Marko,27,0,32,5
1739704220280,MAE 170,A02,825638,Lubarda; Marko,31,0,32,1
1739704220280,MAE 170,A03,825639,Lubarda; Marko,31,0,32,1
1739704220280,MAE 170,B04,825643,Evdokimenko; Ekaterina,28,0,32,4
1739704220280,MAE 170,B05,825645,Evdokimenko; Ekaterina,20,0,32,12
1739704220280,MAE 170,B06,825648,Evdokimenko; Ekaterina,25,0,32,7
1739704221305,MAE 171A,A01,825655,Tynan; George Robert,22,0,30,8
1739704221305,MAE 171A,A02,825657,Tynan; George Robert,29,0,30,1
1739704222333,MAE 175A,A01,825661,de Callafon; Raymond A,20,0,20,0
1739704222333,MAE 175A,A02,825662,de Callafon; Raymond A,14,0,20,6
1739704223359,MAE 184,A00,825714,Anderson; Mark Ronald,23,0,60,37
1739704224384,MAE 185,A00,825715,Schmidt; Oliver,28,0,60,32
1739704225409,MAE 190,A00,825719,Beg; Farhat N.,34,0,40,6
1739704225409,MAE 190,B00,825720,Tynan; George Robert & Mullin; Jennifer S,57,0,60,3
1739704225409,MAE 190,C00,869044,Gerardo; Hortense Flotilde,13,0,14,1
1739704226443,MAE 205,A00,825721,Herbert; Sylvia Lee & Pawlak; Geno Ronald & Mullin; Jennifer S & Lindsey; Stephanie & Cai; Shengqiang & Beg; Farhat N.,9995,0,9999,4
1739704227467,MAE 207,A00,825722,Beg; Farhat N.,7,0,10,3
1739704227467,MAE 207,B00,869156,Gerardo; Hortense Flotilde,24,0,30,6
1739704228495,MAE 209,A00,825723,Scholtes Acevedo; Claire,18,0,30,12
1739704229523,MAE 210C,A00,869158,Sanchez; Antonio Luis,9,0,15,6
1739704230551,MAE 214A,A00,825724,Sarkar; Sutanu,0,0,20,20
1739704231577,MAE 217C,A00,825725,Marinoni; Alessandro,12,0,15,3
1739704232601,MAE 221D,A00,825726,Poulikakos; Lisa Voula,0,0,15,15
1739704233626,MAE 223,A01,825729,Lucas; Andrew J.,0,0,32,32
1739704234651,MAE 224A,A00,825731,Pawlak; Geno Ronald,0,0,10,10
1739704235675,MAE 227,A00,825732,Hidalgo-Gonzalez; Patricia,0,0,15,15
1739704236700,MAE 231B,A00,825733,Boechler; Nicholas Sebastia,28,0,30,2
1739704237725,MAE 240,A00,825734,Rosengren; Aaron,22,0,40,18
1739704238752,MAE 242,A00,825735,Martinez; Sonia,0,0,40,40
1739704239779,MAE 243,A00,869161,Davidson; Michael R,11,0,20,9
1739704240805,MAE 254,A00,825736,Chen; Renkun,0,0,15,15
1739704241885,MAE 256,A00,825740,Coimbra; Carlos F.,7,0,15,8
1739704242909,MAE 266,A00,825741,Evdokimenko; Ekaterina,0,0,20,20
1739704243936,MAE 269,A00,825837,Gravish; Nicholas G,0,0,35,35
1739704244962,MAE 271B,A00,825838,Garay; Javier,5,0,5,0
1739704245990,MAE 272,A00,825839,Meyers; Marc,4,0,15,11
1739704247020,MAE 280B,A00,825840,de Callafon; Raymond A,11,0,40,29
1739704248048,MAE 281B,A00,825842,Cortes; Jorge,7,0,20,13
1739704249076,MAE 289C,A00,825843,McEneaney; William Michael,8,0,10,2
1739704250104,MAE 290C,A00,825846,Schmidt; Oliver,27,0,30,3
1739704251133,MAE 294C,A01,825850,Young; William Roy,10,0,10,0
1739704252160,MATH 2,A01,848213,Cheng; Hsiao-Bing,187,0,190,3
1739704253190,MATH 3B,A01,848358,Ohm; Ko Woon,28,0,30,2
1739704253190,MATH 3B,A02,848359,Ohm; Ko Woon,30,0,30,0
1739704253190,MATH 3B,A03,848368,Ohm; Ko Woon,18,0,30,12
1739704253190,MATH 3B,A04,848369,Ohm; Ko Woon,30,0,30,0
1739704254221,MATH 3C,A01,848397,Anzaldo; Leesa B,20,0,28,8
1739704254221,MATH 3C,A02,848398,Anzaldo; Leesa B,28,0,28,0
1739704254221,MATH 3C,A03,848399,Anzaldo; Leesa B,28,0,28,0
1739704254221,MATH 3C,A04,848400,Anzaldo; Leesa B,28,0,28,0
1739704254221,MATH 3C,B01,848423,Nandi; Achinta Kumar,24,0,30,6
1739704254221,MATH 3C,B02,848439,Nandi; Achinta Kumar,30,0,30,0
1739704254221,MATH 3C,B03,848458,Nandi; Achinta Kumar,29,0,30,1
1739704254221,MATH 3C,B04,848459,Nandi; Achinta Kumar,30,0,30,0
1739704255248,MATH 4C,A01,848474,Briones; Jor-el Thomas Caparas,31,0,35,4
1739704255248,MATH 4C,A02,848476,Briones; Jor-el Thomas Caparas,35,0,36,1
1739704255248,MATH 4C,A03,848479,Briones; Jor-el Thomas Caparas,36,0,36,0
1739704255248,MATH 4C,A04,848481,Briones; Jor-el Thomas Caparas,36,0,36,0
1739704256278,MATH 10A,A01,848484,Briones; Jor-el Thomas Caparas,31,0,33,2
1739704256278,MATH 10A,A02,848490,Briones; Jor-el Thomas Caparas,32,0,33,1
1739704256278,MATH 10A,A03,848495,Briones; Jor-el Thomas Caparas,21,0,33,12
1739704256278,MATH 10A,A04,848508,Briones; Jor-el Thomas Caparas,19,0,33,14
1739704256278,MATH 10A,A05,848517,Briones; Jor-el Thomas Caparas,30,0,33,3
1739704256278,MATH 10A,A06,848518,Briones; Jor-el Thomas Caparas,33,0,33,0
1739704256278,MATH 10A,B01,848521,Bach; Quang Tran,30,0,31,1
1739704256278,MATH 10A,B02,848523,Bach; Quang Tran,31,0,32,1
1739704256278,MATH 10A,B03,848542,Bach; Quang Tran,33,0,33,0
1739704256278,MATH 10A,B04,848543,Bach; Quang Tran,33,0,33,0
1739704256278,MATH 10A,B05,848544,Bach; Quang Tran,28,0,33,5
1739704256278,MATH 10A,B06,848545,Bach; Quang Tran,33,0,33,0
1739704257306,MATH 10B,A01,848547,Zhao; Yizhen,33,0,33,0
1739704257306,MATH 10B,A02,848548,Zhao; Yizhen,33,0,33,0
1739704257306,MATH 10B,A03,848557,Zhao; Yizhen,32,0,33,1
1739704257306,MATH 10B,A04,848558,Zhao; Yizhen,32,0,33,1
1739704257306,MATH 10B,B01,848583,Zhao; Yizhen,55,0,60,5
1739704257306,MATH 10B,B02,848585,Zhao; Yizhen,59,0,60,1
1739704257306,MATH 10B,B03,848586,Zhao; Yizhen,31,0,33,2
1739704257306,MATH 10B,B04,848588,Zhao; Yizhen,32,0,33,1
1739704257306,MATH 10B,C01,848591,Ophir; Amit,30,0,30,0
1739704257306,MATH 10B,C02,848592,Ophir; Amit,29,0,30,1
1739704257306,MATH 10B,C03,848593,Ophir; Amit,30,0,30,0
1739704257306,MATH 10B,C04,848595,Ophir; Amit,30,0,30,0
1739704257306,MATH 10B,D01,848651,Buzaglo; Lucas,8,0,30,22
1739704257306,MATH 10B,D02,848653,Buzaglo; Lucas,26,0,32,6
1739704257306,MATH 10B,D03,848672,Buzaglo; Lucas,31,0,33,2
1739704257306,MATH 10B,D04,848691,Buzaglo; Lucas,33,0,33,0
1739704257306,MATH 10B,D05,848700,Buzaglo; Lucas,28,0,33,5
1739704257306,MATH 10B,D06,848702,Buzaglo; Lucas,27,0,33,6
1739704258337,MATH 10C,A01,848704,Ho; Ching Wei,12,0,27,15
1739704258337,MATH 10C,A02,848706,Ho; Ching Wei,28,0,33,5
1739704258337,MATH 10C,A03,848708,Ho; Ching Wei,29,0,33,4
1739704258337,MATH 10C,A04,848709,Ho; Ching Wei,33,0,33,0
1739704258337,MATH 10C,A05,848711,Ho; Ching Wei,32,0,33,1
1739704258337,MATH 10C,A06,848712,Ho; Ching Wei,32,0,33,1
1739704258337,MATH 10C,B01,848716,Staff,28,0,35,7
1739704258337,MATH 10C,B02,848766,Staff,33,0,35,2
1739704258337,MATH 10C,B03,848767,Staff,33,0,35,2
1739704258337,MATH 10C,B04,848772,Staff,35,0,35,0
1739704258337,MATH 10C,C01,848775,Cheng; Hsiao-Bing,28,0,35,7
1739704258337,MATH 10C,C02,848779,Cheng; Hsiao-Bing,35,0,35,0
1739704258337,MATH 10C,C03,848780,Cheng; Hsiao-Bing,35,0,35,0
1739704258337,MATH 10C,C04,848781,Cheng; Hsiao-Bing,35,0,35,0
1739704259365,MATH 11,A01,848784,Peca-Medlin; John Michael,18,0,28,10
1739704259365,MATH 11,A02,848786,Peca-Medlin; John Michael,28,0,33,5
1739704259365,MATH 11,A03,848788,Peca-Medlin; John Michael,33,0,33,0
1739704259365,MATH 11,A04,848791,Peca-Medlin; John Michael,33,0,33,0
1739704259365,MATH 11,A05,848793,Peca-Medlin; John Michael,55,0,55,0
1739704259365,MATH 11,A06,848794,Peca-Medlin; John Michael,55,0,55,0
1739704259365,MATH 11,B01,848798,Peca-Medlin; John Michael,54,0,55,1
1739704259365,MATH 11,B02,848799,Peca-Medlin; John Michael,55,0,55,0
1739704259365,MATH 11,B03,848800,Peca-Medlin; John Michael,26,0,33,7
1739704259365,MATH 11,B04,848801,Peca-Medlin; John Michael,31,0,33,2
1739704259365,MATH 11,B05,848843,Peca-Medlin; John Michael,33,0,33,0
1739704259365,MATH 11,B06,848844,Peca-Medlin; John Michael,33,0,33,0
1739704260401,MATH 18,A01,848854,Hiatt; Patrick John,32,0,35,3
1739704260401,MATH 18,A02,848859,Hiatt; Patrick John,35,0,35,0
1739704260401,MATH 18,A03,848860,Hiatt; Patrick John,34,0,35,1
1739704260401,MATH 18,A04,848861,Hiatt; Patrick John,35,0,35,0
1739704260401,MATH 18,A05,872522,Hiatt; Patrick John,33,0,35,2
1739704260401,MATH 18,A06,872523,Hiatt; Patrick John,35,0,35,0
1739704260401,MATH 18,B01,848869,Anzaldo; Leesa B,35,0,40,5
1739704260401,MATH 18,B02,848873,Anzaldo; Leesa B,20,0,35,15
1739704260401,MATH 18,B03,848877,Anzaldo; Leesa B,37,0,40,3
1739704260401,MATH 18,B04,848880,Anzaldo; Leesa B,38,0,40,2
1739704260401,MATH 18,B05,848882,Anzaldo; Leesa B,40,0,40,0
1739704260401,MATH 18,B06,848883,Anzaldo; Leesa B,35,0,40,5
1739704260401,MATH 18,B07,848884,Anzaldo; Leesa B,38,0,40,2
1739704260401,MATH 18,B08,848924,Anzaldo; Leesa B,38,0,40,2
1739704260401,MATH 18,C01,849043,Hiatt; Patrick John,34,0,35,1
1739704260401,MATH 18,C02,849044,Hiatt; Patrick John,35,0,35,0
1739704260401,MATH 18,C03,849045,Hiatt; Patrick John,35,0,35,0
1739704260401,MATH 18,C04,849047,Hiatt; Patrick John,33,0,35,2
1739704260401,MATH 18,C05,872524,Hiatt; Patrick John,34,0,35,1
1739704260401,MATH 18,C06,872525,Hiatt; Patrick John,35,0,35,0
1739704260401,MATH 18,D01,849050,Staff,35,0,35,0
1739704260401,MATH 18,D02,849053,Staff,35,0,35,0
1739704260401,MATH 18,D03,849054,Staff,35,0,35,0
1739704260401,MATH 18,D04,849055,Staff,35,0,35,0
1739704260401,MATH 18,D05,872526,Staff,34,0,35,1
1739704260401,MATH 18,D06,872528,Staff,35,0,35,0
1739704261427,MATH 20A,A01,849061,Ho; Ching Wei,28,0,32,4
1739704261427,MATH 20A,A02,849062,Ho; Ching Wei,34,0,35,1
1739704261427,MATH 20A,A03,849064,Ho; Ching Wei,35,0,35,0
1739704261427,MATH 20A,A04,849065,Ho; Ching Wei,35,0,35,0
1739704261427,MATH 20A,B01,849087,Bowers; Adam R.,28,0,35,7
1739704261427,MATH 20A,B02,849100,Bowers; Adam R.,35,0,35,0
1739704261427,MATH 20A,B03,849110,Bowers; Adam R.,34,0,35,1
1739704261427,MATH 20A,B04,849111,Bowers; Adam R.,34,0,35,1
1739704262452,MATH 20B,A01,849131,Staff,58,0,60,2
1739704262452,MATH 20B,A02,849242,Staff,60,0,60,0
1739704262452,MATH 20B,A03,849315,Staff,58,0,60,2
1739704262452,MATH 20B,A04,849319,Staff,60,0,60,0
1739704262452,MATH 20B,B01,849438,Xu; Fengmin,60,0,60,0
1739704262452,MATH 20B,B02,849447,Xu; Fengmin,57,0,60,3
1739704262452,MATH 20B,B03,849463,Xu; Fengmin,14,0,34,20
1739704262452,MATH 20B,B04,849465,Xu; Fengmin,36,0,37,1
1739704263480,MATH 20C,A01,849482,Shakeel; Asif,27,0,32,5
1739704263480,MATH 20C,A02,849484,Shakeel; Asif,31,0,32,1
1739704263480,MATH 20C,A03,849485,Shakeel; Asif,32,0,32,0
1739704263480,MATH 20C,A04,849511,Shakeel; Asif,32,0,32,0
1739704263480,MATH 20C,A05,849512,Shakeel; Asif,32,0,32,0
1739704263480,MATH 20C,A06,849513,Shakeel; Asif,32,0,32,0
1739704263480,MATH 20C,B01,849515,Yin; Wei,28,0,40,12
1739704263480,MATH 20C,B02,849516,Yin; Wei,41,0,45,4
1739704263480,MATH 20C,B03,849628,Yin; Wei,45,0,45,0
1739704263480,MATH 20C,B04,849636,Yin; Wei,43,0,45,2
1739704263480,MATH 20C,C01,849642,Ohm; Ko Woon,51,0,60,9
1739704263480,MATH 20C,C02,849654,Ohm; Ko Woon,60,0,60,0
1739704263480,MATH 20C,C03,849655,Ohm; Ko Woon,59,0,60,1
1739704263480,MATH 20C,C04,849663,Ohm; Ko Woon,60,0,60,0
1739704263480,MATH 20C,D01,849673,Yin; Wei,43,0,45,2
1739704263480,MATH 20C,D02,849677,Yin; Wei,43,0,45,2
1739704263480,MATH 20C,D03,849683,Yin; Wei,45,0,45,0
1739704263480,MATH 20C,D04,849686,Yin; Wei,45,0,45,0
1739704264507,MATH 20D,A01,849688,Hammock; Frances H,22,0,27,5
1739704264507,MATH 20D,A02,849695,Hammock; Frances H,32,0,32,0
1739704264507,MATH 20D,A03,849697,Hammock; Frances H,32,0,32,0
1739704264507,MATH 20D,A04,849734,Hammock; Frances H,31,0,32,1
1739704264507,MATH 20D,A05,849735,Hammock; Frances H,30,0,32,2
1739704264507,MATH 20D,A06,849736,Hammock; Frances H,32,0,32,0
1739704264507,MATH 20D,B01,849829,Hammock; Frances H,34,0,45,11
1739704264507,MATH 20D,B02,849852,Hammock; Frances H,45,0,45,0
1739704264507,MATH 20D,B03,849853,Hammock; Frances H,44,0,45,1
1739704264507,MATH 20D,B04,849857,Hammock; Frances H,45,0,45,0
1739704264507,MATH 20D,C01,849867,Staff,57,0,60,3
1739704264507,MATH 20D,C02,849888,Staff,59,0,60,1
1739704265560,MATH 20E,A01,850038,Sanchez; Anthony,20,0,31,11
1739704265560,MATH 20E,A02,850039,Sanchez; Anthony,33,0,35,2
1739704265560,MATH 20E,A03,850040,Sanchez; Anthony,34,0,35,1
1739704265560,MATH 20E,A04,850041,Sanchez; Anthony,35,0,35,0
1739704265560,MATH 20E,B01,850054,Sheng; Hongyi,27,0,35,8
1739704265560,MATH 20E,B02,850058,Sheng; Hongyi,34,0,35,1
1739704265560,MATH 20E,B03,850060,Sheng; Hongyi,35,0,35,0
1739704265560,MATH 20E,B04,850063,Sheng; Hongyi,35,0,35,0
1739704265560,MATH 20E,B05,872529,Sheng; Hongyi,35,0,35,0
1739704265560,MATH 20E,B06,872530,Sheng; Hongyi,35,0,35,0
1739704265560,MATH 20E,C01,850068,Sheng; Hongyi,29,0,30,1
1739704265560,MATH 20E,C02,850069,Sheng; Hongyi,30,0,30,0
1739704265560,MATH 20E,C03,850072,Sheng; Hongyi,29,0,30,1
1739704265560,MATH 20E,C04,850075,Sheng; Hongyi,29,0,30,1
1739704265560,MATH 20E,C05,850080,Sheng; Hongyi,30,0,30,0
1739704265560,MATH 20E,C06,850083,Sheng; Hongyi,30,0,30,0
1739704266586,MATH 31CH,A01,850090,De Vleming; Kristin Elizab,40,0,40,0
1739704267613,MATH 87,A00,872926,Bowers; Adam R.,20,0,20,0
1739704267613,MATH 87,B00,872927,Bowers; Adam R.,20,0,20,0
1739704268638,MATH 95,A00,850094,Stevens; Laura Jeanne,34,0,35,1
1739704269667,MATH 100B,A01,847038,Aycock; Jon Merrill,33,0,34,1
1739704269667,MATH 100B,A02,847048,Aycock; Jon Merrill,33,0,34,1
1739704270695,MATH 100C,A01,847050,Sorensen; Claus M,30,0,34,4
1739704270695,MATH 100C,A02,847051,Sorensen; Claus M,32,0,34,2
1739704271725,MATH 102,A01,847053,Aliabadi Sr.; Mohsen,25,0,30,5
1739704271725,MATH 102,A02,847101,Aliabadi Sr.; Mohsen,30,0,30,0
1739704271725,MATH 102,A03,847103,Aliabadi Sr.; Mohsen,28,0,30,2
1739704271725,MATH 102,A04,847106,Aliabadi Sr.; Mohsen,30,0,30,0
1739704271725,MATH 102,B01,847119,Aliabadi Sr.; Mohsen,27,0,30,3
1739704271725,MATH 102,B02,847120,Aliabadi Sr.; Mohsen,29,0,30,1
1739704271725,MATH 102,B03,847121,Aliabadi Sr.; Mohsen,29,0,30,1
1739704271725,MATH 102,B04,847123,Aliabadi Sr.; Mohsen,30,0,30,0
1739704272756,MATH 103B,A01,847125,Mohammadi; Amir,34,0,35,1
1739704272756,MATH 103B,A02,847126,Mohammadi; Amir,35,0,35,0
1739704272756,MATH 103B,B01,847128,Wenzl; Hans G,33,0,35,2
1739704272756,MATH 103B,B02,847129,Wenzl; Hans G,35,0,35,0
1739704272756,MATH 103B,C01,847131,Wenzl; Hans G,31,0,35,4
1739704272756,MATH 103B,C02,847132,Wenzl; Hans G,33,0,35,2
1739704273789,MATH 109,A01,847134,Ganesan; Priyanga,10,0,10,0
1739704273789,MATH 109,A02,847135,Ganesan; Priyanga,9,0,10,1
1739704273789,MATH 109,B01,847137,Ganesan; Priyanga,7,0,10,3
1739704273789,MATH 109,B02,847138,Ganesan; Priyanga,9,0,10,1
1739704273789,MATH 109,C01,847140,Upadrashta; Pranav Kumar,7,0,10,3
1739704273789,MATH 109,C02,847141,Upadrashta; Pranav Kumar,10,0,10,0
1739704273789,MATH 109,D01,847143,Sarkar; Pratyush,9,0,10,1
1739704273789,MATH 109,D02,847144,Sarkar; Pratyush,10,0,10,0
1739704273789,MATH 109,E01,847146,Sarkar; Pratyush,10,0,10,0
1739704273789,MATH 109,E02,847148,Sarkar; Pratyush,10,0,10,0
1739704274815,MATH 110,A01,847150,Pillai; Mohandas K,30,0,35,5
1739704274815,MATH 110,A02,847151,Pillai; Mohandas K,34,0,35,1
1739704274815,MATH 110,A03,847152,Pillai; Mohandas K,34,0,35,1
1739704275840,MATH 111A,A01,847154,Shakeel; Asif,23,0,30,7
1739704276866,MATH 112B,A01,847156,Komarova; Natalia,25,0,25,0
1739704277892,MATH 114,A01,847158,Li; Bo,21,0,30,9
1739704277892,MATH 114,A02,847159,Li; Bo,29,0,30,1
1739704278920,MATH 120B,A01,847161,Treuer; John N,32,0,35,3
1739704278920,MATH 120B,A02,847162,Treuer; John N,34,0,35,1
1739704279947,MATH 121B,A01,847164,Stevens; Laura Jeanne,33,0,35,2
1739704280973,MATH 140B,A01,847166,Lu; Yunze,35,0,35,0
1739704280973,MATH 140B,A02,847167,Lu; Yunze,34,0,35,1
1739704282001,MATH 140C,A01,847203,Zlatos; Andrej,33,0,35,2
1739704282001,MATH 140C,A02,847204,Zlatos; Andrej,34,0,35,1
1739704283027,MATH 142B,A01,847207,Parise; Davide,25,0,35,10
1739704283027,MATH 142B,A02,847208,Parise; Davide,31,0,35,4
1739704283027,MATH 142B,B01,847219,Mohammadi; Amir,33,0,35,2
1739704283027,MATH 142B,B02,847222,Mohammadi; Amir,35,0,35,0
1739704283027,MATH 142B,C01,847224,Kunnawalkam Elayavalli; Sr,34,0,35,1
1739704283027,MATH 142B,C02,847331,Kunnawalkam Elayavalli; Sr,34,0,35,1
1739704284053,MATH 146,A01,847333,Pillai; Mohandas K,35,0,35,0
1739704285079,MATH 150B,A01,847335,Chow; Bennett,33,0,35,2
1739704286111,MATH 152,A01,847337,Grier; Daniel T,32,0,50,18
1739704287142,MATH 154,A01,847340,Manners; Frederick,33,0,35,2
1739704287142,MATH 154,A02,847341,Manners; Frederick,35,0,35,0
1739704287142,MATH 154,A03,847342,Manners; Frederick,35,0,35,0
1739704287142,MATH 154,A04,847343,Manners; Frederick,35,0,35,0
1739704287142,MATH 154,B01,847345,Verstraete; Jacques Allan,30,0,35,5
1739704287142,MATH 154,B02,847346,Verstraete; Jacques Allan,35,0,35,0
1739704287142,MATH 154,B03,847347,Verstraete; Jacques Allan,34,0,35,1
1739704287142,MATH 154,B04,847348,Verstraete; Jacques Allan,33,0,35,2
1739704288169,MATH 160B,A01,847460,Manners; Frederick,34,0,35,1
1739704289194,MATH 163,A01,847462,Kunnawalkam Elayavalli; Sr,0,0,25,25
1739704290223,MATH 170A,A01,847464,Nag; Panchali,33,0,35,2
1739704290223,MATH 170A,A02,847465,Nag; Panchali,34,0,35,1
1739704290223,MATH 170A,A03,847466,Nag; Panchali,33,0,35,2
1739704290223,MATH 170A,A04,847467,Nag; Panchali,31,0,35,4
1739704291254,MATH 170B,A01,847530,Dixit; Rishabh,33,0,35,2
1739704291254,MATH 170B,A02,847531,Dixit; Rishabh,35,0,35,0
1739704291254,MATH 170B,A03,847532,Dixit; Rishabh,34,0,35,1
1739704291254,MATH 170B,A04,847533,Dixit; Rishabh,29,0,35,6
1739704292282,MATH 170C,A01,847535,Dixit; Rishabh,35,0,35,0
1739704292282,MATH 170C,A02,847536,Dixit; Rishabh,35,0,35,0
1739704292282,MATH 170C,A03,847537,Dixit; Rishabh,34,0,35,1
1739704292282,MATH 170C,A04,847538,Dixit; Rishabh,35,0,35,0
1739704293306,MATH 171B,A01,847557,Huang; Lei,32,0,35,3
1739704293306,MATH 171B,A02,847560,Huang; Lei,34,0,35,1
1739704293306,MATH 171B,A03,847596,Huang; Lei,31,0,35,4
1739704293306,MATH 171B,A04,847597,Huang; Lei,32,0,35,3
1739704294331,MATH 179,A01,847599,Cheng; Li-Tien,25,0,25,0
1739704295361,MATH 180A,A01,847601,Webber; Robert Jacobs,31,0,35,4
1739704295361,MATH 180A,A02,847602,Webber; Robert Jacobs,35,0,35,0
1739704295361,MATH 180A,A03,847603,Webber; Robert Jacobs,34,0,35,1
1739704295361,MATH 180A,A04,847604,Webber; Robert Jacobs,32,0,35,3
1739704295361,MATH 180A,B01,847606,Hardiman; Liam,35,0,35,0
1739704295361,MATH 180A,B02,847680,Hardiman; Liam,31,0,35,4
1739704295361,MATH 180A,B03,847682,Hardiman; Liam,35,0,35,0
1739704295361,MATH 180A,B04,847683,Hardiman; Liam,35,0,35,0
1739704296390,MATH 180B,A01,847686,Warnke; Lutz Peter,32,0,32,0
1739704296390,MATH 180B,A02,847688,Warnke; Lutz Peter,31,0,32,1
1739704296390,MATH 180B,A03,847689,Warnke; Lutz Peter,31,0,32,1
1739704296390,MATH 180B,A04,847691,Warnke; Lutz Peter,31,0,32,1
1739704296390,MATH 180B,A05,847693,Warnke; Lutz Peter,32,0,32,0
1739704296390,MATH 180B,A06,847694,Warnke; Lutz Peter,30,0,32,2
1739704297414,MATH 180C,A01,847701,Ang; Jie Jun,34,0,35,1
1739704297414,MATH 180C,A02,847707,Ang; Jie Jun,35,0,35,0
1739704297414,MATH 180C,A03,847708,Ang; Jie Jun,32,0,35,3
1739704297414,MATH 180C,A04,847711,Ang; Jie Jun,31,0,35,4
1739704298439,MATH 181A,A01,847753,Zhang; Danna,15,0,35,20
1739704298439,MATH 181A,A02,847756,Zhang; Danna,32,0,35,3
1739704298439,MATH 181A,A03,847757,Zhang; Danna,32,0,35,3
1739704298439,MATH 181A,A04,847758,Zhang; Danna,33,0,35,2
1739704299468,MATH 181B,A01,847760,Rava; Denise,30,0,35,5
1739704299468,MATH 181B,A02,847761,Rava; Denise,34,0,35,1
1739704299468,MATH 181B,A03,847764,Rava; Denise,34,0,35,1
1739704299468,MATH 181B,A04,847765,Rava; Denise,35,0,35,0
1739704300498,MATH 183,A01,847768,Vishwanath; Siddharth,21,0,32,11
1739704300498,MATH 183,A02,847769,Vishwanath; Siddharth,30,0,32,2
1739704300498,MATH 183,A03,847770,Vishwanath; Siddharth,31,0,32,1
1739704300498,MATH 183,A04,847772,Vishwanath; Siddharth,29,0,32,3
1739704300498,MATH 183,A05,847774,Vishwanath; Siddharth,32,0,32,0
1739704300498,MATH 183,A06,847864,Vishwanath; Siddharth,31,0,32,1
1739704301525,MATH 184,A01,847866,Wesley; William J,35,0,35,0
1739704301525,MATH 184,A02,847874,Wesley; William J,33,0,35,2
1739704301525,MATH 184,A03,847875,Wesley; William J,35,0,35,0
1739704301525,MATH 184,A04,847876,Wesley; William J,33,0,35,2
1739704302554,MATH 185,A01,847880,Rava; Denise,31,0,35,4
1739704302554,MATH 185,A02,847881,Rava; Denise,35,0,35,0
1739704303581,MATH 187A,A01,847883,Klevdal; Christian Sleek,14,0,32,18
1739704303581,MATH 187A,A02,847886,Klevdal; Christian Sleek,29,0,32,3
1739704303581,MATH 187A,A03,847892,Klevdal; Christian Sleek,27,0,32,5
1739704303581,MATH 187A,A04,847893,Klevdal; Christian Sleek,32,0,32,0
1739704303581,MATH 187A,A05,847894,Klevdal; Christian Sleek,31,0,32,1
1739704303581,MATH 187A,A06,847903,Klevdal; Christian Sleek,31,0,32,1
1739704304608,MATH 187B,A01,847905,Bucur; Alina Ioana,28,0,35,7
1739704304608,MATH 187B,A02,847906,Bucur; Alina Ioana,34,0,35,1
1739704305635,MATH 189,A01,847908,Lou; Zhipeng,0,0,10,10
1739704305635,MATH 189,A02,847909,Lou; Zhipeng,0,0,10,10
1739704305635,MATH 189,A03,847910,Lou; Zhipeng,0,0,10,10
1739704305635,MATH 189,A04,847911,Lou; Zhipeng,0,0,10,10
1739704305635,MATH 189,A05,847912,Lou; Zhipeng,0,0,10,10
1739704305635,MATH 189,A06,847917,Lou; Zhipeng,0,0,10,10
1739704306663,MATH 190B,A01,848005,McKernan; James,30,0,35,5
1739704307693,MATH 194,A01,848012,Fitzsimmons; Patrick J,12,0,32,20
1739704307693,MATH 194,A02,848080,Fitzsimmons; Patrick J,31,0,32,1
1739704307693,MATH 194,A03,848081,Fitzsimmons; Patrick J,26,0,32,6
1739704307693,MATH 194,A04,848107,Fitzsimmons; Patrick J,32,0,32,0
1739704307693,MATH 194,A05,848108,Fitzsimmons; Patrick J,31,0,32,1
1739704307693,MATH 194,A06,848147,Fitzsimmons; Patrick J,30,0,32,2
1739704308719,MATH 197,001,872928,Kedlaya; Kiran S.,9999,0,9999,0
1739704309745,MATH 200C,A00,846124,Salehi Golsefidy; Alireza,18,0,20,2
1739704310774,MATH 202C,A00,846125,Rhoades; Brendon Patrick,18,0,20,2
1739704311799,MATH 203C,A00,846128,Izadi; Elham,20,0,20,0
1739704312827,MATH 204C,A00,846131,Pollack; Aaron,20,0,20,0
1739704313855,MATH 205,A00,846132,Popescu; Cristian D.,18,0,20,2
1739704314879,MATH 208,A00,846133,Oprea; Dragos N.,10,0,10,0
1739704315907,MATH 209,A00,846173,Bucur; Alina Ioana,10,0,10,0
1739704316932,MATH 211A,A00,846174,Salehi Golsefidy; Alireza,10,0,10,0
1739704317957,MATH 211B,A00,846175,Sanchez; Anthony,9,0,10,1
1739704318983,MATH 212B,A01,846177,Komarova; Natalia,10,0,10,0
1739704320008,MATH 214,A01,846179,Li; Bo,2,0,5,3
1739704320008,MATH 214,A02,846181,Li; Bo,5,0,5,0
1739704321036,MATH 216C,A00,846182,Cloninger; Alexander,17,0,20,3
1739704322062,MATH 218,A00,846183,Komarova; Natalia,9,0,10,1
1739704323088,MATH 220C,A00,846184,Oprea; Dragos N.,20,0,20,0
1739704324114,MATH 231C,A00,846185,Li; Bo,20,0,20,0
1739704325146,MATH 240C,A00,846187,Ioana; Adrian,18,0,20,2
1739704326170,MATH 243,A00,846188,Kunnawalkam Elayavalli; Sr,9,0,10,1
1739704327195,MATH 248,A00,846189,Bejenaru; Ioan,9,0,10,1
1739704328222,MATH 250C,A00,846190,Chow; Bennett,18,0,20,2
1739704329254,MATH 258,A00,846191,Ni; Lei,10,0,10,0
1739704330282,MATH 262A,A00,846192,Suk; Andrew Hoon,17,0,20,3
1739704331311,MATH 264C,A00,846193,Rhoades; Brendon Patrick,18,0,20,2
1739704332338,MATH 269,A00,846194,Warnke; Lutz Peter,9,0,10,1
1739704333369,MATH 270C,A00,846195,Leok; Melvin,14,0,20,6
1739704334394,MATH 271C,A00,846197,Nie; Jiawang,16,0,20,4
1739704335426,MATH 272C,A00,846198,Miller; Pearson,20,0,20,0
1739704336465,MATH 276,A00,846199,Mc Culloch; Andrew Douglas,0,0,0,0
1739704337492,MATH 278A,A00,846283,Cheng; Li-Tien,10,0,10,0
1739704338516,MATH 278B,A00,846322,Cloninger; Alexander,10,0,10,0
1739704339543,MATH 278C,A00,846333,Nie; Jiawang,10,0,10,0
1739704340567,MATH 279,A01,846359,Cheng; Li-Tien,10,0,10,0
1739704341593,MATH 280C,A00,846360,Kemp; Todd Aahron,18,0,20,2
1739704342621,MATH 281C,A00,846363,Zhang; Danna,8,0,20,12
1739704343646,MATH 285,A00,846378,Schweinsberg; Jason,7,0,20,13
1739704344671,MATH 288,A00,846382,Ang; Jie Jun,9,0,10,1
1739704345756,MATH 289A,A00,846386,Novak; Jonathan I,15,0,20,5
1739704345756,MATH 289A,B00,846413,Lou; Zhipeng,13,0,20,7
1739704345756,MATH 289A,C00,876133,Xu; Ronghui,2,0,10,8
1739704346783,MATH 290C,A00,846451,Roberts; Justin Deritter,18,0,20,2
1739704347809,MATH 292,A00,846481,Lu; Yunze,9,0,10,1
1739704348835,MATH 295,A00,846486,Bejenaru; Ioan,50,0,50,0
1739704349860,MATH 296,A00,846492,Warnke; Lutz Peter,20,0,20,0
1739704350887,MATH 297,001,889670,Gamst; Anthony Collins,0,0,0,0
1739704351913,MATS 200,A00,825196,Graeve; Olivia A,9988,0,9999,11
1739704352938,MATS 201B,A00,825197,Garay; Javier,44,0,55,11
1739704353964,MATS 205A,A00,825200,Meyers; Marc,15,0,20,5
1739704354988,MATS 252,A00,825203,Evdokimenko; Ekaterina,16,0,30,14
1739704356014,MATS 256,A00,825204,Chen; Renkun,24,0,30,6
1739704357040,MATS 261B,A00,825205,Qiao; Yu,20,0,25,5
1739704358070,MBC 296,001,887235,Staff,9999,0,9999,0
1739704359096,MCWP 40,001,858225,Wastal; Carrie King,14,0,15,1
1739704359096,MCWP 40,003,858230,Wastal; Carrie King,12,0,15,3
1739704359096,MCWP 40,004,858231,Wastal; Carrie King,12,0,15,3
1739704359096,MCWP 40,006,858235,Montejo; Carolina,20,0,20,0
1739704359096,MCWP 40,007,858240,Wastal; Carrie King,15,0,15,0
1739704359096,MCWP 40,008,858241,Wastal; Carrie King,11,0,15,4
1739704360128,MCWP 50,001,826425,Bartulis; Jason Michael,19,0,20,1
1739704360128,MCWP 50,002,826426,Bartulis; Jason Michael,19,0,20,1
1739704360128,MCWP 50,003,826427,Bartulis; Jason Michael,20,0,20,0
1739704360128,MCWP 50,004,826429,Compas; Sean Matthew,17,0,20,3
1739704360128,MCWP 50,005,826431,Compas; Sean Matthew,20,0,20,0
1739704360128,MCWP 50,006,826432,Krone; Jarret,19,0,20,1
1739704360128,MCWP 50,007,826433,Krone; Jarret,19,0,20,1
1739704360128,MCWP 50,008,826434,Redela; Pamela Morgan,20,0,20,0
1739704360128,MCWP 50,009,826435,Redela; Pamela Morgan,20,0,20,0
1739704360128,MCWP 50,010,826436,Carter; Andrea L,17,0,20,3
1739704360128,MCWP 50,011,826437,Carter; Andrea L,20,0,20,0
1739704360128,MCWP 50,012,826439,Nies; Laurie Elizabeth,20,0,20,0
1739704360128,MCWP 50,013,826474,Nies; Laurie Elizabeth,19,0,20,1
1739704360128,MCWP 50,014,826483,Duru; Nur,17,0,20,3
1739704360128,MCWP 50,015,826484,Duru; Nur,20,0,20,0
1739704360128,MCWP 50,016,826486,Silva; Kelly B,20,0,20,0
1739704360128,MCWP 50,017,826488,Silva; Kelly B,20,0,20,0
1739704360128,MCWP 50,018,826489,Silva; Kelly B,20,0,20,0
1739704360128,MCWP 50,019,826490,Carter; Jennifer A,20,0,20,0
1739704360128,MCWP 50,020,826491,Carter; Jennifer A,20,0,20,0
1739704360128,MCWP 50,021,826492,Smith; Haydee Marie,20,0,20,0
1739704360128,MCWP 50,022,826493,Smith; Haydee Marie,19,0,20,1
1739704360128,MCWP 50,023,826543,Morshed; Michael James,16,0,20,4
1739704360128,MCWP 50,024,826579,Morshed; Michael James,16,0,20,4
1739704360128,MCWP 50,025,826582,Pham; Vincent Minhduc,20,0,20,0
1739704360128,MCWP 50,026,826609,Pham; Vincent Minhduc,20,0,20,0
1739704361156,MCWP 50R,A00,826669,Miller; Elizabeth Deen,17,0,20,3
1739704361156,MCWP 50R,B00,826714,Miller; Elizabeth Deen,19,0,20,1
1739704362185,MCWP 125,A00,826719,Guillen; Melinda,20,0,20,0
1739704362185,MCWP 125,B00,826720,Guillen; Melinda,18,0,20,2
1739704362185,MCWP 125,C00,826721,Guillen; Melinda,15,0,20,5
1739704363209,MED 225,A00,872558,Esko; Jeffrey D.,6,0,6,0
1739704364237,MED 246,A00,872562,Gordts; Philip & Lewis; Amanda Lark & Godula; Kamil & Gagneux; Pascal & Esko; Jeffrey D. & Bode; Lars,10,0,10,0
1739704365264,MED 262,A00,883267,Singh; Karandeep,31,0,35,4
1739704366292,MED 265,A00,884437,El-Kareh; Robert E & Sitapati; Amy,27,0,30,3
1739704367318,MED 267,A01,883697,Hogarth; Michael Andrew,23,0,30,7
1739704368547,MED 275,A00,872551,Liu; George Yenhsi,7,0,10,3
1739704369572,MED 278,A00,884420,Carter; Hannah Kathryn & Mesirov; Jill P. & Curtius; Kathleen Mary,14,0,16,2
1739704370599,MED 296,001,866575,Chi; Neil C.,4,0,5,1
1739704370599,MED 296,002,866576,Castellanos; Luis R.,4,0,5,1
1739704370599,MED 296,003,866585,Jeong; Ah-Reum,4,0,5,1
1739704370599,MED 296,004,866590,Staff,5,0,5,0
1739704370599,MED 296,005,866627,Staff,5,0,5,0
1739704371627,MGT 3,A00,839898,Wagner; Timothy Ryan,96,0,98,2
1739704372653,MGT 4,A01,839906,Levkoff; Steven B.,5,0,6,1
1739704372653,MGT 4,A02,839911,Levkoff; Steven B.,5,0,6,1
1739704372653,MGT 4,A03,839913,Levkoff; Steven B.,5,0,6,1
1739704372653,MGT 4,B01,839919,Brooks; Marcus Raymond,30,0,32,2
1739704373679,MGT 5,A00,839921,Molloie Jr.; William H,184,0,186,2
1739704374704,MGT 12,A00,839922,Lindenberger; Wade Douglas,88,0,98,10
1739704374704,MGT 12,B00,839926,Lindenberger; Wade Douglas,75,0,100,25
1739704374704,MGT 12,C00,840027,Pecore; Joseph P.,87,0,100,13
1739704375730,MGT 16,A00,840029,Buchanan; Harold G,95,0,100,5
1739704375730,MGT 16,B00,840031,Buchanan; Harold G,95,0,100,5
1739704375730,MGT 16,C00,840033,Campbell; Robert Harold,119,0,120,1
1739704375730,MGT 16,D00,840034,Campbell; Robert Harold,118,0,120,2
1739704375730,MGT 16,E00,840049,Demill; Burritt,98,0,98,0
1739704375730,MGT 16,F00,840056,Demill; Burritt,97,0,98,1
1739704376762,MGT 18,A00,840060,McKay; Michael J,97,0,98,1
1739704376762,MGT 18,B00,840063,McKay; Michael J,96,0,98,2
1739704376762,MGT 18,C00,840074,McKay; Michael J,94,0,98,4
1739704376762,MGT 18,D00,840076,Chamberlain; Travis Dean,98,0,98,0
1739704377791,MGT 45,A00,840097,Pecore; Joseph P.,128,0,150,22
1739704377791,MGT 45,B00,840098,Pecore; Joseph P.,141,0,150,9
1739704378818,MGT 71,A00,840099,Park; Kun Soo,94,0,98,4
1739704379842,MGT 71R,A00,840101,Phiroz; Zal Navroze,117,0,150,33
1739704381458,MGT 100,A00,840102,Wilbur; Kenneth C,78,0,98,20
1739704381458,MGT 100,B00,840103,Wilbur; Kenneth C,87,0,98,11
1739704381458,MGT 100,C00,840104,Wilbur; Kenneth C,95,0,98,3
1739704382490,MGT 103,A00,840105,Bates; Kenneth Walter,93,0,98,5
1739704382490,MGT 103,B00,840106,Demill; Burritt,97,0,98,1
1739704382490,MGT 103,C00,840107,Eberhard; Craig A,98,0,98,0
1739704382490,MGT 103,D00,840225,Eberhard; Craig A,97,0,98,1
1739704382490,MGT 103,E00,840226,Ehrich; Kristine R,93,0,98,5
1739704382490,MGT 103,F00,840227,Ehrich; Kristine R,95,0,98,3
1739704382490,MGT 103,G00,840228,Ehrich; Kristine R,96,0,98,2
1739704383515,MGT 105,A00,840229,Bates; Kenneth Walter,87,0,98,11
1739704384539,MGT 106,A00,840230,Eberhard; Craig A,96,0,98,2
1739704385567,MGT 107,A00,881472,Yorkston; Eric A,94,0,98,4
1739704386603,MGT 109,A00,840231,Jasko; Katarzyna Beata,85,0,98,13
1739704386603,MGT 109,B00,840232,Liu; Wei,87,0,98,11
1739704387632,MGT 112,A00,840233,Somasundaram; Tyagarajan,91,0,98,7
1739704387632,MGT 112,B00,840234,Somasundaram; Tyagarajan,76,0,98,22
1739704388673,MGT 119,A00,840235,Anderson; Jon Marcus,140,0,140,0
1739704388673,MGT 119,B00,840236,Davis; Kathleen Ann,98,0,98,0
1739704388673,MGT 119,C00,840237,Mc Kenzie; Craig R.M.,97,0,98,1
1739704388673,MGT 119,D00,840238,Etingue Kum; Menes,40,0,40,0
1739704389702,MGT 121B,A00,840239,Klaas; Jeffrey David,91,0,98,7
1739704390735,MGT 128R,A00,840240,Krishnan; Viswanathan,83,0,98,15
1739704391764,MGT 131A,A00,840242,Houskeeper; Robert,147,0,150,3
1739704392792,MGT 131B,A00,840243,Houskeeper; Robert,98,0,98,0
1739704393817,MGT 132,A00,840244,Blakley; Bruce,95,0,98,3
1739704394843,MGT 137,A00,840245,Lindenberger; Wade Douglas,84,0,98,14
1739704395869,MGT 146,A00,881478,Brooks; Marcus Raymond,97,0,98,1
1739704396896,MGT 147,A00,840246,Anderson; John Charles,74,0,75,1
1739704397922,MGT 151R,A00,840253,Phiroz; Zal Navroze,84,0,98,14
1739704398950,MGT 153,A00,840254,Perols; Johan Lars,67,0,90,23
1739704399975,MGT 155,A00,881481,Shin; Hyo Duk,95,0,98,3
1739704401000,MGT 160,A00,840265,Johnson; Erik Barry,90,0,90,0
1739704401000,MGT 160,B00,840266,Staff,87,0,90,3
1739704401000,MGT 160,C00,840267,Staff,82,0,90,8
1739704402028,MGT 162,A00,840269,Levin; Joel,93,0,98,5
1739704402028,MGT 162,B00,840270,Levin; Joel,98,0,98,0
1739704403057,MGT 162R,A00,840271,Gneezy; Uri,173,0,199,26
1739704404083,MGT 164,A00,840272,McKay; Mary A,98,0,98,0
1739704404083,MGT 164,B00,840273,McKay; Mary A,97,0,98,1
1739704404083,MGT 164,C00,840274,McKay; Mary A,97,0,98,1
1739704404083,MGT 164,D00,840275,Meyer; Alison Bloomfield,92,0,98,6
1739704405109,MGT 166,A00,840365,Moran; Cathleen L.,98,0,98,0
1739704405109,MGT 166,B00,840429,Moran; Cathleen L.,96,0,98,2
1739704405109,MGT 166,C00,840430,Moran; Cathleen L.,97,0,98,1
1739704406138,MGT 167,A00,840431,Klaas; Jeffrey David,96,0,98,2
1739704407163,MGT 171R,A00,840478,Phiroz; Zal Navroze,73,0,98,25
1739704408189,MGT 172,A00,840536,Hedges; Kathleen & Royal; Rebecca,114,0,120,6
1739704408189,MGT 172,B00,840580,Hedges; Kathleen,92,0,98,6
1739704408189,MGT 172,C00,840581,Zimmermann; Carsten,96,0,98,2
1739704408189,MGT 172,D00,881483,Zimmermann; Carsten,97,0,98,1
1739704409215,MGT 173,A00,840604,Hayes; Sherry Lorine,91,0,98,7
1739704410240,MGT 175,A00,840636,Gopal; Christopher S.,94,0,98,4
1739704411268,MGT 180,A00,840641,Bliss; Barbara Ann,145,0,150,5
1739704411268,MGT 180,B00,840642,Bliss; Barbara Ann,143,0,150,7
1739704412295,MGT 181,A00,840643,Buchanan; Harold G,117,0,120,3
1739704413319,MGT 184,A00,886143,Parashar; Sat P,89,0,98,9
1739704414348,MGT 185,A00,840648,Dunn; Louis Jean,88,0,98,10
1739704415371,MGT 187,A00,840649,Dunn; Louis Jean,68,0,75,7
1739704416397,MGT 189,A00,840650,Avenancio-Leon; Carlos,88,0,98,10
1739704417424,MGT 255,A00,840651,Rottenstreich; Yuval S,15,0,20,5
1739704418452,MGT 259,A00,872537,Staff,16,0,20,4
1739704419477,MGT 285,A00,840652,Liu; Jun,20,0,20,0
1739704420527,MGT 296,001,870424,Gneezy; Ayelet,3,0,3,0
1739704420527,MGT 296,002,870453,Amir; On,3,0,3,0
1739704420527,MGT 296,003,870454,Amir; On & Karmarkar; Uma R,3,0,3,0
1739704420527,MGT 296,004,870455,Liu; Jun,2,0,3,1
1739704420527,MGT 296,005,870456,Hansen; Karsten T.,3,0,3,0
1739704420527,MGT 296,006,870471,Erat; Sanjiv,3,0,3,0
1739704420527,MGT 296,007,870472,Timmermann; Allan,3,0,3,0
1739704420527,MGT 296,008,870501,Smith; Pamela Karen,3,0,3,0
1739704420527,MGT 296,009,870502,Zhang; Zhe,3,0,3,0
1739704420527,MGT 296,010,870508,Oveis; Christopher S,3,0,3,0
1739704420527,MGT 296,011,870523,Amir; On & Gneezy; Ayelet,2,0,3,1
1739704420527,MGT 296,012,870537,Luo; Danqi,3,0,3,0
1739704421599,MMW 13,A01,823232,Chang; Edmond Yi-Teh,16,0,16,0
1739704421599,MMW 13,A02,823239,Chang; Edmond Yi-Teh,16,0,16,0
1739704421599,MMW 13,A03,823242,Chang; Edmond Yi-Teh,16,0,16,0
1739704421599,MMW 13,A04,823251,Chang; Edmond Yi-Teh,16,0,16,0
1739704421599,MMW 13,A05,823252,Chang; Edmond Yi-Teh,16,0,16,0
1739704421599,MMW 13,A06,823253,Chang; Edmond Yi-Teh,15,0,16,1
1739704421599,MMW 13,A07,823255,Chang; Edmond Yi-Teh,16,0,16,0
1739704421599,MMW 13,A08,823257,Chang; Edmond Yi-Teh,16,0,16,0
1739704421599,MMW 13,A09,823263,Chang; Edmond Yi-Teh,16,0,16,0
1739704421599,MMW 13,A10,823291,Chang; Edmond Yi-Teh,16,0,16,0
1739704421599,MMW 13,A11,823292,Chang; Edmond Yi-Teh,16,0,16,0
1739704421599,MMW 13,A12,823293,Chang; Edmond Yi-Teh,16,0,16,0
1739704421599,MMW 13,A13,823370,Chang; Edmond Yi-Teh,0,0,0,0
1739704421599,MMW 13,A14,823480,Chang; Edmond Yi-Teh,0,0,0,0
1739704421599,MMW 13,A15,823481,Chang; Edmond Yi-Teh,16,0,16,0
1739704421599,MMW 13,A16,823482,Chang; Edmond Yi-Teh,15,0,16,1
1739704421599,MMW 13,A17,823483,Chang; Edmond Yi-Teh,16,0,16,0
1739704421599,MMW 13,A18,823484,Chang; Edmond Yi-Teh,16,0,16,0
1739704421599,MMW 13,A19,823485,Chang; Edmond Yi-Teh,0,0,0,0
1739704421599,MMW 13,A20,823486,Chang; Edmond Yi-Teh,0,0,0,0
1739704421599,MMW 13,B01,823488,Zhiri; Oumelbanine,15,0,16,1
1739704421599,MMW 13,B02,823490,Zhiri; Oumelbanine,15,0,16,1
1739704421599,MMW 13,B03,823491,Zhiri; Oumelbanine,14,0,16,2
1739704421599,MMW 13,B04,823492,Zhiri; Oumelbanine,15,0,16,1
1739704421599,MMW 13,B05,823493,Zhiri; Oumelbanine,16,0,16,0
1739704421599,MMW 13,B06,823494,Zhiri; Oumelbanine,13,0,16,3
1739704421599,MMW 13,B07,823495,Zhiri; Oumelbanine,15,0,16,1
1739704421599,MMW 13,B08,823496,Zhiri; Oumelbanine,15,0,16,1
1739704421599,MMW 13,B09,823522,Zhiri; Oumelbanine,16,0,16,0
1739704421599,MMW 13,B10,823528,Zhiri; Oumelbanine,16,0,16,0
1739704421599,MMW 13,B11,823604,Zhiri; Oumelbanine,16,0,16,0
1739704421599,MMW 13,B12,823613,Zhiri; Oumelbanine,16,0,16,0
1739704421599,MMW 13,B13,823624,Zhiri; Oumelbanine,16,0,16,0
1739704421599,MMW 13,B14,823627,Zhiri; Oumelbanine,15,0,16,1
1739704421599,MMW 13,B15,823631,Zhiri; Oumelbanine,16,0,16,0
1739704421599,MMW 13,B16,823642,Zhiri; Oumelbanine,15,0,16,1
1739704421599,MMW 13,C01,823773,Murillo; Dana V.,16,0,16,0
1739704421599,MMW 13,C02,823774,Murillo; Dana V.,16,0,16,0
1739704421599,MMW 13,C03,823793,Murillo; Dana V.,16,0,16,0
1739704421599,MMW 13,C04,823794,Murillo; Dana V.,16,0,16,0
1739704421599,MMW 13,C05,823801,Murillo; Dana V.,16,0,16,0
1739704421599,MMW 13,C06,823856,Murillo; Dana V.,16,0,16,0
1739704421599,MMW 13,C07,823876,Murillo; Dana V.,16,0,16,0
1739704421599,MMW 13,C08,823878,Murillo; Dana V.,16,0,16,0
1739704421599,MMW 13,C09,823956,Murillo; Dana V.,0,0,0,0
1739704421599,MMW 13,C10,823978,Murillo; Dana V.,0,0,0,0
1739704421599,MMW 13,C11,824009,Murillo; Dana V.,0,0,0,0
1739704421599,MMW 13,C12,824022,Murillo; Dana V.,0,0,0,0
1739704421599,MMW 13,C13,824023,Murillo; Dana V.,16,0,16,0
1739704421599,MMW 13,C14,824027,Murillo; Dana V.,15,0,16,1
1739704421599,MMW 13,C15,824029,Murillo; Dana V.,0,0,0,0
1739704421599,MMW 13,C16,824036,Murillo; Dana V.,0,0,0,0
1739704421599,MMW 13,D01,824044,Vitkus; Daniel J.,16,0,16,0
1739704421599,MMW 13,D02,824045,Vitkus; Daniel J.,16,0,16,0
1739704421599,MMW 13,D03,824050,Vitkus; Daniel J.,16,0,16,0
1739704421599,MMW 13,D04,824066,Vitkus; Daniel J.,16,0,16,0
1739704421599,MMW 13,D05,824070,Vitkus; Daniel J.,16,0,16,0
1739704421599,MMW 13,D06,824080,Vitkus; Daniel J.,16,0,16,0
1739704421599,MMW 13,D07,824081,Vitkus; Daniel J.,16,0,16,0
1739704421599,MMW 13,D08,824092,Vitkus; Daniel J.,16,0,16,0
1739704421599,MMW 13,D09,824112,Vitkus; Daniel J.,0,0,0,0
1739704421599,MMW 13,D10,824248,Vitkus; Daniel J.,0,0,0,0
1739704421599,MMW 13,D11,824303,Vitkus; Daniel J.,0,0,0,0
1739704421599,MMW 13,D12,824311,Vitkus; Daniel J.,0,0,0,0
1739704421599,MMW 13,D13,824312,Vitkus; Daniel J.,16,0,16,0
1739704421599,MMW 13,D14,824317,Vitkus; Daniel J.,16,0,16,0
1739704421599,MMW 13,D15,824377,Vitkus; Daniel J.,0,0,0,0
1739704421599,MMW 13,D16,824378,Vitkus; Daniel J.,0,0,0,0
1739704422633,MMW 15,A01,824426,Chang; Edmond Yi-Teh,27,0,28,1
1739704422633,MMW 15,A02,824586,Chang; Edmond Yi-Teh,26,0,28,2
1739704422633,MMW 15,A03,824617,Chang; Edmond Yi-Teh,24,0,28,4
1739704422633,MMW 15,A04,824641,Chang; Edmond Yi-Teh,26,0,28,2
1739704422633,MMW 15,A05,824653,Chang; Edmond Yi-Teh,25,0,28,3
1739704422633,MMW 15,A06,824689,Chang; Edmond Yi-Teh,28,0,28,0
1739704422633,MMW 15,A07,824735,Chang; Edmond Yi-Teh,28,0,28,0
1739704422633,MMW 15,A08,824804,Chang; Edmond Yi-Teh,27,0,28,1
1739704422633,MMW 15,A09,824805,Chang; Edmond Yi-Teh,0,0,0,0
1739704422633,MMW 15,A10,824963,Chang; Edmond Yi-Teh,0,0,0,0
1739704422633,MMW 15,B01,824999,Peterson; Johanna L,0,0,0,0
1739704422633,MMW 15,B02,825015,Peterson; Johanna L,0,0,0,0
1739704422633,MMW 15,B03,825050,Peterson; Johanna L,18,0,28,10
1739704422633,MMW 15,B04,825079,Peterson; Johanna L,24,0,28,4
1739704422633,MMW 15,B05,825109,Peterson; Johanna L,27,0,28,1
1739704422633,MMW 15,B06,825114,Peterson; Johanna L,24,0,28,4
1739704422633,MMW 15,B07,825151,Peterson; Johanna L,23,0,28,5
1739704422633,MMW 15,B08,825183,Peterson; Johanna L,19,0,28,9
1739704422633,MMW 15,B09,825190,Peterson; Johanna L,28,0,28,0
1739704422633,MMW 15,B10,825191,Peterson; Johanna L,26,0,28,2
1739704422633,MMW 15,B11,825192,Peterson; Johanna L,0,0,0,0
1739704422633,MMW 15,B12,825193,Peterson; Johanna L,0,0,0,0
1739704423660,MSED 295,A00,825207,Staff,5,0,5,0
1739704424690,MUS 1C,A01,826943,Staff,24,0,25,1
1739704424690,MUS 1C,A02,826944,Staff,23,0,25,2
1739704424690,MUS 1C,A03,826945,Staff,25,0,25,0
1739704425715,MUS 2C,A01,826955,Obermueller; Karola,29,0,30,1
1739704426741,MUS 2CK,A00,826957,Ohnishi; Takae,14,0,15,1
1739704426741,MUS 2CK,B00,826960,Ohnishi; Takae,15,0,15,0
1739704427765,MUS 2JK,A00,826963,Kenyatta; Kamau,13,0,15,2
1739704428796,MUS 4,A01,826968,Day; Kevin Alexander,24,0,25,1
1739704428796,MUS 4,A02,826969,Day; Kevin Alexander,24,0,25,1
1739704428796,MUS 4,A03,826970,Day; Kevin Alexander,25,0,25,0
1739704428796,MUS 4,A04,826972,Day; Kevin Alexander,25,0,25,0
1739704428796,MUS 4,A05,826973,Day; Kevin Alexander,25,0,25,0
1739704428796,MUS 4,A06,826986,Day; Kevin Alexander,25,0,25,0
1739704428796,MUS 4,A07,826987,Day; Kevin Alexander,25,0,25,0
1739704428796,MUS 4,A08,826988,Day; Kevin Alexander,25,0,25,0
1739704428796,MUS 4,A09,826989,Day; Kevin Alexander,25,0,25,0
1739704428796,MUS 4,A10,826990,Day; Kevin Alexander,24,0,25,1
1739704429822,MUS 6,A01,826992,Hankins; Sarah E.,24,0,25,1
1739704429822,MUS 6,A02,826993,Hankins; Sarah E.,23,0,25,2
1739704429822,MUS 6,A03,826994,Hankins; Sarah E.,25,0,25,0
1739704429822,MUS 6,A04,826995,Hankins; Sarah E.,22,0,25,3
1739704430857,MUS 8,A01,826997,Smythe; Cory Benjamin,23,0,25,2
1739704430857,MUS 8,A02,826998,Smythe; Cory Benjamin,25,0,25,0
1739704430857,MUS 8,A03,827002,Smythe; Cory Benjamin,25,0,25,0
1739704430857,MUS 8,A04,827003,Smythe; Cory Benjamin,22,0,25,3
1739704430857,MUS 8,A05,827004,Smythe; Cory Benjamin,25,0,25,0
1739704430857,MUS 8,A06,827005,Smythe; Cory Benjamin,25,0,25,0
1739704430857,MUS 8,A07,827006,Smythe; Cory Benjamin,24,0,25,1
1739704430857,MUS 8,A08,827007,Smythe; Cory Benjamin,23,0,25,2
1739704431884,MUS 11,A01,827011,Terrazas Perez; Wilfrido D,23,0,25,2
1739704431884,MUS 11,A02,827012,Terrazas Perez; Wilfrido D,23,0,25,2
1739704431884,MUS 11,A03,827013,Terrazas Perez; Wilfrido D,25,0,25,0
1739704431884,MUS 11,A04,827014,Terrazas Perez; Wilfrido D,24,0,25,1
1739704431884,MUS 11,A05,827015,Terrazas Perez; Wilfrido D,25,0,25,0
1739704431884,MUS 11,A06,827016,Terrazas Perez; Wilfrido D,25,0,25,0
1739704431884,MUS 11,A07,827017,Terrazas Perez; Wilfrido D,25,0,25,0
1739704431884,MUS 11,A08,827018,Terrazas Perez; Wilfrido D,22,0,25,3
1739704432915,MUS 12,A01,827020,Guy; Nancy,24,0,25,1
1739704432915,MUS 12,A02,827021,Guy; Nancy,25,0,25,0
1739704432915,MUS 12,A03,827022,Guy; Nancy,25,0,25,0
1739704432915,MUS 12,A04,827023,Guy; Nancy,24,0,25,1
1739704433940,MUS 14,A01,827025,McCormack; Timothy Matthew,25,0,25,0
1739704433940,MUS 14,A02,827026,McCormack; Timothy Matthew,25,0,25,0
1739704433940,MUS 14,A03,827027,McCormack; Timothy Matthew,24,0,25,1
1739704433940,MUS 14,A04,827028,McCormack; Timothy Matthew,25,0,25,0
1739704434971,MUS 15,A01,827031,Staff,22,0,25,3
1739704434971,MUS 15,A02,827032,Staff,23,0,25,2
1739704434971,MUS 15,A03,827033,Staff,24,0,25,1
1739704434971,MUS 15,A04,827034,Staff,25,0,25,0
1739704434971,MUS 15,A05,827035,Staff,25,0,25,0
1739704434971,MUS 15,A06,827036,Staff,23,0,25,2
1739704434971,MUS 15,A07,827037,Staff,25,0,25,0
1739704434971,MUS 15,A08,827038,Staff,24,0,25,1
1739704434971,MUS 15,A09,827039,Staff,25,0,25,0
1739704434971,MUS 15,A10,827049,Staff,23,0,25,2
1739704436002,MUS 17,A01,827051,Staff,23,0,25,2
1739704436002,MUS 17,A02,827052,Staff,25,0,25,0
1739704436002,MUS 17,A03,827053,Staff,25,0,25,0
1739704436002,MUS 17,A04,827054,Staff,24,0,25,1
1739704436002,MUS 17,A05,827055,Staff,25,0,25,0
1739704436002,MUS 17,A06,827056,Staff,24,0,25,1
1739704436002,MUS 17,A07,827057,Staff,24,0,25,1
1739704436002,MUS 17,A08,827060,Staff,23,0,25,2
1739704436002,MUS 17,A09,827061,Staff,25,0,25,0
1739704436002,MUS 17,A10,827062,Staff,25,0,25,0
1739704436002,MUS 17,A11,827063,Staff,25,0,25,0
1739704436002,MUS 17,A12,827064,Staff,24,0,25,1
1739704437032,MUS 19R,A01,827066,Britt; King James,23,0,25,2
1739704437032,MUS 19R,A02,827067,Britt; King James,15,0,25,10
1739704437032,MUS 19R,A03,827068,Britt; King James,25,0,25,0
1739704437032,MUS 19R,A04,827069,Britt; King James,22,0,25,3
1739704437032,MUS 19R,A05,827070,Britt; King James,25,0,25,0
1739704437032,MUS 19R,A06,827071,Britt; King James,21,0,25,4
1739704437032,MUS 19R,A07,827072,Britt; King James,24,0,25,1
1739704437032,MUS 19R,A08,827083,Britt; King James,23,0,25,2
1739704437032,MUS 19R,B01,827121,Britt; King James,5,0,5,0
1739704437032,MUS 19R,B02,827122,Britt; King James,5,0,5,0
1739704437032,MUS 19R,B03,827123,Britt; King James,5,0,5,0
1739704437032,MUS 19R,B04,827128,Britt; King James,5,0,5,0
1739704437032,MUS 19R,B05,827129,Britt; King James,5,0,5,0
1739704437032,MUS 19R,B06,827130,Britt; King James,5,0,5,0
1739704437032,MUS 19R,B07,827198,Britt; King James,5,0,5,0
1739704437032,MUS 19R,B08,827199,Britt; King James,5,0,5,0
1739704438073,MUS 32,001,855621,Dresser; Mark Stuart,10,0,10,0
1739704438073,MUS 32,002,855622,Kenyatta; Kamau,10,0,10,0
1739704438073,MUS 32,003,855623,Curtis; Charles Rector,10,0,10,0
1739704438073,MUS 32,004,855624,Carlstrom; Mitchell Kraig,10,0,10,0
1739704438073,MUS 32,005,855625,Terrazas Perez; Wilfrido D,10,0,10,0
1739704438073,MUS 32,006,855628,Ohnishi; Takae,10,0,10,0
1739704438073,MUS 32,007,855629,Burr; Anthony I,10,0,10,0
1739704438073,MUS 32,008,855630,Carlson; Erik,10,0,10,0
1739704438073,MUS 32,009,855631,Staff,10,0,10,0
1739704439101,MUS 32V,A00,827206,Narucki; Susan M,10,0,10,0
1739704439101,MUS 32V,B00,827209,Flores Bucio; Mariana,10,0,10,0
1739704439101,MUS 32V,C00,827210,Zazueta Cervera; Miguel Angel,10,0,10,0
1739704440127,MUS 32VM,A00,827211,Zazueta Cervera; Miguel Angel,19,0,19,0
1739704441153,MUS 43,A00,827216,Yadegari; Shahrokh D,91,0,96,5
1739704442179,MUS 95C,A00,827217,Flores Bucio; Mariana,34,0,40,6
1739704443205,MUS 95D,A00,827219,Yadegari; Shahrokh D,40,0,40,0
1739704444230,MUS 95E,A00,827229,Henson; Matthew Alexander,40,0,40,0
1739704445268,MUS 95F,A00,827332,Carlstrom; Mitchell Kraig,40,0,40,0
1739704446294,MUS 95G,A00,827371,Anderson; Kenneth,386,0,395,9
1739704446294,MUS 95G,B00,827384,Anderson; Kenneth,391,0,395,4
1739704447320,MUS 95JC,A00,827385,Kenyatta; Kamau,25,0,25,0
1739704448346,MUS 95L,A00,827386,Pittman; Katherine Sue,65,0,65,0
1739704449370,MUS 95P,A00,827387,Nourai; Keyavash,17,0,20,3
1739704450453,MUS 95W,A00,827388,Seshadri; Kartik,21,0,25,4
1739704450453,MUS 95W,B00,827389,Seshadri; Kartik,25,0,25,0
1739704451480,MUS 101C,A01,827517,Day; Kevin Alexander,34,0,35,1
1739704452512,MUS 103C,A00,827518,Steiger; Rand,14,0,15,1
1739704453540,MUS 103F,A00,827546,Steiger; Rand,1,0,1,0
1739704454582,MUS 107,A00,827547,Guy; Nancy,15,0,15,0
1739704455610,MUS 111,A00,827548,Liang; Lei,118,0,120,2
1739704456636,MUS 113,A00,827549,Narucki; Susan M,30,0,30,0
1739704457661,MUS 114,A00,827550,Schick; Steven,138,0,140,2
1739704458688,MUS 120C,A01,827563,Leslie Santana; Myrta,24,0,25,1
1739704459714,MUS 130,A00,827567,Ohnishi; Takae,35,0,35,0
1739704460745,MUS 132,001,855633,Dresser; Mark Stuart,10,0,10,0
1739704460745,MUS 132,002,855635,Kenyatta; Kamau,10,0,10,0
1739704460745,MUS 132,003,855637,Curtis; Charles Rector,10,0,10,0
1739704460745,MUS 132,004,855639,Carlstrom; Mitchell Kraig,10,0,10,0
1739704460745,MUS 132,006,855641,Terrazas Perez; Wilfrido D,10,0,10,0
1739704460745,MUS 132,007,855642,Ohnishi; Takae,10,0,10,0
1739704460745,MUS 132,008,855643,Burr; Anthony I,10,0,10,0
1739704460745,MUS 132,009,855646,Carlson; Erik,10,0,10,0
1739704460745,MUS 132,010,855647,Smythe; Cory Benjamin,10,0,10,0
1739704460745,MUS 132,011,855648,Richards; Stephanie F,10,0,10,0
1739704460745,MUS 132,012,855649,Nourai; Keyavash,10,0,10,0
1739704461769,MUS 132R,A00,827568,Narucki; Susan M,2,0,2,0
1739704462796,MUS 132V,A00,827569,Narucki; Susan M,15,0,15,0
1739704462796,MUS 132V,B00,827570,Zazueta Cervera; Miguel Angel,15,0,15,0
1739704462796,MUS 132V,C00,827572,Flores Bucio; Mariana,15,0,15,0
1739704463821,MUS 134,A00,827573,Yadegari; Shahrokh D,30,0,30,0
1739704464847,MUS 137C,A00,827574,Kenyatta; Kamau,35,0,35,0
1739704465874,MUS 143,A00,827575,Yadegari; Shahrokh D,28,0,30,2
1739704466903,MUS 150,A00,872496,Roberts; Matana,28,0,30,2
1739704467930,MUS 151,A00,827577,Hankins; Sarah E.,9,0,20,11
1739704468954,MUS 160B,A00,827579,Dubnov; Shlomo,14,0,15,1
1739704468954,MUS 160B,B00,827581,Freitas Caetano; Marcelo,15,0,15,0
1739704469979,MUS 172,A01,827584,Staff,37,0,45,8
1739704471006,MUS 174C,A00,827585,Erbe; Tom,21,0,27,6
1739704472031,MUS 175,A00,827586,Smyth; Tamara R.,27,0,30,3
1739704473056,MUS 176,A00,827587,Britt; King James,30,0,30,0
1739704474082,MUS 201A,A00,827590,Narucki; Susan M,15,0,15,0
1739704474082,MUS 201A,B00,827592,Dresser; Mark Stuart,15,0,15,0
1739704475108,MUS 201C,A00,827593,Schick; Steven,15,0,15,0
1739704476136,MUS 202,A00,827596,Schick; Steven,40,0,40,0
1739704477164,MUS 203C,A00,827597,McCormack; Timothy Matthew,13,0,15,2
1739704478191,MUS 203D,A00,827598,Davis; Anthony Curtis,10,0,10,0
1739704478191,MUS 203D,B00,827599,Obermueller; Karola,10,0,10,0
1739704478191,MUS 203D,C00,827600,Liang; Lei,10,0,10,0
1739704478191,MUS 203D,D00,827601,Lou; Michelle Siulai,10,0,10,0
1739704478191,MUS 203D,E00,827602,Steiger; Rand,10,0,10,0
1739704478191,MUS 203D,F00,827605,McCormack; Timothy Matthew,10,0,10,0
1739704479214,MUS 204,A00,827607,Obermueller; Karola,24,0,25,1
1739704480242,MUS 205,A00,827608,Hankins; Sarah E.,14,0,15,1
1739704481271,MUS 206,A00,827609,Lou; Michelle Siulai,0,0,0,0
1739704481271,MUS 206,B00,827610,Dresser; Mark Stuart,15,0,15,0
1739704481271,MUS 206,C00,872457,Roberts; Matana,14,0,15,1
1739704482297,MUS 207,A00,827611,Leslie Santana; Myrta,13,0,15,2
1739704482297,MUS 207,B00,872458,Guy; Nancy,15,0,15,0
1739704483325,MUS 210,A00,827612,Davis; Anthony Curtis,15,0,15,0
1739704484354,MUS 229,A00,872460,Liang; Lei,15,0,15,0
1739704485381,MUS 232,001,855654,Dresser; Mark Stuart,10,0,10,0
1739704485381,MUS 232,002,855655,Kenyatta; Kamau,10,0,10,0
1739704485381,MUS 232,003,855656,Curtis; Charles Rector,10,0,10,0
1739704485381,MUS 232,004,855659,Terrazas Perez; Wilfrido D,10,0,10,0
1739704485381,MUS 232,005,855660,Ohnishi; Takae,10,0,10,0
1739704485381,MUS 232,006,855661,Burr; Anthony I,10,0,10,0
1739704485381,MUS 232,007,855662,Carlson; Erik,10,0,10,0
1739704485381,MUS 232,008,855663,Schick; Steven,10,0,10,0
1739704485381,MUS 232,009,855664,Narucki; Susan M,10,0,10,0
1739704486406,MUS 234,A00,827614,Yadegari; Shahrokh D,20,0,20,0
1739704487432,MUS 245,A00,827616,Carlson; Erik,15,0,15,0
1739704488456,MUS 267,A00,827617,Erbe; Tom,13,0,15,2
1739704489480,MUS 270C,A00,827618,Dubnov; Shlomo,18,0,20,2
1739704490507,NANO 100L,A00,808557,Vecchio; Kenneth S,17,0,20,3
1739704491533,NANO 103,A00,808560,Jahed Motlagh; Zeinab,49,0,50,1
1739704492558,NANO 108,A00,808561,Lubarda; Vlado,100,0,100,0
1739704493587,NANO 112,A01,808563,Vazquez Mena; Oscar,69,0,70,1
1739704494617,NANO 115L,A01,808567,Xu; Sheng,32,0,38,6
1739704494617,NANO 115L,B01,808569,Yang; Kesong,38,0,38,0
1739704495642,NANO 120B,A01,808575,Pokorski; Jonathan Kyle,32,0,35,3
1739704495642,NANO 120B,B01,808577,Ong; Shyue Ping,34,0,35,1
1739704496670,NANO 158,A00,808580,Luo; Jian,50,0,50,0
1739704497700,NANO 174,A00,808582,Meyers; Marc,49,0,50,1
1739704498725,NANO 181R,A00,869155,Ong; Shyue Ping,38,0,40,2
1739704499750,NANO 200,A00,808584,Jahed Motlagh; Zeinab,108,0,120,12
1739704500781,NANO 273,A00,808614,Shah; Nisarg,24,0,30,6
1739704501810,NANO 279,A00,808619,Liu; Ping,44,0,50,6
1739704502838,NANO 281R,A00,808633,Ong; Shyue Ping,37,0,60,23
1739704503863,NANO 282,A00,808661,Steinmetz; Nicole F,49,0,50,1
1739704504891,NEU 200C,A00,827621,Miller; Cory T.,15,0,18,3
1739704505920,NEU 276,A01,827623,Castle; Michael James,26,0,28,2
1739704506945,NEU 296,001,866729,Evans; Sean Jeffrey,6,0,10,4
1739704506945,NEU 296,002,866730,Staff,5,0,5,0
1739704506945,NEU 296,003,866731,Staff,5,0,5,0
1739704507970,NEUG 221,A00,827624,Zou; Yimin,8,0,12,4
1739704508996,NEUG 280,A00,827625,Chen; Xu,12,0,12,0
1739704510026,NEUG 296,A00,827626,Bloodgood; Brenda Laurie,9999,0,9999,0
1739704510026,NEUG 296,B00,827627,Allen; Nicola J,9999,0,9999,0
1739704511050,OPTH 296,001,866835,Afshari; Natalie,4,0,5,1
1739704511050,OPTH 296,002,866836,Staff,5,0,5,0
1739704511050,OPTH 296,003,866838,Staff,5,0,5,0
1739704512079,ORTH 296,A00,866851,Staff,5,0,5,0
1739704512079,ORTH 296,001,866849,Schwartz; Alexandra K.,4,0,5,1
1739704512079,ORTH 296,002,866850,Staff,5,0,5,0
1739704513107,PAE 240,A00,866068,Villarreal Jr.; Elias,30,0,30,0
1739704514133,PAE 241,A01,866073,Villarreal Jr.; Elias,30,0,30,0
1739704515160,PAE 242,A00,866077,Villarreal Jr.; Elias,30,0,30,0
1739704516186,PAE 243,A00,866078,Villarreal Jr.; Elias,30,0,30,0
1739704517215,PAE 244,A00,866119,Villarreal Jr.; Elias,30,0,30,0
1739704518244,PAE 245,A01,866083,Villarreal Jr.; Elias,30,0,30,0
1739704519271,PAE 246,A00,866085,Villarreal Jr.; Elias,30,0,30,0
1739704520298,PATH 296,001,866942,Staff,5,0,5,0
1739704520298,PATH 296,002,866945,Staff,5,0,5,0
1739704520298,PATH 296,003,866947,Staff,5,0,5,0
1739704521323,PEDS 296,001,866976,Staff,5,0,5,0
1739704521323,PEDS 296,002,866982,Staff,5,0,5,0
1739704521323,PEDS 296,003,866985,Staff,5,0,5,0
1739704522350,PH 45,A01,818863,Stone; Matthew David,28,0,30,2
1739704522350,PH 45,A02,818864,Stone; Matthew David,26,0,30,4
1739704523375,PH 50,A00,818865,Glockner; Susan Mariscal,291,0,300,9
1739704524403,PH 95,A00,885315,Larsen; Britta Ann,39,0,40,1
1739704525429,PH 101,A00,818868,Tan; Gene Brian,43,0,50,7
1739704526455,PH 102,A01,818870,Rana; Brinda Kanti,17,0,25,8
1739704526455,PH 102,A02,818871,Rana; Brinda Kanti,22,0,25,3
1739704526455,PH 102,B01,818963,Rana; Brinda Kanti,21,0,25,4
1739704526455,PH 102,B02,818965,Rana; Brinda Kanti,24,0,25,1
1739704527485,PH 110,A00,818966,Campbell; Chadwick Karl,58,0,60,2
1739704527485,PH 110,B00,818968,Zoumas-Morse; Christine E.,46,0,50,4
1739704528514,PH 120,A00,818972,Wynn; Adriane Michelle,50,0,60,10
1739704529542,PH 130,A00,818976,Gould; Carlos Francisco,36,0,50,14
1739704530567,PH 155,A00,818977,Fielding-Miller; Rebecca,68,0,70,2
1739704531595,PH 162,A00,872363,Eikey; Elizabeth Victoria,23,0,30,7
1739704532627,PH 194,A00,818984,Zoumas-Morse; Christine E.,0,0,0,0
1739704532627,PH 194,B00,819006,Zoumas-Morse; Christine E.,0,0,0,0
1739704532627,PH 194,C00,819010,Nguyen-Grozavu; France T.,0,0,0,0
1739704532627,PH 194,D00,819013,Nguyen-Grozavu; France T.,0,0,0,0
1739704532627,PH 194,E00,819017,White; Anne Elizabeth Clar,0,0,0,0
1739704532627,PH 194,F00,819024,Marquez; Becky,0,0,0,0
1739704533656,PH 196BH,A01,819028,Binkin; Nancy Jeanne,20,0,20,0
1739704534683,PHAR 219,A00,828488,Ross; Camille,0,0,0,0
1739704535711,PHAR 227,A00,872418,Zhang; Jin,19,0,20,1
1739704536737,PHAR 231,A00,881484,Daneman; Richard & Newton; Alexandra C.,20,0,20,0
1739704536737,PHAR 231,B00,881486,Staff,20,0,20,0
1739704536737,PHAR 231,C00,881489,Schoeneberg; Johannes,20,0,20,0
1739704537765,PHAR 234,A00,881479,Newton; Alexandra C.,20,0,20,0
1739704538794,PHAR 276,A00,828494,Mc Culloch; Andrew Douglas,0,0,0,0
1739704539819,PHAR 295,A00,828499,Joiner; William J.,14,0,15,1
1739704540848,PHB 223,A00,819029,Vaida; Florin,17,0,36,19
1739704541875,PHB 228,A00,819036,Thomas; Ronald G,26,0,36,10
1739704542903,PHB 248,A00,819043,Xu; Ronghui,10,0,25,15
1739704543929,PHB 281,A00,872569,Staff,55,0,65,10
1739704544955,PHIL 1,A00,829682,Grush; Rick Scott,57,0,60,3
1739704545981,PHIL 10,A01,829896,Grush; Rick Scott,44,0,44,0
1739704545981,PHIL 10,A02,829897,Grush; Rick Scott,43,0,44,1
1739704545981,PHIL 10,A03,829898,Grush; Rick Scott,43,0,44,1
1739704545981,PHIL 10,A04,829899,Grush; Rick Scott,42,0,44,2
1739704545981,PHIL 10,A05,829900,Grush; Rick Scott,42,0,44,2
1739704545981,PHIL 10,A06,829901,Grush; Rick Scott,42,0,44,2
1739704547008,PHIL 13,A01,829909,Brandt; Reuven A,0,0,0,0
1739704547008,PHIL 13,A02,829910,Brandt; Reuven A,21,0,25,4
1739704547008,PHIL 13,A03,829911,Brandt; Reuven A,0,0,0,0
1739704547008,PHIL 13,A04,829912,Brandt; Reuven A,25,0,25,0
1739704547008,PHIL 13,A05,829913,Brandt; Reuven A,23,0,25,2
1739704547008,PHIL 13,A06,829914,Brandt; Reuven A,24,0,25,1
1739704548044,PHIL 27,A01,829916,Harrell; Maralee Mae,20,0,25,5
1739704548044,PHIL 27,A02,829917,Harrell; Maralee Mae,21,0,25,4
1739704548044,PHIL 27,A03,829918,Harrell; Maralee Mae,17,0,25,8
1739704548044,PHIL 27,A04,829919,Harrell; Maralee Mae,23,0,25,2
1739704549068,PHIL 28,A01,829921,Lamey; Andy M.,24,0,25,1
1739704549068,PHIL 28,A02,829922,Lamey; Andy M.,24,0,25,1
1739704549068,PHIL 28,A03,829923,Lamey; Andy M.,15,0,25,10
1739704549068,PHIL 28,A04,829924,Lamey; Andy M.,24,0,25,1
1739704549068,PHIL 28,A05,829925,Lamey; Andy M.,23,0,25,2
1739704549068,PHIL 28,A06,829926,Lamey; Andy M.,24,0,25,1
1739704550092,PHIL 33,A01,829928,Tolley; Clinton,23,0,25,2
1739704550092,PHIL 33,A02,829929,Tolley; Clinton,24,0,25,1
1739704551117,PHIL 50,A00,829930,Yuan; Yuan,111,0,120,9
1739704552142,PHIL 60,A00,829989,Marechal; Patricia,33,0,33,0
1739704553169,PHIL 101,A00,829994,Marechal; Patricia,58,0,60,2
1739704554253,PHIL 102,A00,830057,Johnson; Monte,30,0,33,3
1739704555279,PHIL 108,A00,830058,Hardimon; Michael O.,31,0,33,2
1739704556304,PHIL 112,A00,830059,Hardimon; Michael O.,35,0,40,5
1739704557330,PHIL 120,A00,830060,Carr; Jennifer Rose,50,0,55,5
1739704558359,PHIL 125,A00,830063,Carr; Jennifer Rose,32,0,33,1
1739704559386,PHIL 131,A00,830065,Watkins; Eric,32,0,33,1
1739704560416,PHIL 134,A00,830066,Rudolph; Rachel Etta,31,0,33,2
1739704561445,PHIL 145,A00,830069,McKenzie; Kerry V.,54,0,60,6
1739704562471,PHIL 155,A00,830070,Tolley; Clinton,115,0,120,5
1739704563496,PHIL 160,A00,830071,Yuan; Yuan,32,0,33,1
1739704564528,PHIL 162,A00,830072,Lamey; Andy M.,41,0,42,1
1739704565553,PHIL 173,A00,830076,Brandt; Reuven A,108,0,120,12
1739704566579,PHIL 174,A01,830079,Danks; David J,27,0,27,0
1739704566579,PHIL 174,A02,830080,Danks; David J,27,0,27,0
1739704566579,PHIL 174,A03,830081,Danks; David J,27,0,27,0
1739704566579,PHIL 174,A04,830083,Danks; David J,27,0,27,0
1739704566579,PHIL 174,A05,830084,Danks; David J,26,0,27,1
1739704566579,PHIL 174,A06,830089,Danks; David J,27,0,27,0
1739704566579,PHIL 174,A07,830090,Danks; David J,27,0,27,0
1739704566579,PHIL 174,A08,830093,Danks; David J,27,0,27,0
1739704567605,PHIL 201A,A00,830095,Watkins; Eric,17,0,20,3
1739704568633,PHIL 202,A00,830097,Brink; David O.,16,0,20,4
1739704569657,PHIL 209B,A00,830098,Gere; Catherina M.,9,0,10,1
1739704570686,PHIL 209C,A00,830108,McKenzie; Kerry V.,10,0,10,0
1739704571710,PHIL 232,A00,830138,Sher; Gila,18,0,20,2
1739704572736,PHIL 234,A00,830139,Rudolph; Rachel Etta,18,0,20,2
1739704573764,PHIL 271,A00,830142,Vargas; Manuel Rogelio & Fulkerson; Matthew Todd,10,0,10,0
1739704574789,PHIL 275,A00,830179,Watkins; Eric,9,0,10,1
1739704575818,PHIL 277,A00,830185,Tolley; Clinton,9,0,10,1
1739704576844,PHIL 278,A00,830186,Fulkerson; Matthew Todd & Cohen; Jonathan David,10,0,10,0
1739704577870,PHIL 280,A00,830192,Kovaka; Karenc,10,0,10,0
1739704578898,PHIL 281,A00,830207,Tolley; Clinton,10,0,10,0
1739704579926,PHIL 283,A00,830214,Tolley; Clinton & Vargas; Manuel Rogelio,9,0,10,1
1739704580950,PHIL 284,A00,830244,Kovaka; Karenc,10,0,10,0
1739704581977,PHIL 285,A00,830255,Fulkerson; Matthew Todd & Cohen; Jonathan David,18,0,20,2
1739704583002,PHIL 286,A00,830259,Callender; Craig Adam & Chen; Keming,10,0,10,0
1739704584031,PHIL 287,A00,830262,Johnson; Monte,10,0,10,0
1739704585081,PHIL 290,001,828857,Nelkin; Dana Kay,9999,0,9999,0
1739704585081,PHIL 290,002,828858,Bazargan-Forward; Saba,9999,0,9999,0
1739704585081,PHIL 290,003,828861,Brandt; Reuven A,9999,0,9999,0
1739704585081,PHIL 290,004,828864,Brink; David O.,9999,0,9999,0
1739704585081,PHIL 290,005,828868,Callender; Craig Adam,9999,0,9999,0
1739704585081,PHIL 290,006,828869,Carr; Jennifer Rose,9999,0,9999,0
1739704585081,PHIL 290,007,828875,Cartwright; Nancy D.,9999,0,9999,0
1739704585081,PHIL 290,008,828878,Cohen; Jonathan David,9999,0,9999,0
1739704585081,PHIL 290,009,828880,Danks; David J,9999,0,9999,0
1739704585081,PHIL 290,010,828896,Fulkerson; Matthew Todd,9999,0,9999,0
1739704585081,PHIL 290,011,828897,Grush; Rick Scott,9999,0,9999,0
1739704585081,PHIL 290,012,828934,Hardimon; Michael O.,9999,0,9999,0
1739704585081,PHIL 290,013,828950,Harrell; Maralee Mae,9999,0,9999,0
1739704585081,PHIL 290,014,828951,Johnson; Monte,9999,0,9999,0
1739704585081,PHIL 290,015,828956,Kovaka; Karenc,9999,0,9999,0
1739704585081,PHIL 290,016,828959,Lamey; Andy M.,9999,0,9999,0
1739704585081,PHIL 290,017,828963,Marechal; Patricia,9999,0,9999,0
1739704585081,PHIL 290,018,828969,McKenzie; Kerry V.,9999,0,9999,0
1739704585081,PHIL 290,019,828970,Rickless; Samuel Charles,9999,0,9999,0
1739704585081,PHIL 290,020,828971,Sher; Gila,9999,0,9999,0
1739704585081,PHIL 290,021,828983,Shields; Christopher John,9999,0,9999,0
1739704585081,PHIL 290,022,829062,Tolley; Clinton,9999,0,9999,0
1739704585081,PHIL 290,023,829063,Vargas; Manuel Rogelio,9999,0,9999,0
1739704585081,PHIL 290,024,829065,Watkins; Eric,9999,0,9999,0
1739704585081,PHIL 290,025,829067,Chen; Keming,9999,0,9999,0
1739704585081,PHIL 290,026,829069,Yuan; Yuan,9999,0,9999,0
1739704585081,PHIL 290,027,829070,Kocurek; Alexander William,9999,0,9999,0
1739704585081,PHIL 290,028,829073,Rudolph; Rachel Etta,9999,0,9999,0
1739704586115,PHIL 295,001,829074,Bazargan-Forward; Saba,9999,0,9999,0
1739704586115,PHIL 295,002,829076,Brandt; Reuven A,9999,0,9999,0
1739704586115,PHIL 295,003,829080,Brink; David O.,9999,0,9999,0
1739704586115,PHIL 295,004,829081,Callender; Craig Adam,9999,0,9999,0
1739704586115,PHIL 295,005,829082,Carr; Jennifer Rose,9999,0,9999,0
1739704586115,PHIL 295,006,829135,Cartwright; Nancy D.,9999,0,9999,0
1739704586115,PHIL 295,007,829136,Chen; Keming,9999,0,9999,0
1739704586115,PHIL 295,008,829137,Cohen; Jonathan David,9999,0,9999,0
1739704586115,PHIL 295,009,829138,Danks; David J,9999,0,9999,0
1739704586115,PHIL 295,010,829139,Fulkerson; Matthew Todd,9999,0,9999,0
1739704586115,PHIL 295,011,829143,Grush; Rick Scott,9999,0,9999,0
1739704586115,PHIL 295,012,829144,Hardimon; Michael O.,9999,0,9999,0
1739704586115,PHIL 295,013,829145,Harrell; Maralee Mae,9999,0,9999,0
1739704586115,PHIL 295,014,829146,Johnson; Monte,9999,0,9999,0
1739704586115,PHIL 295,015,829147,Kovaka; Karenc,9999,0,9999,0
1739704586115,PHIL 295,016,829148,Lamey; Andy M.,9999,0,9999,0
1739704586115,PHIL 295,017,829149,Marechal; Patricia,9999,0,9999,0
1739704586115,PHIL 295,018,829150,McKenzie; Kerry V.,9999,0,9999,0
1739704586115,PHIL 295,019,829151,Nelkin; Dana Kay,9999,0,9999,0
1739704586115,PHIL 295,020,829152,Rickless; Samuel Charles,9999,0,9999,0
1739704586115,PHIL 295,021,829153,Sher; Gila,9999,0,9999,0
1739704586115,PHIL 295,022,829154,Shields; Christopher John,9999,0,9999,0
1739704586115,PHIL 295,023,829156,Tolley; Clinton,9999,0,9999,0
1739704586115,PHIL 295,024,829157,Vargas; Manuel Rogelio,9999,0,9999,0
1739704586115,PHIL 295,025,829158,Watkins; Eric,9999,0,9999,0
1739704586115,PHIL 295,026,829159,Kocurek; Alexander William,9999,0,9999,0
1739704586115,PHIL 295,027,829160,Rudolph; Rachel Etta,9999,0,9999,0
1739704586115,PHIL 295,028,829161,Yuan; Yuan,9999,0,9999,0
1739704587140,PHYS 1A,A00,830264,Tsai; Philbert S,350,0,360,10
1739704588173,PHYS 1AL,001,830274,Yagil; Avi & Tsai; Philbert S,25,0,30,5
1739704588173,PHYS 1AL,002,830320,Yagil; Avi & Tsai; Philbert S,28,0,30,2
1739704588173,PHYS 1AL,003,830324,Yagil; Avi & Tsai; Philbert S,29,0,30,1
1739704588173,PHYS 1AL,004,830352,Yagil; Avi & Tsai; Philbert S,30,0,30,0
1739704588173,PHYS 1AL,005,830364,Yagil; Avi & Tsai; Philbert S,27,0,30,3
1739704588173,PHYS 1AL,006,830365,Yagil; Avi & Tsai; Philbert S,25,0,30,5
1739704588173,PHYS 1AL,007,830366,Yagil; Avi & Tsai; Philbert S,30,0,30,0
1739704588173,PHYS 1AL,008,830378,Yagil; Avi & Tsai; Philbert S,29,0,30,1
1739704588173,PHYS 1AL,009,830485,Yagil; Avi & Tsai; Philbert S,29,0,30,1
1739704588173,PHYS 1AL,010,830486,Yagil; Avi & Tsai; Philbert S,30,0,30,0
1739704588173,PHYS 1AL,011,830496,Yagil; Avi & Tsai; Philbert S,30,0,30,0
1739704589200,PHYS 1B,A00,830497,Groisman; Alexander,344,0,360,16
1739704590227,PHYS 1BL,001,830498,Yagil; Avi & Tsai; Philbert S,29,0,30,1
1739704590227,PHYS 1BL,002,830499,Yagil; Avi & Tsai; Philbert S,29,0,30,1
1739704590227,PHYS 1BL,003,830500,Yagil; Avi & Tsai; Philbert S,29,0,30,1
1739704590227,PHYS 1BL,004,830501,Yagil; Avi & Tsai; Philbert S,28,0,30,2
1739704590227,PHYS 1BL,005,830502,Yagil; Avi & Tsai; Philbert S,29,0,30,1
1739704590227,PHYS 1BL,006,830503,Yagil; Avi & Tsai; Philbert S,28,0,30,2
1739704590227,PHYS 1BL,007,830504,Yagil; Avi & Tsai; Philbert S,26,0,30,4
1739704590227,PHYS 1BL,008,830505,Yagil; Avi & Tsai; Philbert S,29,0,30,1
1739704590227,PHYS 1BL,009,830507,Yagil; Avi & Tsai; Philbert S,29,0,30,1
1739704590227,PHYS 1BL,010,830508,Yagil; Avi & Tsai; Philbert S,26,0,30,4
1739704590227,PHYS 1BL,011,830509,Yagil; Avi & Tsai; Philbert S,29,0,30,1
1739704590227,PHYS 1BL,012,830510,Yagil; Avi & Tsai; Philbert S,29,0,30,1
1739704591256,PHYS 1C,A00,830511,Popmintchev; Tenio,591,0,600,9
1739704591256,PHYS 1C,B00,830512,Popmintchev; Tenio,562,0,600,38
1739704592302,PHYS 1CL,001,830513,Yagil; Avi & Tsai; Philbert S,29,0,30,1
1739704592302,PHYS 1CL,002,830514,Yagil; Avi & Tsai; Philbert S,30,0,30,0
1739704592302,PHYS 1CL,003,830515,Yagil; Avi & Tsai; Philbert S,24,0,30,6
1739704592302,PHYS 1CL,004,830516,Yagil; Avi & Tsai; Philbert S,26,0,30,4
1739704592302,PHYS 1CL,005,830517,Yagil; Avi & Tsai; Philbert S,24,0,30,6
1739704592302,PHYS 1CL,006,830518,Yagil; Avi & Tsai; Philbert S,30,0,30,0
1739704592302,PHYS 1CL,007,830519,Yagil; Avi & Tsai; Philbert S,26,0,30,4
1739704592302,PHYS 1CL,008,830520,Yagil; Avi & Tsai; Philbert S,25,0,30,5
1739704592302,PHYS 1CL,009,830521,Yagil; Avi & Tsai; Philbert S,28,0,30,2
1739704592302,PHYS 1CL,010,830522,Yagil; Avi & Tsai; Philbert S,29,0,30,1
1739704592302,PHYS 1CL,011,872498,Yagil; Avi & Tsai; Philbert S,30,0,30,0
1739704592302,PHYS 1CL,012,872499,Yagil; Avi & Tsai; Philbert S,30,0,30,0
1739704592302,PHYS 1CL,013,830584,Yagil; Avi & Tsai; Philbert S,18,0,30,12
1739704592302,PHYS 1CL,014,830586,Yagil; Avi & Tsai; Philbert S,27,0,30,3
1739704592302,PHYS 1CL,015,830588,Yagil; Avi & Tsai; Philbert S,26,0,30,4
1739704592302,PHYS 1CL,016,830591,Yagil; Avi & Tsai; Philbert S,24,0,30,6
1739704592302,PHYS 1CL,017,830592,Yagil; Avi & Tsai; Philbert S,29,0,30,1
1739704592302,PHYS 1CL,018,830598,Yagil; Avi & Tsai; Philbert S,27,0,30,3
1739704592302,PHYS 1CL,019,830604,Yagil; Avi & Tsai; Philbert S,29,0,30,1
1739704592302,PHYS 1CL,020,830605,Yagil; Avi & Tsai; Philbert S,28,0,30,2
1739704592302,PHYS 1CL,021,830607,Yagil; Avi & Tsai; Philbert S,27,0,30,3
1739704592302,PHYS 1CL,022,830609,Yagil; Avi & Tsai; Philbert S,28,0,30,2
1739704592302,PHYS 1CL,023,872500,Yagil; Avi & Tsai; Philbert S,28,0,30,2
1739704592302,PHYS 1CL,024,872501,Yagil; Avi & Tsai; Philbert S,30,0,30,0
1739704592302,PHYS 1CL,025,830613,Yagil; Avi & Tsai; Philbert S,29,0,30,1
1739704592302,PHYS 1CL,026,830617,Yagil; Avi & Tsai; Philbert S,30,0,30,0
1739704592302,PHYS 1CL,027,830658,Yagil; Avi & Tsai; Philbert S,30,0,30,0
1739704592302,PHYS 1CL,028,830661,Yagil; Avi & Tsai; Philbert S,29,0,30,1
1739704592302,PHYS 1CL,029,830669,Yagil; Avi & Tsai; Philbert S,25,0,30,5
1739704592302,PHYS 1CL,030,830676,Yagil; Avi & Tsai; Philbert S,30,0,30,0
1739704592302,PHYS 1CL,031,830679,Yagil; Avi & Tsai; Philbert S,24,0,30,6
1739704592302,PHYS 1CL,032,830680,Yagil; Avi & Tsai; Philbert S,28,0,30,2
1739704592302,PHYS 1CL,033,872502,Yagil; Avi & Tsai; Philbert S,30,0,30,0
1739704592302,PHYS 1CL,034,872503,Yagil; Avi & Tsai; Philbert S,27,0,30,3
1739704593335,PHYS 2A,A01,830828,Shotwell; Brian,19,0,30,11
1739704593335,PHYS 2A,A02,830829,Shotwell; Brian,29,0,30,1
1739704593335,PHYS 2A,A03,830830,Shotwell; Brian,30,0,30,0
1739704593335,PHYS 2A,A04,830831,Shotwell; Brian,30,0,30,0
1739704593335,PHYS 2A,A05,830832,Shotwell; Brian,28,0,30,2
1739704593335,PHYS 2A,A06,830849,Shotwell; Brian,27,0,30,3
1739704593335,PHYS 2A,A07,830887,Shotwell; Brian,28,0,30,2
1739704593335,PHYS 2A,A08,830888,Shotwell; Brian,30,0,30,0
1739704593335,PHYS 2A,A09,830889,Shotwell; Brian,30,0,30,0
1739704593335,PHYS 2A,A10,830890,Shotwell; Brian,30,0,30,0
1739704593335,PHYS 2A,A11,830934,Shotwell; Brian,0,0,0,0
1739704593335,PHYS 2A,A12,830938,Shotwell; Brian,0,0,0,0
1739704594370,PHYS 2B,A01,830950,Meyertholen; Andrew D.,29,0,30,1
1739704594370,PHYS 2B,A02,830982,Meyertholen; Andrew D.,30,0,30,0
1739704594370,PHYS 2B,A03,830983,Meyertholen; Andrew D.,30,0,30,0
1739704594370,PHYS 2B,A04,830984,Meyertholen; Andrew D.,30,0,30,0
1739704594370,PHYS 2B,A05,830985,Meyertholen; Andrew D.,25,0,30,5
1739704594370,PHYS 2B,A06,830986,Meyertholen; Andrew D.,30,0,30,0
1739704594370,PHYS 2B,A07,830987,Meyertholen; Andrew D.,28,0,30,2
1739704594370,PHYS 2B,A08,830988,Meyertholen; Andrew D.,29,0,30,1
1739704594370,PHYS 2B,A09,830989,Meyertholen; Andrew D.,30,0,30,0
1739704594370,PHYS 2B,A10,831009,Meyertholen; Andrew D.,29,0,30,1
1739704594370,PHYS 2B,A11,831010,Meyertholen; Andrew D.,24,0,30,6
1739704594370,PHYS 2B,A12,831018,Meyertholen; Andrew D.,30,0,30,0
1739704594370,PHYS 2B,B01,831020,Meyertholen; Andrew D.,21,0,30,9
1739704594370,PHYS 2B,B02,831021,Meyertholen; Andrew D.,30,0,30,0
1739704594370,PHYS 2B,B03,831022,Meyertholen; Andrew D.,29,0,30,1
1739704594370,PHYS 2B,B04,831036,Meyertholen; Andrew D.,28,0,30,2
1739704594370,PHYS 2B,B05,831037,Meyertholen; Andrew D.,29,0,30,1
1739704594370,PHYS 2B,B06,831043,Meyertholen; Andrew D.,30,0,30,0
1739704594370,PHYS 2B,B07,831046,Meyertholen; Andrew D.,30,0,30,0
1739704594370,PHYS 2B,B08,831047,Meyertholen; Andrew D.,30,0,30,0
1739704594370,PHYS 2B,B09,831061,Meyertholen; Andrew D.,29,0,30,1
1739704594370,PHYS 2B,B10,831062,Meyertholen; Andrew D.,29,0,30,1
1739704594370,PHYS 2B,B11,831069,Meyertholen; Andrew D.,30,0,30,0
1739704594370,PHYS 2B,B12,831070,Meyertholen; Andrew D.,30,0,30,0
1739704595402,PHYS 2BL,A01,831108,Sharma; Vivek A.,24,0,24,0
1739704595402,PHYS 2BL,A02,831109,Sharma; Vivek A.,12,0,24,12
1739704595402,PHYS 2BL,A03,831112,Sharma; Vivek A.,22,0,24,2
1739704595402,PHYS 2BL,A04,831113,Sharma; Vivek A.,21,0,24,3
1739704595402,PHYS 2BL,A05,831127,Sharma; Vivek A.,24,0,24,0
1739704595402,PHYS 2BL,A06,831150,Sharma; Vivek A.,17,0,24,7
1739704595402,PHYS 2BL,A07,831327,Sharma; Vivek A.,21,0,24,3
1739704595402,PHYS 2BL,A08,831329,Sharma; Vivek A.,23,0,24,1
1739704595402,PHYS 2BL,A09,831338,Sharma; Vivek A.,24,0,24,0
1739704595402,PHYS 2BL,A10,831345,Sharma; Vivek A.,23,0,24,1
1739704595402,PHYS 2BL,A11,831355,Sharma; Vivek A.,21,0,24,3
1739704595402,PHYS 2BL,A12,831357,Sharma; Vivek A.,24,0,24,0
1739704595402,PHYS 2BL,A13,831428,Sharma; Vivek A.,24,0,24,0
1739704595402,PHYS 2BL,A14,831433,Sharma; Vivek A.,21,0,24,3
1739704595402,PHYS 2BL,A15,831434,Sharma; Vivek A.,21,0,24,3
1739704596434,PHYS 2C,A01,831436,Shotwell; Brian,29,0,30,1
1739704596434,PHYS 2C,A02,831440,Shotwell; Brian,30,0,30,0
1739704596434,PHYS 2C,A03,831441,Shotwell; Brian,27,0,30,3
1739704596434,PHYS 2C,A04,831444,Shotwell; Brian,29,0,30,1
1739704596434,PHYS 2C,A05,831445,Shotwell; Brian,27,0,30,3
1739704596434,PHYS 2C,A06,831446,Shotwell; Brian,30,0,30,0
1739704596434,PHYS 2C,A07,831453,Shotwell; Brian,28,0,30,2
1739704596434,PHYS 2C,A08,831454,Shotwell; Brian,29,0,30,1
1739704596434,PHYS 2C,A09,831469,Shotwell; Brian,25,0,30,5
1739704596434,PHYS 2C,A10,831470,Shotwell; Brian,27,0,30,3
1739704596434,PHYS 2C,A11,831471,Shotwell; Brian,30,0,30,0
1739704596434,PHYS 2C,A12,831481,Shotwell; Brian,27,0,30,3
1739704597459,PHYS 2CL,A01,831597,Ni; Kaixuan,25,0,28,3
1739704597459,PHYS 2CL,A02,831598,Ni; Kaixuan,23,0,28,5
1739704597459,PHYS 2CL,A03,831599,Ni; Kaixuan,27,0,28,1
1739704597459,PHYS 2CL,A04,831601,Ni; Kaixuan,26,0,28,2
1739704597459,PHYS 2CL,A05,831602,Ni; Kaixuan,26,0,28,2
1739704597459,PHYS 2CL,A06,831603,Ni; Kaixuan,26,0,28,2
1739704598486,PHYS 2D,A01,831605,Branson; James G,26,0,30,4
1739704598486,PHYS 2D,A02,831606,Branson; James G,30,0,30,0
1739704598486,PHYS 2D,A03,831607,Branson; James G,30,0,30,0
1739704599513,PHYS 4B,A01,831609,Grinstein; Benjamin,30,0,30,0
1739704599513,PHYS 4B,A02,831610,Grinstein; Benjamin,29,0,30,1
1739704599513,PHYS 4B,A03,831611,Grinstein; Benjamin,29,0,30,1
1739704599513,PHYS 4B,A04,831612,Grinstein; Benjamin,28,0,30,2
1739704600540,PHYS 4E,A01,831622,Intriligator; Kenneth Arthur,39,0,40,1
1739704600540,PHYS 4E,A02,831630,Intriligator; Kenneth Arthur,40,0,40,0
1739704600540,PHYS 4E,A03,831631,Intriligator; Kenneth Arthur,39,0,40,1
1739704601568,PHYS 87,A00,869095,Grinstein; Benjamin,20,0,20,0
1739704602595,PHYS 100C,A01,831698,Barreiro Guerrero; Julio,57,0,60,3
1739704603625,PHYS 105B,A01,831700,Green; Daniel Richard,24,0,24,0
1739704604652,PHYS 120,A01,831702,Yang; Liang,31,0,32,1
1739704604652,PHYS 120,A02,831916,Yang; Liang,30,0,32,2
1739704605678,PHYS 130A,A01,831918,You; Yizhuang,90,0,90,0
1739704606707,PHYS 130B,A01,831921,You; Yizhuang,49,0,50,1
1739704607733,PHYS 137,A01,831924,Intriligator; Kenneth Arthur,33,0,36,3
1739704608758,PHYS 140A,A01,831928,Frano Pereira; Alex M,45,0,50,5
1739704609787,PHYS 141,A00,831929,Zhao; Hongbo,57,0,60,3
1739704610812,PHYS 152B,A01,831932,Hirsch; Jorge Eduardo,17,0,20,3
1739704611838,PHYS 154,A01,872509,Grinstein; Benjamin,21,0,23,2
1739704612864,PHYS 162,A01,831935,Keating; Brian,43,0,46,3
1739704613892,PHYS 170,A01,831938,Oh; Seungeun,23,0,25,2
1739704614919,PHYS 177,A00,831940,Dudko; Olga,18,0,20,2
1739704615944,PHYS 202,A00,831941,Vergassola; Massimo & Diamond; Patrick H,19,0,20,1
1739704616975,PHYS 203B,A01,831943,Fogler; Michael M.,17,0,20,3
1739704618001,PHYS 210A,A01,831946,Arovas; Daniel P,19,0,20,1
1739704619025,PHYS 212C,A01,831948,Grover; Tarun,18,0,20,2
1739704620049,PHYS 215C,A00,831949,McGreevy; John A.,10,0,10,0
1739704621083,PHYS 221A,A00,831953,Tan; Tzer Han,20,0,20,0
1739704622108,PHYS 222A,A00,831954,Ni; Kaixuan,10,0,10,0
1739704623133,PHYS 227,A00,831958,Fuller; George Michael,22,0,25,3
1739704624157,PHYS 228,A00,831961,Flauger; Raphael M,24,0,25,1
1739704625186,PHYS 232,A00,831962,Hirsch; Jorge Eduardo,5,0,5,0
1739704626211,PHYS 239,A00,831963,Goldenfeld; Nigel,7,0,10,3
1739704626211,PHYS 239,B00,831964,Serra; Mattia,8,0,10,2
1739704627237,PHYS 241,A00,831965,Zhao; Hongbo,4,0,5,1
1739704628262,PHYS 250,A00,831969,Di Ventra; Massimiliano,50,0,50,0
1739704629286,PHYS 251,A00,831970,Grinstein; Benjamin,20,0,20,0
1739704630314,PHYS 252,A00,831971,Diamond; Patrick H,10,0,10,0
1739704631340,PHYS 253,A00,831972,Fuller; George Michael,30,0,30,0
1739704632375,PHYS 254,A00,831973,Serra; Mattia,29,0,30,1
1739704633399,PHYS 255,A00,831974,Hwa; Terence T.,30,0,30,0
1739704634427,PHYS 260,A00,831975,Fuller; George Michael,50,0,50,0
1739704635452,PHYS 277,A00,831976,Dudko; Olga,14,0,20,6
1739704636479,POLI 5D,A01,832046,Arnold; David Hall,7,0,8,1
1739704636479,POLI 5D,A02,832047,Arnold; David Hall,8,0,8,0
1739704636479,POLI 5D,A03,832049,Arnold; David Hall,8,0,8,0
1739704636479,POLI 5D,A04,832050,Arnold; David Hall,7,0,8,1
1739704636479,POLI 5D,A05,832051,Arnold; David Hall,8,0,8,0
1739704636479,POLI 5D,B01,832055,Dai; Yinlin,5,0,5,0
1739704636479,POLI 5D,B02,832056,Dai; Yinlin,4,0,5,1
1739704637507,POLI 10D,A01,832058,Noble; Benjamin S,33,0,34,1
1739704637507,POLI 10D,A02,832059,Noble; Benjamin S,33,0,34,1
1739704637507,POLI 10D,A03,832060,Noble; Benjamin S,34,0,34,0
1739704637507,POLI 10D,A04,832061,Noble; Benjamin S,33,0,34,1
1739704637507,POLI 10D,A05,832062,Noble; Benjamin S,33,0,34,1
1739704637507,POLI 10D,A06,832064,Noble; Benjamin S,34,0,34,0
1739704638533,POLI 12D,A01,832067,Thai; Eric,30,0,34,4
1739704638533,POLI 12D,A02,832068,Thai; Eric,32,0,34,2
1739704638533,POLI 12D,A03,832069,Thai; Eric,34,0,34,0
1739704638533,POLI 12D,A04,832070,Thai; Eric,34,0,34,0
1739704638533,POLI 12D,A05,832072,Thai; Eric,33,0,34,1
1739704638533,POLI 12D,A06,832074,Thai; Eric,34,0,34,0
1739704639559,POLI 27,A01,832079,Elgin; Samuel Zincke,27,0,34,7
1739704639559,POLI 27,A02,832081,Elgin; Samuel Zincke,31,0,34,3
1739704639559,POLI 27,A03,832082,Elgin; Samuel Zincke,34,0,34,0
1739704639559,POLI 27,A04,832083,Elgin; Samuel Zincke,32,0,34,2
1739704640589,POLI 28,A01,832085,Elgin; Samuel Zincke,29,0,34,5
1739704640589,POLI 28,A02,832087,Elgin; Samuel Zincke,30,0,34,4
1739704640589,POLI 28,A03,832092,Elgin; Samuel Zincke,32,0,34,2
1739704640589,POLI 28,A04,832093,Elgin; Samuel Zincke,33,0,34,1
1739704641617,POLI 30D,A01,832096,Anderson; Anthony Michael,19,0,28,9
1739704641617,POLI 30D,A02,832098,Anderson; Anthony Michael,23,0,28,5
1739704641617,POLI 30D,A03,832100,Anderson; Anthony Michael,27,0,28,1
1739704641617,POLI 30D,A04,832102,Anderson; Anthony Michael,27,0,28,1
1739704641617,POLI 30D,A05,832103,Anderson; Anthony Michael,20,0,28,8
1739704641617,POLI 30D,A06,832252,Anderson; Anthony Michael,28,0,28,0
1739704642643,POLI 87,A00,881663,Mignozzetti; Umberto,20,0,20,0
1739704643667,POLI 100O,A00,832254,Boehmer; Alison Paige,106,0,115,9
1739704644693,POLI 104Q,A00,832257,Nichter; Maysa,100,0,120,20
1739704645721,POLI 104U,A00,869584,Nichter; Maysa,55,0,75,20
1739704646749,POLI 104V,A00,832258,Staff,43,0,50,7
1739704647774,POLI 110C,A00,832259,Soon; Valerie,49,0,50,1
1739704648800,POLI 119A,A00,832260,Staff,45,0,50,5
1739704649829,POLI 120D,A00,832261,Hansen; Jan Eric,45,0,50,5
1739704650859,POLI 121D,A00,832262,Roberts; Margaret Earling,113,0,115,2
1739704651885,POLI 126AB,A00,832263,Fisk; David Lee,154,0,156,2
1739704652911,POLI 131CR,A00,832264,Hoston; Germaine,131,0,135,4
1739704652911,POLI 131CR,B00,877489,Hoston; Germaine,30,0,30,0
1739704653940,POLI 140D,A00,832265,Wong; Tak Kei,191,0,200,9
1739704654967,POLI 145C,A00,832267,Fisk; David Lee,191,0,196,5
1739704655993,POLI 149,A00,832268,Joseph; Michael F,192,0,196,4
1739704657017,POLI 150A,A00,832269,Wong; Tak Kei,235,0,245,10
1739704658098,POLI 170,A00,872371,Staff,110,0,115,5
1739704659124,POLI 176,A00,832337,Roberts; Margaret Earling,73,0,80,7
1739704660149,POLI 194,A00,832339,Staff,9999,0,9999,0
1739704661173,POLI 194SD,A00,832431,Nichter; Maysa,25,0,25,0
1739704662199,POLI 197SD,001,832432,Nichter; Maysa,25,0,25,0
1739704663224,POLI 198RA,001,832499,Broz; James Lawrence,25,0,25,0
1739704664250,POLI 203B,A00,832500,Slantchev; Branislav,23,0,25,2
1739704665276,POLI 218R,A00,832535,Hoston; Germaine,24,0,25,1
1739704666303,POLI 219,A00,832536,Soon; Valerie,10,0,10,0
1739704667328,POLI 220A,A00,832537,Ferree; Karen E,21,0,25,4
1739704668353,POLI 243,A00,832538,Joseph; Michael F,24,0,25,1
1739704669379,POLI 250,A00,832539,Stout; Christopher Timothy,22,0,25,3
1739704671430,POLI 273,A00,832541,Mignozzetti; Umberto,8,0,25,17
1739704672455,POLI 281,A00,832542,Ban; Pamela M,11,0,12,1
1739704673479,POLI 282,A00,832543,Ferree; Karen E,24,0,25,1
1739704674503,POLI 283,A00,832544,Slantchev; Branislav,23,0,25,2
1739704675533,POLI 285,A00,832545,Ingham; Sean,12,0,12,0
1739704676560,POLI 286,A00,832546,Mignozzetti; Umberto,25,0,25,0
1739704677588,PSY 296,001,867611,Eyler; Lisa T.,4,0,5,1
1739704677588,PSY 296,002,867612,Fettes; Danielle Lynn,4,0,5,1
1739704677588,PSY 296,003,867613,Staff,5,0,5,0
1739704678616,PSYC 1,A00,841780,Hurwitz; Ethan Scott,292,0,300,8
1739704679640,PSYC 3R,A00,841782,Pilegard; Celeste Cristine,297,0,310,13
1739704680671,PSYC 60,A01,862444,Lowe; Angela Beth,34,0,35,1
1739704680671,PSYC 60,A02,862476,Lowe; Angela Beth,33,0,35,2
1739704680671,PSYC 60,A03,862477,Lowe; Angela Beth,34,0,35,1
1739704680671,PSYC 60,A04,862499,Lowe; Angela Beth,32,0,35,3
1739704680671,PSYC 60,A05,862516,Lowe; Angela Beth,35,0,35,0
1739704680671,PSYC 60,A06,862578,Lowe; Angela Beth,34,0,35,1
1739704680671,PSYC 60,A07,862603,Lowe; Angela Beth,34,0,35,1
1739704680671,PSYC 60,B01,862605,Rose; Fred E.,32,0,35,3
1739704680671,PSYC 60,B02,862622,Rose; Fred E.,34,0,35,1
1739704680671,PSYC 60,B03,862658,Rose; Fred E.,33,0,35,2
1739704680671,PSYC 60,B04,862659,Rose; Fred E.,32,0,35,3
1739704680671,PSYC 60,B05,862669,Rose; Fred E.,35,0,35,0
1739704680671,PSYC 60,B06,862680,Rose; Fred E.,33,0,35,2
1739704680671,PSYC 60,B07,862682,Rose; Fred E.,34,0,35,1
1739704681700,PSYC 70,A01,862683,Pilegard; Celeste Cristine,29,0,35,6
1739704681700,PSYC 70,A02,862684,Pilegard; Celeste Cristine,33,0,35,2
1739704681700,PSYC 70,A03,862688,Pilegard; Celeste Cristine,35,0,35,0
1739704681700,PSYC 70,A04,862697,Pilegard; Celeste Cristine,35,0,35,0
1739704681700,PSYC 70,A05,862698,Pilegard; Celeste Cristine,35,0,35,0
1739704681700,PSYC 70,A06,862738,Pilegard; Celeste Cristine,35,0,35,0
1739704682728,PSYC 71,A01,841792,Geller; Emma Harlan,21,0,25,4
1739704682728,PSYC 71,A02,841793,Geller; Emma Harlan,25,0,26,1
1739704682728,PSYC 71,B01,841795,Steiner; Eric Tomas,16,0,21,5
1739704682728,PSYC 71,B02,841797,Steiner; Eric Tomas,20,0,21,1
1739704683753,PSYC 88,A00,841802,Dobkins; Karen R.,52,0,65,13
1739704684781,PSYC 100,A00,841803,Chapman; Eddie Nathaniel,299,0,348,49
1739704685808,PSYC 101,A00,841804,Schachner; Adena,264,0,295,31
1739704686834,PSYC 102,A00,841807,Moranton; Nirelia Melbina-,294,0,295,1
1739704687859,PSYC 104,A00,841810,McCullough; Michael E,193,0,265,72
1739704688885,PSYC 105,A00,841812,Lau; Aubrey,294,0,295,1
1739704689915,PSYC 108,A00,841813,Adrian; Julia Anna,291,0,295,4
1739704690939,PSYC 111B,A01,841865,Geller; Emma Harlan,35,0,35,0
1739704691963,PSYC 116C,A01,841922,Lang; Ariel,25,0,25,0
1739704692992,PSYC 117,A01,872925,Bajic; Daniel Andrew,25,0,25,0
1739704694019,PSYC 118,A01,841931,Miller; Cory T.,39,0,45,6
1739704695044,PSYC 124,A00,841932,Chapman; Eddie Nathaniel,336,0,348,12
1739704696069,PSYC 125,A00,841933,Rose; Fred E.,140,0,146,6
1739704697093,PSYC 127,A00,841934,Dickenson; Janna Alene,17,0,20,3
1739704698117,PSYC 131,A00,841936,Anagnostaras; Stephan,47,0,65,18
1739704699141,PSYC 132,A00,841937,Steiner; Eric Tomas,90,0,120,30
1739704700166,PSYC 137,A00,841939,Winkielman; Piotr,212,0,216,4
1739704701194,PSYC 144,A00,841941,Wixted; John T,293,0,295,2
1739704702222,PSYC 164,A00,841943,Kaplan; Paul,276,0,295,19
1739704703250,PSYC 169,A00,841944,Tallman; Catherine Walsh,271,0,295,24
1739704704274,PSYC 178,A00,841945,Glaser; Dale,132,0,146,14
1739704705300,PSYC 179,A00,841980,Lacefield; Katharine I,290,0,350,60
1739704706328,PSYC 188,A00,842062,Lacefield; Katharine I,233,0,300,67
1739704707353,PSYC 190,A00,842063,Barner; David A.,274,0,300,26
1739704708384,PSYC 193,A00,842067,Brashier; Nadia Marie,214,0,216,2
1739704708384,PSYC 193,B00,842068,Gremel; Christina M,33,0,35,2
1739704708384,PSYC 193,C00,842095,Harris; Christine Renee,20,0,20,0
1739704708384,PSYC 193,D00,842096,Lin; Chujun,59,0,60,1
1739704708384,PSYC 193,E00,842154,Long; Bria,24,0,25,1
1739704708384,PSYC 193,F00,872477,Mukku; Dhananjaya,35,0,35,0
1739704709411,PSYC 193L,A01,842159,Aron; Adam,18,0,21,3
1739704709411,PSYC 193L,B01,842163,Barner; David A.,22,0,24,2
1739704709411,PSYC 193L,C01,842167,Brown; Sandra A,65,0,65,0
1739704710438,PSYC 194C,A01,842196,Heyman; Gail D.,1,0,1,0
1739704711465,PSYC 210,A00,842202,Powell; Lindsey Jane,17,0,20,3
1739704712499,PSYC 222,A00,842339,Gorman; Michael R.,20,0,20,0
1739704713527,PSYC 224,A00,842402,Miller; Cory T.,29,0,30,1
1739704714552,PSYC 242,A00,842579,Walker; Caren Michelle,28,0,30,2
1739704715577,PSYC 270C,A00,842580,Dobkins; Karen R.,19,0,20,1
1739704716602,PSYC 271,A00,842581,Anagnostaras; Stephan,19,0,20,1
1739704717630,PSYC 272,A00,842582,Gentner; Tim,18,0,20,2
1739704717630,PSYC 272,B00,872469,Mukku; Dhananjaya,20,0,20,0
1739704718658,PSYC 274,A00,842583,McCullough; Michael E,30,0,30,0
1739704719684,PSYC 275,A00,842600,Brady; Timothy Francis,29,0,30,1
1739704720710,PSYC 276,A00,842601,McCullough; Michael E,15,0,20,5
1739704721741,PSYC 280,A00,842760,Serences; John Thomas,76,0,80,4
1739704722779,PSYC 296,001,851620,Anagnostaras; Stephan,9999,0,9999,0
1739704722779,PSYC 296,002,851621,Aron; Adam,9999,0,9999,0
1739704722779,PSYC 296,003,851622,Mukku; Dhananjaya,9999,0,9999,0
1739704722779,PSYC 296,004,851623,Barner; David A.,9998,0,9999,1
1739704722779,PSYC 296,005,851624,Schachner; Adena,9999,0,9999,0
1739704722779,PSYC 296,006,851625,Brady; Timothy Francis,9999,0,9999,0
1739704722779,PSYC 296,007,851627,Brashier; Nadia Marie,9999,0,9999,0
1739704722779,PSYC 296,008,851628,Brown; Sandra A,9999,0,9999,0
1739704722779,PSYC 296,009,851629,Carver; Leslie J.,9999,0,9999,0
1739704722779,PSYC 296,010,851630,Chapman; Eddie Nathaniel,9999,0,9999,0
1739704722779,PSYC 296,011,851631,Dickenson; Janna Alene,9999,0,9999,0
1739704722779,PSYC 296,012,851632,Dobkins; Karen R.,9999,0,9999,0
1739704722779,PSYC 296,014,851635,Ferreira; Victor,9999,0,9999,0
1739704722779,PSYC 296,015,851636,Geller; Emma Harlan,9999,0,9999,0
1739704722779,PSYC 296,016,851637,Gentner; Tim,9998,0,9999,1
1739704722779,PSYC 296,017,851642,Gorman; Michael R.,9999,0,9999,0
1739704722779,PSYC 296,018,851644,Gremel; Christina M,9999,0,9999,0
1739704722779,PSYC 296,019,851645,Harris; Christine Renee,9999,0,9999,0
1739704722779,PSYC 296,020,851646,Heyman; Gail D.,9999,0,9999,0
1739704722779,PSYC 296,021,851647,Lin; Chujun,9999,0,9999,0
1739704722779,PSYC 296,022,851648,Long; Bria,9999,0,9999,0
1739704722779,PSYC 296,023,851650,McCullough; Michael E,9999,0,9999,0
1739704722779,PSYC 296,024,851655,Mc Kenzie; Craig R.M.,9999,0,9999,0
1739704722779,PSYC 296,025,851656,Miller; Cory T.,9999,0,9999,0
1739704722779,PSYC 296,026,851657,Oesch; Nicholas W,9999,0,9999,0
1739704722779,PSYC 296,028,851662,Pilegard; Celeste Cristine,9999,0,9999,0
1739704722779,PSYC 296,029,851664,Powell; Lindsey Jane,9999,0,9999,0
1739704722779,PSYC 296,030,851665,Rickard; Timothy C.,9999,0,9999,0
1739704722779,PSYC 296,031,851672,Serences; John Thomas,9999,0,9999,0
1739704722779,PSYC 296,032,851774,Walker; Caren Michelle,9999,0,9999,0
1739704722779,PSYC 296,033,851778,Winkielman; Piotr,9999,0,9999,0
1739704722779,PSYC 296,034,851808,Wixted; John T,9999,0,9999,0
1739704723807,RAD 296,001,867654,Staff,5,0,5,0
1739704723807,RAD 296,002,867659,Staff,5,0,5,0
1739704723807,RAD 296,003,867666,Staff,5,0,5,0
1739704724832,RELI 150,A00,832548,Rahimi; Babak,37,0,40,3
1739704725860,RELI 189,A00,832549,Rahimi; Babak,40,0,40,0
1739704726886,REV 12,A00,869164,Yu; Paul K L,40,0,40,0
1739704727913,REV 20,A00,869165,Yu; Paul K L,40,0,40,0
1739704728939,REV 87,A00,869166,Rodriguez; Bretton Sigfred,19,0,20,1
1739704729967,RMAS 296,001,867895,Murphy; James D,5,0,5,0
1739704729967,RMAS 296,002,867896,Staff,5,0,5,0
1739704729967,RMAS 296,003,867897,Staff,5,0,5,0
1739704730995,RMED 296,001,867854,Duleba; Antoni,4,0,5,1
1739704730995,RMED 296,002,867860,Staff,5,0,5,0
1739704730995,RMED 296,003,867882,Staff,5,0,5,0
1739704732021,SE 3,A01,838151,Van Den Einde; Yael Dahlia,42,0,52,10
1739704732021,SE 3,A02,838152,Van Den Einde; Yael Dahlia,50,0,52,2
1739704732021,SE 3,A03,838153,Van Den Einde; Yael Dahlia,50,0,53,3
1739704732021,SE 3,A04,838154,Van Den Einde; Yael Dahlia,51,0,53,2
1739704732021,SE 3,A05,838155,Van Den Einde; Yael Dahlia,49,0,50,1
1739704733047,SE 101B,A01,838160,Van Den Einde; Yael Dahlia,53,0,56,3
1739704734075,SE 105,A01,838162,Qiao; Yu,85,0,88,3
1739704735100,SE 110A,A01,838164,Staff,53,0,56,3
1739704736126,SE 110B,A00,838166,Zhu; Qiang,123,0,125,2
1739704737155,SE 130B,A01,838174,Krysl; Petr,93,0,100,7
1739704738183,SE 131A,A01,838499,Krysl; Petr,103,0,110,7
1739704739211,SE 140B,A01,838504,Palermo; Alessandro,22,0,24,2
1739704739211,SE 140B,A02,838505,Palermo; Alessandro,21,0,24,3
1739704739211,SE 140B,A03,838507,Palermo; Alessandro,23,0,24,1
1739704739211,SE 140B,A04,871139,Palermo; Alessandro,13,0,24,11
1739704739211,SE 140B,A05,871140,Palermo; Alessandro,0,0,24,24
1739704739211,SE 140B,A06,871141,Palermo; Alessandro,23,0,24,1
1739704740240,SE 143B,A01,838512,Kosmatka; John B,4,0,15,11
1739704740240,SE 143B,A02,838513,Kosmatka; John B,9,0,15,6
1739704741269,SE 150A,A01,838526,Uang; Chia-Ming,94,0,100,6
1739704742311,SE 150B,A01,838538,Morrison; Machel Leigh,36,0,50,14
1739704743338,SE 151B,A00,838540,Tsampras; Georgios,62,0,75,13
1739704744366,SE 160B,A01,838543,Kim; Hyunsun Alicia,96,0,100,4
1739704745391,SE 165,A00,838544,Todd; Michael,0,0,10,10
1739704746417,SE 183,A00,872450,Tomac; Ingrid,0,0,0,3
1739704747441,SE 202,A00,838832,Kosmatka; John B,28,0,30,2
1739704748465,SE 203B,A00,838855,Tsampras; Georgios,49,0,65,16
1739704749490,SE 213,A00,838859,Palermo; Alessandro,21,0,30,9
1739704750514,SE 214,A00,870032,Shing; P. Benson,19,0,40,21
1739704751539,SE 215,A00,838876,Zhu; Qiang,34,0,45,11
1739704752570,SE 224,A00,838921,Conte; Joel P,36,0,50,14
1739704753595,SE 246,A00,838926,McCartney; John Scott,25,0,30,5
1739704754621,SE 249,A01,839605,Tomac; Ingrid,15,0,20,5
1739704755648,SE 251B,A00,838934,Qiao; Yu,17,0,25,8
1739704756682,SE 253B,A00,838942,Kim; Hyonny,30,0,30,0
1739704757709,SE 260B,A00,838947,Kim; Hyunsun Alicia,10,0,10,0
1739704758735,SE 265,A00,838954,Todd; Michael,10,0,20,10
1739704759760,SE 279,A00,838959,Chen; Jiun-Shyan,24,0,30,6
1739704760787,SE 290,A00,838962,Loh; Kenneth J. H.,74,0,100,26
1739704761905,SE 296,001,838963,Asaro; Robert J,9999,0,9999,0
1739704761905,SE 296,002,838980,Chen; Jiun-Shyan,9999,0,9999,0
1739704761905,SE 296,003,838992,Conte; Joel P,9999,0,9999,0
1739704761905,SE 296,004,839039,Elgamal; Ahmed,9999,0,9999,0
1739704761905,SE 296,005,839040,Hutchinson; Tara,9999,0,9999,0
1739704761905,SE 296,006,839041,Jandaghi Semnani; Shabnam,9999,0,9999,0
1739704761905,SE 296,007,839042,Kim; Hyonny,9999,0,9999,0
1739704761905,SE 296,008,839055,Kim; Hyunsun Alicia,9999,0,9999,0
1739704761905,SE 296,009,839059,Kosmatka; John B,9999,0,9999,0
1739704761905,SE 296,010,839087,Krysl; Petr,9999,0,9999,0
1739704761905,SE 296,011,839094,Kuester; Falko,9999,0,9999,0
1739704761905,SE 296,012,839115,Lanza Di Scalea; Francesco,9999,0,9999,0
1739704761905,SE 296,013,839173,Loh; Kenneth J. H.,9999,0,9999,0
1739704761905,SE 296,014,839174,McCartney; John Scott,9999,0,9999,0
1739704761905,SE 296,015,839198,Morrison; Machel Leigh,9999,0,9999,0
1739704761905,SE 296,016,839229,Mosqueda; Gilberto,9999,0,9999,0
1739704761905,SE 296,017,839230,Qiao; Yu,9999,0,9999,0
1739704761905,SE 296,018,839234,Restrepo; Jose,9999,0,9999,0
1739704761905,SE 296,019,839243,Shing; P. Benson,9999,0,9999,0
1739704761905,SE 296,020,839323,Todd; Michael,9999,0,9999,0
1739704761905,SE 296,021,839326,Tomac; Ingrid,9999,0,9999,0
1739704761905,SE 296,022,839327,Tsampras; Georgios,9999,0,9999,0
1739704761905,SE 296,023,839329,Uang; Chia-Ming,9999,0,9999,0
1739704761905,SE 296,024,839340,Van Den Einde; Yael Dahlia,9999,0,9999,0
1739704761905,SE 296,025,839342,Zhu; Qiang,9999,0,9999,0
1739704761905,SE 296,026,839351,Tehrani; Mehran,9999,0,9999,0
1739704761905,SE 296,027,839356,Palermo; Alessandro,9999,0,9999,0
1739704762945,SEV 20,A00,838033,Antonovics; Kate L.,30,0,30,0
1739704763972,SIO 10,A00,839607,Borsa; Adrian Antal,591,0,600,9
1739704765000,SIO 16,A00,839615,Stegman; David,146,0,150,4
1739704766026,SIO 35,A00,839616,Driscoll; Neal W.,189,0,210,21
1739704767055,SIO 50,A01,839691,Cook; Geoffrey W,20,0,22,2
1739704767055,SIO 50,A02,839692,Cook; Geoffrey W,20,0,22,2
1739704768080,SIO 60,A01,839695,Ricke; Katharine L & Lucas; Andrew J.,29,0,34,5
1739704769107,SIO 75,A00,839696,Norris; Richard D.,28,0,30,2
1739704770132,SIO 87,A00,839697,Cook; Geoffrey W,20,0,20,0
1739704770132,SIO 87,B00,839698,Cook; Geoffrey W,20,0,20,0
1739704770132,SIO 87,C00,872480,Feddersen; Falk & Morzfeld; Matthias,15,0,15,0
1739704770132,SIO 87,D00,876215,Jensen; Paul R.,19,0,20,1
1739704771160,SIO 90,A00,839699,Shipp; Lauren Elizabeth,60,0,65,5
1739704772187,SIO 111,A01,839895,Feddersen; Falk,27,0,30,3
1739704773214,SIO 112,A01,839701,Morzfeld; Matthias,38,0,40,2
1739704774240,SIO 113,A01,839703,May; David Alexander,33,0,40,7
1739704775269,SIO 115,A01,872479,Fricker; Helen A.,61,0,65,4
1739704776298,SIO 121,A00,839704,Bowman; Jeff Shovlowsky,25,0,30,5
1739704777326,SIO 135,A01,839706,Fricker; Helen A. & Sandwell; David T,20,0,20,0
1739704777326,SIO 135,A02,872452,Fricker; Helen A. & Sandwell; David T,20,0,20,0
1739704778353,SIO 136,A01,839708,Kacev; David & Shipp; Lauren Elizabeth,29,0,34,5
1739704778353,SIO 136,A02,839709,Kacev; David & Shipp; Lauren Elizabeth,32,0,34,2
1739704779381,SIO 139,A00,839713,Kacev; David,89,0,95,6
1739704780409,SIO 141,A01,839715,Pomeroy; Robert S.,14,0,14,0
1739704781432,SIO 143,A01,839717,Andersson; Andreas Jerry,30,0,35,5
1739704782457,SIO 145,A01,872421,Choy; Carolyn Anela,9,0,18,9
1739704783482,SIO 152,A01,839719,Van Allen; Emily Joyce,17,0,20,3
1739704784510,SIO 153,A01,839722,Capaldi; Tomas,29,0,30,1
1739704785534,SIO 160,A00,839723,Fialko; Yuri A.,26,0,30,4
1739704786561,SIO 173,A00,839724,Xie; Shang-Ping,26,0,30,4
1739704787587,SIO 174,A00,839725,Aluwihare; Lihini & Russell; Lynn M.,26,0,30,4
1739704788627,SIO 176,A00,839726,Merrifield; Sophia T,27,0,30,3
1739704789656,SIO 181,A01,839728,Tresguerres; Martin,20,0,25,5
1739704789656,SIO 181,A02,839729,Tresguerres; Martin,23,0,25,2
1739704789656,SIO 181,A03,839730,Tresguerres; Martin,25,0,25,0
1739704789656,SIO 181,A04,839731,Tresguerres; Martin,23,0,25,2
1739704789656,SIO 181,A05,839732,Tresguerres; Martin,25,0,25,0
1739704789656,SIO 181,A06,839733,Tresguerres; Martin,24,0,25,1
1739704790688,SIO 184,A01,839735,Rouse; Gregory W.,17,0,24,7
1739704790688,SIO 184,A02,839736,Rouse; Gregory W.,20,0,24,4
1739704791714,SIO 190,A01,839738,Lin; Ying-Tsong,18,0,20,2
1739704791714,SIO 190,B01,839740,Kacev; David,26,0,30,4
1739704791714,SIO 190,D01,839742,Gaasterland; Theresa,20,0,20,0
1739704792747,SIO 190L,A00,886144,Staff,28,0,30,2
1739704792747,SIO 190L,A01,886145,Staff,30,0,30,0
1739704793772,SIO 194,A00,851602,Staff,0,0,0,0
1739704794798,SIOB 242C,A01,839746,Gaasterland; Theresa,25,0,25,0
1739704795826,SIOB 243,A00,839748,Gerwick; William Henry,17,0,20,3
1739704796851,SIOB 262,A00,839749,Gerwick; William Henry,25,0,25,0
1739704797875,SIOB 270A,A01,839751,Petrik; Colleen Mary,11,0,15,4
1739704798903,SIOB 278,A00,839752,Jensen; Paul R.,13,0,15,2
1739704798903,SIOB 278,B00,872373,Hechinger; Ryan F.,11,0,15,4
1739704798903,SIOB 278,C00,874430,Allen; Andrew Ellis,13,0,15,2
1739704799928,SIOB 279,A00,871153,Barton; Andrew David,43,0,50,7
1739704800957,SIOB 282,A00,839753,Palenik; Brian,18,0,20,2
1739704801984,SIOB 284,A01,839755,Rouse; Gregory W.,1,0,3,2
1739704801984,SIOB 284,A02,839756,Rouse; Gregory W.,2,0,3,1
1739704803012,SIOB 286,A01,839758,Aburto Oropeza; Marco Octavio,20,0,25,5
1739704804037,SIOB 291,A00,839759,Staff,0,0,0,0
1739704805062,SIOB 297,A00,839760,Allen; Eric,19,0,25,6
1739704806095,SIOC 202B,A00,839761,Stramski; Dariusz & Gabriel; Anne Alice-Agnes,16,0,20,4
1739704807123,SIOC 203C,A01,839763,Young; William Roy,18,0,20,2
1739704808151,SIOC 207C,A00,872521,Vasconcelos; Manuela,5,0,5,0
1739704809177,SIOC 208,A00,839764,Lucas; Andrew J.,45,0,50,5
1739704810205,SIOC 209,A00,872379,Werner; Bradley T.,10,0,10,0
1739704810205,SIOC 209,B00,874420,Watson-Parris; Duncan & Hao; Xuanting,17,0,20,3
1739704811230,SIOC 211B,A00,839779,Feddersen; Falk,5,0,8,3
1739704812257,SIOC 212B,A01,839861,Cessi; Paola,11,0,15,4
1739704813282,SIOC 217C,A00,839862,Lutsko; Nicholas J.,23,0,25,2
1739704814306,SIOC 218A,A00,839863,Send; Uwe,3,0,10,7
1739704815332,SIOC 228,A00,839865,Shi; Yuanyuan,1,0,10,9
1739704816356,SIOC 235,A00,839866,Xie; Shang-Ping,7,0,10,3
1739704817381,SIOC 250,A00,839871,Norris; Joel Roland,20,0,20,0
1739704818405,SIOC 296,A00,871155,Gabriel; Corey John,9,0,20,11
1739704819432,SIOG 200B,A00,839873,Gabriel; Anne Alice-Agnes,19,0,20,1
1739704820456,SIOG 224,A00,839876,Laske; Gabi & Stegman; David,20,0,20,0
1739704821480,SIOG 227C,A00,839879,Fan; Wenyuan & Gabriel; Anne Alice-Agnes,20,0,20,0
1739704822505,SIOG 228,A00,839880,Van Allen; Emily Joyce,13,0,20,7
1739704823531,SIOG 230,A00,839882,Constable; Catherine G,25,0,25,0
1739704824559,SIOG 232,A00,839885,Constable; Steven C & Constable; Catherine G,49,0,50,1
1739704825584,SIOG 236,A01,839890,Fricker; Helen A. & Sandwell; David T,5,0,5,0
1739704825584,SIOG 236,A02,872451,Fricker; Helen A. & Sandwell; David T,5,0,5,0
1739704826608,SIOG 239,A00,839891,Fan; Wenyuan,19,0,20,1
1739704827632,SIOG 268,A00,872652,Martz; Todd R.,9,0,10,1
1739704828658,SOCE 194,A00,851601,Staff,0,0,0,0
1739704829686,SOCG 204,A00,838022,Ng; Kwai,0,0,10,10
1739704830712,SOCG 206,A00,838023,Alvarez; Camila Huerta,6,0,10,4
1739704831737,SOCG 246,A00,838024,Kenworthy; Lane A.,4,0,10,6
1739704832762,SOCG 255B,A00,838025,Gere; Catherina M.,7,0,10,3
1739704833787,SOCG 255C,A00,838026,McKenzie; Kerry V.,7,0,10,3
1739704834810,SOCG 263,A00,838027,Jules-Rosette; Bennetta W.,9,0,10,1
1739704835836,SOCG 278,A00,838030,Watson; Tobias,4,0,10,6
1739704836862,SOCG 280,A00,838031,Fitzgerald; David S,4,0,10,6
1739704837889,SOCG 290,A00,838032,Goldman; Harvey Stern,7,0,10,3
1739704838915,SOCI 2,A01,837726,Payne; Christine Anna,27,0,30,3
1739704838915,SOCI 2,A02,837727,Payne; Christine Anna,30,0,30,0
1739704838915,SOCI 2,A03,837728,Payne; Christine Anna,29,0,30,1
1739704838915,SOCI 2,A04,837729,Payne; Christine Anna,29,0,30,1
1739704838915,SOCI 2,A05,837730,Payne; Christine Anna,30,0,30,0
1739704838915,SOCI 2,A06,837766,Payne; Christine Anna,0,0,0,0
1739704838915,SOCI 2,A07,837769,Payne; Christine Anna,0,0,0,0
1739704838915,SOCI 2,A08,837770,Payne; Christine Anna,0,0,0,0
1739704839944,SOCI 10,A01,869965,Kenworthy; Lane A.,27,0,30,3
1739704839944,SOCI 10,A02,869977,Kenworthy; Lane A.,28,0,30,2
1739704839944,SOCI 10,A03,869985,Kenworthy; Lane A.,30,0,30,0
1739704839944,SOCI 10,A04,869986,Kenworthy; Lane A.,28,0,30,2
1739704840972,SOCI 20,A01,837783,Calderon-Zaks; Michael Aar,35,0,35,0
1739704840972,SOCI 20,A02,837807,Calderon-Zaks; Michael Aar,34,0,35,1
1739704841998,SOCI 60,A01,837816,Sutton; April Marie,28,0,32,4
1739704841998,SOCI 60,A02,837817,Sutton; April Marie,32,0,32,0
1739704841998,SOCI 60,A03,837818,Sutton; April Marie,29,0,32,3
1739704841998,SOCI 60,A04,837819,Sutton; April Marie,31,0,32,1
1739704843023,SOCI 100,A01,837840,Medvetz; Thomas Matthew,29,0,30,1
1739704843023,SOCI 100,A02,837848,Medvetz; Thomas Matthew,30,0,30,0
1739704843023,SOCI 100,A03,837849,Medvetz; Thomas Matthew,30,0,30,0
1739704843023,SOCI 100,A04,837850,Medvetz; Thomas Matthew,28,0,30,2
1739704844051,SOCI 103M,A00,837862,Kilpatrick; Kevin,29,0,30,1
1739704845079,SOCI 104,A00,837863,Arnal; Maud Marie Leonie,28,0,30,2
1739704846108,SOCI 106,A00,837869,Payne; Christine Anna,27,0,30,3
1739704847134,SOCI 109,A00,837870,Kilpatrick; Kevin,29,0,30,1
1739704848160,SOCI 111,A00,837871,Ribas Norris; Janet Vanesa,56,0,56,0
1739704849185,SOCI 111T,A00,837872,Thorpe; Charles Robert,65,0,65,0
1739704850214,SOCI 112,A00,837885,Pitt; Richard Norris,58,0,65,7
1739704851240,SOCI 113,A00,837886,Rogers; Julia Ellen,73,0,75,2
1739704852265,SOCI 115,A00,837889,Sutton; April Marie,63,0,65,2
1739704853291,SOCI 117,A01,851612,Jones; Makeba,9,0,13,4
1739704853291,SOCI 117,A02,851613,Jones; Makeba,13,0,13,0
1739704853291,SOCI 117,A03,851614,Jones; Makeba,12,0,12,0
1739704853291,SOCI 117,A04,851616,Jones; Makeba,12,0,12,0
1739704853291,SOCI 117,B01,870980,Staff,10,0,10,0
1739704853291,SOCI 117,B02,870985,Staff,10,0,10,0
1739704853291,SOCI 117,B03,870987,Staff,10,0,10,0
1739704853291,SOCI 117,B04,871055,Staff,10,0,10,0
1739704854314,SOCI 119,A00,837925,Victoria Torres; Pablo,87,0,90,3
1739704855340,SOCI 125C,A00,872640,Watson; Tobias,55,0,56,1
1739704856364,SOCI 125M,A00,837948,Fitzgerald; David S,45,0,45,0
1739704857392,SOCI 126,A01,851618,Jones; Makeba,18,0,20,2
1739704857392,SOCI 126,A02,837966,Jones; Makeba,20,0,20,0
1739704857392,SOCI 126,A03,837969,Jones; Makeba,20,0,20,0
1739704858421,SOCI 129,A00,837973,Pitt; Richard Norris,72,0,75,3
1739704859448,SOCI 132,A00,837974,Blair-Loy; Mary,74,0,75,1
1739704860473,SOCI 133,A00,837983,Calderon-Zaks; Michael Aar,55,0,56,1
1739704861497,SOCI 134,A00,837989,Rogers; Julia Ellen,45,0,45,0
1739704862522,SOCI 135,A00,838005,Ruiz; Jonathan Joseph,54,0,56,2
1739704863548,SOCI 138,A00,838006,Ruiz; Jonathan Joseph,55,0,56,1
1739704864573,SOCI 139,A00,838007,Ribas Norris; Janet Vanesa,41,0,46,5
1739704865654,SOCI 139A,A00,838008,Estefan; Michel,52,0,56,4
1739704866680,SOCI 140A,A00,838009,Gong; Neil M,66,0,70,4
1739704867707,SOCI 140J,A00,838010,Estefan; Michel,92,0,100,8
1739704868736,SOCI 148,A00,838011,Maron; Asa,34,0,35,1
1739704869765,SOCI 150,A00,838012,Victoria Torres; Pablo,68,0,75,7
1739704870792,SOCI 151,A00,838013,Goldman; Harvey Stern,64,0,65,1
1739704871817,SOCI 156,A00,838014,Ostovany; Khashayar,40,0,40,0
1739704872849,SOCI 157,A00,838015,Crofts; Christine,45,0,56,11
1739704873880,SOCI 158,A00,838016,Ostovany; Khashayar,39,0,40,1
1739704874908,SOCI 160,A00,838017,Medvetz; Thomas Matthew,70,0,70,0
1739704875937,SOCI 161,A00,838018,Arnal; Maud Marie Leonie,49,0,50,1
1739704876963,SOCI 168,A00,838019,Thorpe; Charles Robert,40,0,40,0
1739704877990,SOCI 168E,A00,838021,Crofts; Christine,19,0,35,16
1739704879017,SOCI 174,A00,872915,Shafir; Gershon,28,0,30,2
1739704880043,SOMC 229,A00,867907,Hoang; Mai Phuong,160,0,160,0
1739704881078,SOMC 240,A00,867911,Coyne; Christopher John,160,0,160,0
1739704882107,SOMC 242,A00,867913,Kline; Ahnika Sarah,160,0,160,0
1739704883133,SOMC 244,A00,867940,Evans; Sean Jeffrey,160,0,160,0
1739704884161,SOMC 245C,A01,867952,Noel; Geoffroy Pierre Jean,160,0,160,0
1739704885190,SOMC 246C,A00,867953,Eyler; Lisa T.,160,0,160,0
1739704886223,SOMC 247C,A50,867992,Calcutt; Nigel A,160,0,160,0
1739704887251,SOMC 248C,A00,867993,Joshi; Weena Erin,160,0,160,0
1739704888276,SOMC 249,A00,867994,Bui; Jack D,160,0,160,0
1739704889300,SOMC 250,A00,867997,Reid; Erin G.,160,0,160,0
1739704890324,SOMC 255C,A00,868050,Allison; Matthew,160,0,160,0
1739704891348,SOMI 296,A00,868065,Staff,5,0,5,0
1739704892386,SPPH 161R,A01,864775,Chambers; Christina D,29,0,30,1
1739704892386,SPPH 161R,C01,886226,Chambers; Christina D,20,0,20,0
1739704893411,SPPH 263B,A01,884929,Hook; Vivian Yuan-Ho,98,0,99,1
1739704894436,SPPS 200A,A00,864810,Luli; Alex J,100,0,100,0
1739704895463,SPPS 200B,A00,864827,Luli; Alex J,99,0,99,0
1739704896488,SPPS 200C,A00,864829,Luli; Alex J,99,0,99,0
1739704897513,SPPS 203,A00,864831,Painter; Nathan A.,92,0,99,7
1739704898537,SPPS 205,A01,864838,Bandeira; Nuno Filipe Cabrita,92,0,99,7
1739704899563,SPPS 209,A00,864842,Bounthavong; Mark,93,0,99,6
1739704900592,SPPS 211A,A00,864862,Ferguson; Fleur,92,0,99,7
1739704901617,SPPS 211B,A00,864920,Ferguson; Fleur,96,0,99,3
1739704902642,SPPS 211C,A00,864924,Ferguson; Fleur,93,0,99,6
1739704903671,SPPS 211D,A00,864925,Tsunoda; Shirley M.,99,0,99,0
1739704904697,SPPS 212C,A01,864927,Saunders; Ila Maewal,93,0,99,6
1739704905721,SPPS 213C,A00,864928,Namba; Jennifer Mariko,93,0,99,6
1739704906749,SPPS 218B,A00,864929,Vijapurkar; Ulka,93,0,99,6
1739704907776,SPPS 225,A01,864932,Reed; Chantal,92,0,99,7
1739704908803,SPPS 229,A01,864934,Reid; Erin G.,96,0,99,3
1739704909828,SPPS 237,A00,864935,Mimoto; Mizuho Stacy,96,0,99,3
1739704910857,SPPS 238,A00,864937,Beyhan; Sinem,96,0,99,3
1739704911885,SPPS 239,A01,864942,Bui; Jack D,96,0,99,3
1739704912913,SPPS 241,A01,864944,Tsunoda; Shirley M.,92,0,99,7
1739704913937,SPPS 249,A00,864945,Brandl; Katharina,96,0,99,3
1739704914965,SPPS 250,A00,864946,Tsunoda; Shirley M.,97,0,99,2
1739704915991,SPPS 251,A00,864953,Chen; Timothy,20,0,20,0
1739704917017,SPPS 252,A00,865004,Abdul-Mutakabbir; Jacinda,96,0,99,3
1739704918042,SPPS 253,A00,865006,Tsunoda; Shirley M.,99,0,99,0
1739704919068,SPPS 255,A00,865010,Bounthavong; Mark,98,0,99,1
1739704920094,SPPS 261,A00,865011,Chambers; Christina D,97,0,99,2
1739704921119,SPPS 278,A00,865012,Fricovsky; Eduardo Santiago,98,0,99,1
1739704922143,SPPS 280,A00,865013,Fricovsky; Eduardo Santiago,23,0,23,0
1739704923168,SPPS 281,A00,865014,Gerwick; William Henry,95,0,99,4
1739704924194,SPPS 283,A00,865015,Tsunoda; Shirley M.,98,0,99,1
1739704925221,SURG 296,001,868067,Harris; Jeffrey Paul,4,0,5,1
1739704925221,SURG 296,002,868068,Coffey; Charles Stuart,4,0,5,1
1739704925221,SURG 296,003,868069,Malas; Mahmoud,4,0,5,1
1739704926248,SYN 1,001,836580,Rock; Martin,20,0,20,0
1739704926248,SYN 1,002,836582,Birberick; Brittany Celest,17,0,20,3
1739704926248,SYN 1,003,836583,Meyer; Leslie Rose,20,0,20,0
1739704926248,SYN 1,004,836584,Fish; Gwendolyn Anne,19,0,20,1
1739704926248,SYN 1,005,836585,Fish; Gwendolyn Anne,20,0,20,0
1739704926248,SYN 1,006,836586,Tawater; Hanna Jean,20,0,20,0
1739704926248,SYN 1,007,836590,Fish; Gwendolyn Anne,20,0,20,0
1739704926248,SYN 1,008,836591,Iatarola; Briana Marie,18,0,20,2
1739704926248,SYN 1,009,836592,Browne; Emily,20,0,20,0
1739704926248,SYN 1,010,836594,Staff,20,0,20,0
1739704926248,SYN 1,011,836595,Hom; Kirstyn Courtney,20,0,20,0
1739704926248,SYN 1,012,836599,Hom; Kirstyn Courtney,19,0,20,1
1739704926248,SYN 1,013,836600,Lagapa; Jason,20,0,20,0
1739704926248,SYN 1,014,836603,Deavenport; James Cary,18,0,20,2
1739704926248,SYN 1,015,836606,Girard; Gabrielle,19,0,20,1
1739704926248,SYN 1,016,836607,Deavenport; James Cary,20,0,20,0
1739704926248,SYN 1,017,836622,Girard; Gabrielle,20,0,20,0
1739704926248,SYN 1,018,836653,Atkinson; Arthur Laird,20,0,20,0
1739704926248,SYN 1,019,836656,Girard; Gabrielle,18,0,20,2
1739704926248,SYN 1,020,836658,Atkinson; Arthur Laird,18,0,20,2
1739704926248,SYN 1,021,836659,Staff,20,0,20,0
1739704926248,SYN 1,022,836662,Bishop; Graham,19,0,20,1
1739704926248,SYN 1,023,836663,Bishop; Graham,20,0,20,0
1739704926248,SYN 1,024,836666,Lagapa; Jason,18,0,20,2
1739704926248,SYN 1,025,836723,Lagapa; Jason,20,0,20,0
1739704926248,SYN 1,026,836728,Iatarola; Briana Marie,20,0,20,0
1739704926248,SYN 1,027,836729,Iatarola; Briana Marie,20,0,20,0
1739704926248,SYN 1,028,836730,Difruscio; Mark,20,0,20,0
1739704926248,SYN 1,029,836731,Difruscio; Mark,19,0,20,1
1739704927286,SYN 100,A01,836744,Gladstein; Jill M,12,0,15,3
1739704927286,SYN 100,A02,836745,Gladstein; Jill M,15,0,15,0
1739704927286,SYN 100,B01,836748,Rock; Martin,15,0,15,0
1739704927286,SYN 100,B02,836809,Rock; Martin,14,0,15,1
1739704927286,SYN 100,C01,836812,Browne; Emily,14,0,15,1
1739704927286,SYN 100,C02,836818,Browne; Emily,13,0,15,2
1739704927286,SYN 100,D01,836820,Meyer; Leslie Rose,10,0,15,5
1739704927286,SYN 100,D02,836822,Meyer; Leslie Rose,15,0,15,0
1739704927286,SYN 100,E01,836824,Tawater; Hanna Jean,13,0,15,2
1739704927286,SYN 100,E02,836825,Tawater; Hanna Jean,12,0,15,3
1739704927286,SYN 100,F01,836975,Meyer; Leslie Rose,15,0,15,0
1739704927286,SYN 100,F02,837038,Meyer; Leslie Rose,14,0,15,1
1739704927286,SYN 100,G01,837132,Deavenport; James Cary,13,0,15,2
1739704927286,SYN 100,G02,837133,Deavenport; James Cary,14,0,15,1
1739704927286,SYN 100,H01,837155,Gormally; Brenna,15,0,15,0
1739704927286,SYN 100,H02,872920,Gormally; Brenna,15,0,15,0
1739704927286,SYN 100,I01,837161,Gormally; Brenna,13,0,15,2
1739704927286,SYN 100,I02,837166,Gormally; Brenna,15,0,15,0
1739704927286,SYN 100,J01,837169,Difruscio; Mark,9,0,15,6
1739704927286,SYN 100,J02,837171,Difruscio; Mark,12,0,15,3
1739704927286,SYN 100,K01,837174,Rosenberg; Ryan Glenn,9,0,15,6
1739704927286,SYN 100,K02,837176,Rosenberg; Ryan Glenn,15,0,15,0
1739704927286,SYN 100,L01,837264,Rosenberg; Ryan Glenn,13,0,15,2
1739704927286,SYN 100,L02,837265,Rosenberg; Ryan Glenn,15,0,15,0
1739704927286,SYN 100,M01,837268,Hom; Kirstyn Courtney,12,0,15,3
1739704927286,SYN 100,M02,837269,Hom; Kirstyn Courtney,12,0,15,3
1739704927286,SYN 100,N01,837272,Atkinson; Arthur Laird,14,0,15,1
1739704927286,SYN 100,N02,837275,Atkinson; Arthur Laird,14,0,15,1
1739704927286,SYN 100,O01,837278,Bishop; Graham,13,0,15,2
1739704927286,SYN 100,O02,837284,Bishop; Graham,15,0,15,0
1739704928314,SYN 150,001,837627,Vega; Adrian,20,0,20,0
1739704928314,SYN 150,002,837643,Vega; Adrian,20,0,20,0
1739704929349,TDAC 1,A00,835839,Walsh; Kim C.,19,0,20,1
1739704929349,TDAC 1,B00,835840,Walsh; Kim C.,20,0,20,0
1739704929349,TDAC 1,C00,835841,Walsh; Kim C.,7,0,20,13
1739704929349,TDAC 1,D00,835843,Walsh; Kim C.,19,0,20,1
1739704929349,TDAC 1,E00,835844,Walsh; Kim C.,6,0,20,14
1739704929349,TDAC 1,F00,835845,Walsh; Kim C.,15,0,20,5
1739704930374,TDAC 101,A00,836005,Basso; Beatrice,17,0,20,3
1739704931409,TDAC 102,A00,836006,Harting; Carla Kelso,16,0,20,4
1739704932440,TDAC 105,A00,836007,Barricelli; Marc Alexander,20,0,20,0
1739704933469,TDAC 108,A00,836008,Buescher; Stephen W.,17,0,20,3
1739704933469,TDAC 108,B00,836009,Buescher; Stephen W.,16,0,20,4
1739704933469,TDAC 108,C00,836010,Walsh; Kim C.,20,0,20,0
1739704934494,TDAC 109,A00,836012,Blair; Kyle Adam,20,0,20,0
1739704935520,TDAC 122,A00,836014,Stalling; Vanessa,30,0,30,0
1739704935520,TDAC 122,B00,836015,Perry; Lamar,30,0,30,0
1739704935520,TDAC 122,C00,872388,Celik; Aysan Karagasli,30,0,30,0
1739704935520,TDAC 122,D00,874223,Caban; Andrea Chudnow,30,0,30,0
1739704935520,TDAC 122,E00,874224,Staff,30,0,30,0
1739704936545,TDDE 101,A00,836016,Guirguis; Mark C,20,0,20,0
1739704937572,TDDE 121,A01,836018,Kuhl; Christopher August,16,0,17,1
1739704938599,TDDE 130,A00,836019,Guirguis; Mark C,20,0,20,0
1739704939624,TDDE 131,A00,836020,Petrovich; Victoria A.,19,0,20,1
1739704939624,TDDE 131,B00,872473,Brill; Robert L.,100,0,100,0
1739704940650,TDDE 132,A00,836021,Guirguis; Mark C,20,0,20,0
1739704941675,TDDM 1,A00,835853,Sammartano; Tonnie,40,0,40,0
1739704942700,TDDM 100,A00,836022,Alvarez; Ana Maria,29,0,30,1
1739704943725,TDDR 102,A00,836024,Powell; Lora,19,0,20,1
1739704944749,TDDR 108,A00,836029,Stalling; Vanessa,20,0,20,0
1739704945774,TDDR 111,A00,836039,Castro; Robert Jess,15,0,16,1
1739704945774,TDDR 111,B00,836070,Castro; Robert Jess,16,0,16,0
1739704946799,TDDR 190,A00,836072,Perry; Lamar,35,0,35,0
1739704947825,TDGE 1,A01,835855,Salovey; Todd,19,0,20,1
1739704947825,TDGE 1,A02,835856,Salovey; Todd,20,0,20,0
1739704947825,TDGE 1,A03,835857,Salovey; Todd,19,0,20,1
1739704947825,TDGE 1,A04,835858,Salovey; Todd,20,0,20,0
1739704947825,TDGE 1,A05,835859,Salovey; Todd,19,0,20,1
1739704947825,TDGE 1,A06,835861,Salovey; Todd,17,0,20,3
1739704948849,TDGE 11,A00,835862,Fulton; Julia,224,0,245,21
1739704948849,TDGE 11,B00,835863,Salimi; Rana,157,0,158,1
1739704949880,TDGE 25,A00,835864,Harting; Carla Kelso,15,0,20,5
1739704949880,TDGE 25,B00,835865,Harting; Carla Kelso,14,0,20,6
1739704949880,TDGE 25,C00,835866,Harting; Carla Kelso,19,0,20,1
1739704949880,TDGE 25,D00,835868,Harting; Carla Kelso,16,0,20,4
1739704950906,TDGE 40,A02,835872,Power; Jade Yukana,29,0,30,1
1739704950906,TDGE 40,A03,835873,Power; Jade Yukana,30,0,30,0
1739704951931,TDGE 100,A01,836080,Salovey; Todd,24,0,25,1
1739704951931,TDGE 100,A02,836084,Salovey; Todd,24,0,25,1
1739704952960,TDGE 124,A00,836091,Fulton; Julia,232,0,250,18
1739704953985,TDGE 125,B00,836162,Havis; Allan,215,0,220,5
1739704955015,TDGE 196B,A00,872390,Brown; Bernard Joseph,1,0,1,0
1739704955015,TDGE 196B,B00,872391,Burelle; Julie Sara Veronique,2,0,2,0
1739704955015,TDGE 196B,C00,872392,Celik; Aysan Karagasli,2,0,2,0
1739704955015,TDGE 196B,D00,872394,Havis; Allan,1,0,1,0
1739704955015,TDGE 196B,E00,872396,Mehrishi; Rishika,1,0,1,0
1739704955015,TDGE 196B,F00,872397,Powell; Lora,1,0,1,0
1739704955015,TDGE 196B,G00,872398,Stalling; Vanessa,1,0,1,0
1739704955015,TDGE 196B,H00,872399,Stein; Deborah Isobel,2,0,2,0
1739704956040,TDGR 212,A00,836303,Meyer; Ursula,10,0,10,0
1739704957074,TDGR 219,A00,836305,Portes; Elizabeth Marie,5,0,5,0
1739704958102,TDGR 221B,A00,836306,Caban; Andrea Chudnow,10,0,10,0
1739704959129,TDGR 229,A00,836307,Meyer; Ursula,9,0,9,0
1739704960156,TDGR 233,A00,836308,Staff,9,0,9,0
1739704961184,TDGR 245,A00,836309,Stalling; Vanessa,3,0,3,0
1739704962207,TDGR 250,A00,836311,Staff,5,0,5,0
1739704963235,TDGR 251,A00,836314,Iizuka; Naomi Hisako,5,0,5,0
1739704963235,TDGR 251,B00,836315,Stein; Deborah Isobel,5,0,5,0
1739704964260,TDGR 257B,A00,836388,Stein; Deborah Isobel,7,0,7,0
1739704965286,TDGR 278,A00,836431,Petrovich; Victoria A.,20,0,20,0
1739704966322,TDGR 279,A00,836437,Brill; Robert L.,3,0,3,0
1739704966322,TDGR 279,B00,836440,Petrovich; Victoria A.,3,0,3,0
1739704966322,TDGR 279,C00,836441,McElver; Robert Harrison,3,0,3,0
1739704966322,TDGR 279,D00,836443,Kuhl; Christopher August,3,0,3,0
1739704966322,TDGR 279,E00,836444,Bokovikova; Alina V,3,0,3,0
1739704967348,TDGR 289C,A00,836447,Anderson; Mysia Anyse,10,0,10,0
1739704968376,TDGR 289D,A00,836448,Burelle; Julie Sara Veronique,10,0,10,0
1739704969455,TDGR 292,A00,836449,Anderson; Mysia Anyse,15,0,15,0
1739704970481,TDGR 296,A00,872384,Powell; Lora,10,0,10,0
1739704971508,TDHD 175,A00,836190,Brown; Bernard Joseph,19,0,20,1
1739704972533,TDHT 10,A00,835875,Power; Jade Yukana,24,0,25,1
1739704973559,TDHT 23,A01,835878,Burelle; Julie Sara Veronique,24,0,24,0
1739704973559,TDHT 23,A02,835879,Burelle; Julie Sara Veronique,24,0,24,0
1739704973559,TDHT 23,A03,835880,Burelle; Julie Sara Veronique,22,0,24,2
1739704974586,TDHT 101,A00,836191,Anderson; Mysia Anyse,23,0,25,2
1739704974586,TDHT 101,B00,836193,Staff,24,0,25,1
1739704975612,TDHT 104,A00,836196,Basso; Beatrice,24,0,25,1
1739704976636,TDHT 115,A00,872386,Staff,21,0,25,4
1739704977664,TDMV 1,A00,835881,Caligagan; Maria T.,21,0,30,9
1739704978689,TDMV 2,A00,835882,Weinberg; Sadie,25,0,30,5
1739704979718,TDMV 3,A00,835884,Mack; Kara Shanai',28,0,40,12
1739704980746,TDMV 11,A00,835886,Naves Tannus; Melissa,27,0,30,3
1739704981772,TDMV 20,A00,835890,Smith; Alison D,18,0,20,2
1739704981772,TDMV 20,B00,835920,Brown; Bernard Joseph,40,0,40,0
1739704982800,TDMV 110,A00,836197,Caligagan; Maria T.,29,0,30,1
1739704983826,TDMV 111,A00,836201,Smith; Alison D,26,0,30,4
1739704984851,TDMV 120,A00,836206,Johnston; Holly,30,0,30,0
1739704985877,TDMV 122,A00,836209,Weinberg; Sadie,30,0,30,0
1739704986902,TDMV 123,A00,836214,Johnston; Holly,30,0,30,0
1739704987927,TDMV 130,A00,836216,Mack; Kara Shanai',40,0,40,0
1739704988953,TDMV 138,A00,836222,Jun; Grace Shin Hae,17,0,40,23
1739704989979,TDMV 140,A00,836225,Caligagan; Maria T.,38,0,40,2
1739704989979,TDMV 140,B00,836226,Corrales; Joseph Bernales,39,0,40,1
1739704989979,TDMV 140,C00,836228,Mack; Kara Shanai',30,0,30,0
1739704989979,TDMV 140,D00,836229,Power; Jade Yukana,27,0,30,3
1739704989979,TDMV 140,E00,836232,Lima; Paulo Henrique,30,0,30,0
1739704991003,TDMV 141,A00,836236,Caligagan; Tony,29,0,30,1
1739704992028,TDMV 142,A00,836239,Blanco; Juan Carlos,27,0,30,3
1739704993052,TDMV 143,A00,836288,Fyall; Daunte Edward,29,0,30,1
1739704994080,TDMV 144,A00,836289,Camaya; Michelle Ann,25,0,30,5
1739704994080,TDMV 144,B00,836293,Patnaik; Shibani,30,0,30,0
1739704995105,TDMV 146,A00,836295,Caligagan; Tony,39,0,40,1
1739704996130,TDMV 149,A00,836296,Jun; Grace Shin Hae,38,0,40,2
1739704997153,TDPF 162,A00,836297,Alvarez; Ana Maria,30,0,30,0
1739704998180,TDPR 6,A01,835924,Guirguis; Mark C,50,0,50,0
1739704998180,TDPR 6,A02,835925,Guirguis; Mark C,50,0,50,0
1739704999205,TDPR 102,A00,836298,Guirguis; Mark C,20,0,20,0
1739705000231,TDPR 104,A00,836299,Powell; Lora,15,0,15,0
1739705001256,TDPW 1,A00,835931,Stein; Deborah Isobel,14,0,15,1
1739705001256,TDPW 1,B00,835932,Stein; Deborah Isobel,15,0,15,0
1739705001256,TDPW 1,C00,835934,Stein; Deborah Isobel,15,0,15,0
1739705001256,TDPW 1,D00,835936,Stein; Deborah Isobel,13,0,15,2
1739705001256,TDPW 1,E00,835939,Stein; Deborah Isobel,13,0,15,2
1739705002281,TDPW 102,A00,836300,Iizuka; Naomi Hisako,19,0,20,1
1739705003309,TDTR 10,A00,836002,Wilson; Terry A.,26,0,30,4
1739705004334,TDTR 15,A00,836003,Johnston; Holly,29,0,30,1
1739705005359,TDTR 20,A00,836004,Smith; Alison D,19,0,20,1
1739705006386,TMC 15,A00,836574,Hemans; Patricia Ann Benitez,25,0,27,2
1739705007412,TMC 120,A01,836579,Browne; Errol Tsekani,24,0,25,1
1739705008439,UROL 296,001,868229,Staff,5,0,5,0
1739705008439,UROL 296,002,868230,Staff,5,0,5,0
1739705009468,USP 1,A01,835156,Kwak; Nancy,30,0,30,0
1739705009468,USP 1,A02,835157,Kwak; Nancy,27,0,30,3
1739705009468,USP 1,A03,835158,Kwak; Nancy,29,0,30,1
1739705009468,USP 1,A04,835159,Kwak; Nancy,28,0,30,2
1739705009468,USP 1,A05,835160,Kwak; Nancy,30,0,30,0
1739705009468,USP 1,A06,835161,Kwak; Nancy,30,0,30,0
1739705010494,USP 2,A01,835188,Pezzoli; Keith,34,0,35,1
1739705010494,USP 2,A02,835191,Pezzoli; Keith,33,0,35,2
1739705011520,USP 3,A01,835207,Wickland; Teo Akande,30,0,30,0
1739705011520,USP 3,A02,835290,Wickland; Teo Akande,28,0,30,2
1739705012545,USP 4,A00,835371,Shi; Xiao,24,0,25,1
1739705013570,USP 5,A01,835376,Shenkman; Michael Thomas,30,0,35,5
1739705013570,USP 5,A02,835381,Shenkman; Michael Thomas,34,0,35,1
1739705014598,USP 6,A01,835456,Shvartzberg Carrio; Manuel,35,0,35,0
1739705014598,USP 6,A02,835457,Shvartzberg Carrio; Manuel,35,0,35,0
1739705015627,USP 15,A01,835460,Martin; Isaac,32,0,35,3
1739705015627,USP 15,A02,835461,Martin; Isaac,35,0,35,0
1739705016656,USP 25,A00,835462,Sun; Feiyang,58,0,60,2
1739705017684,USP 60,A01,835468,Wali; Behram,27,0,28,1
1739705018708,USP 100,A00,835469,Moses; Kelema Lee,68,0,70,2
1739705019737,USP 119,A00,835472,Schwaller; Nora Louise,30,0,35,5
1739705020766,USP 124,A00,835475,Hinds; Juli Beth,67,0,70,3
1739705021790,USP 125,A00,835477,Garcia; Guadalupe,22,0,22,0
1739705022818,USP 128B,A01,835530,Lewis; Leslie R,13,0,13,0
1739705023845,USP 131,A00,835537,Wartell; Julie Dara,35,0,65,30
1739705024871,USP 142C,A00,835546,Lerner; Amy M,0,0,0,3
1739705025897,USP 145,A00,835547,Yaghmaee; Saman,142,0,146,4
1739705026924,USP 150,A00,835548,Holmes; Michael Joseph,58,0,60,2
1739705027950,USP 151,A00,835551,Clark; Christopher N,42,0,45,3
1739705028975,USP 152A,A01,835569,Moeder; Nathan L,22,0,22,0
1739705028975,USP 152A,A02,835571,Moeder; Nathan L,21,0,22,1
1739705029999,USP 152B,A00,835581,Moeder; Nathan L,23,0,25,2
1739705031028,USP 153,A00,835641,Shenkman; Michael Thomas,63,0,65,2
1739705032054,USP 158A,A00,835683,Sun; Feiyang,25,0,25,0
1739705033079,USP 159B,A00,835704,Gherini; Paul Pier-Carlo,7,0,8,1
1739705034105,USP 160,A00,835742,Wartell; Julie Dara,25,0,25,0
1739705035133,USP 164,A00,835796,Moses; Kelema Lee,24,0,32,8
1739705036158,USP 165C,A00,835797,Frank; Lawrence Douglas,20,0,20,0
1739705037182,USP 169,A00,835799,Bajaj; Ravi Siddharth,29,0,30,1
1739705038207,USP 170,A00,835800,Entezam; Maryam,60,0,65,5
1739705039236,USP 171,A00,835802,Herzog; Lawrence,65,0,70,5
1739705040263,USP 172,A00,835804,Peerson; Susan,13,0,22,9
1739705041288,USP 175,A00,835805,Velasco; Diego,20,0,22,2
1739705041288,USP 175,B00,835806,Staff,20,0,22,2
1739705042328,USP 177A,A00,835807,Velasco; Diego,21,0,22,1
1739705043355,USP 177B,A00,835814,Peerson; Susan,22,0,25,3
1739705044381,USP 180,A00,835815,Frank; Lawrence Douglas,29,0,30,1
1739705045407,USP 188B,A00,835817,Pezzoli; Keith,30,0,30,0
1739705046442,USP 190,A00,835818,Collins; Caroline Imani,15,0,15,0
1739705047467,USP 191B,A00,835823,Shi; Xiao,18,0,20,2
1739705048491,USP 193,A00,835825,Staff,22,0,22,0
1739705049516,USP 194,A00,835837,Staff,0,0,0,0
1739705050542,USP 198,A00,880741,Moses; Kelema Lee,9999,0,9999,0
1739705051570,USP 265C,A00,835838,Frank; Lawrence Douglas,10,0,10,0
1739705052598,VIS 3,A01,833730,Fayman; Eva,25,0,25,0
1739705052598,VIS 3,A02,833731,Fayman; Eva,22,0,25,3
1739705052598,VIS 3,A03,833806,Fayman; Eva,24,0,25,1
1739705052598,VIS 3,A04,833888,Fayman; Eva,25,0,25,0
1739705052598,VIS 3,A05,833889,Fayman; Eva,25,0,25,0
1739705052598,VIS 3,A06,833890,Fayman; Eva,22,0,25,3
1739705052598,VIS 3,A07,833891,Fayman; Eva,24,0,25,1
1739705052598,VIS 3,A08,833892,Fayman; Eva,23,0,25,2
1739705052598,VIS 3,A09,833893,Fayman; Eva,25,0,25,0
1739705052598,VIS 3,A10,833894,Fayman; Eva,24,0,25,1
1739705052598,VIS 3,A11,833895,Fayman; Eva,25,0,25,0
1739705052598,VIS 3,A12,833896,Fayman; Eva,22,0,25,3
1739705053625,VIS 9,A00,833897,Sprague; Sean Jeffrey,213,0,250,37
1739705054651,VIS 10,A00,833898,Stone; Patricia,238,0,250,12
1739705055678,VIS 21A,A01,833900,Newsome; Elizabeth Ann,32,0,32,0
1739705055678,VIS 21A,A02,833901,Newsome; Elizabeth Ann,31,0,32,1
1739705055678,VIS 21A,A03,833902,Newsome; Elizabeth Ann,32,0,32,0
1739705055678,VIS 21A,A04,833903,Newsome; Elizabeth Ann,31,0,32,1
1739705055678,VIS 21A,A05,833904,Newsome; Elizabeth Ann,32,0,32,0
1739705055678,VIS 21A,A06,833905,Newsome; Elizabeth Ann,32,0,32,0
1739705056709,VIS 22,A01,833907,Williams; Alena J,32,0,32,0
1739705056709,VIS 22,A02,833908,Williams; Alena J,32,0,32,0
1739705056709,VIS 22,A03,833909,Williams; Alena J,30,0,32,2
1739705056709,VIS 22,A04,833910,Williams; Alena J,31,0,32,1
1739705056709,VIS 22,A05,833911,Williams; Alena J,31,0,32,1
1739705056709,VIS 22,A06,833912,Williams; Alena J,32,0,32,0
1739705056709,VIS 22,A07,833913,Williams; Alena J,32,0,32,0
1739705056709,VIS 22,A08,833914,Williams; Alena J,32,0,32,0
1739705056709,VIS 22,A09,833915,Williams; Alena J,32,0,32,0
1739705056709,VIS 22,A10,833916,Williams; Alena J,32,0,32,0
1739705056709,VIS 22,A11,833917,Williams; Alena J,31,0,32,1
1739705056709,VIS 22,A12,833918,Williams; Alena J,32,0,32,0
1739705057736,VIS 31,A00,833919,Dominguez; Ricardo,308,0,320,12
1739705058763,VIS 32,A01,833921,Yoldas; Pinar,31,0,32,1
1739705058763,VIS 32,A02,833922,Yoldas; Pinar,31,0,32,1
1739705059791,VIS 41,A01,833924,D'Elena-Tweed; Jessica Erin,25,0,25,0
1739705059791,VIS 41,A02,833925,D'Elena-Tweed; Jessica Erin,20,0,25,5
1739705059791,VIS 41,A03,833926,D'Elena-Tweed; Jessica Erin,25,0,25,0
1739705059791,VIS 41,A04,833927,D'Elena-Tweed; Jessica Erin,22,0,25,3
1739705059791,VIS 41,A05,833928,D'Elena-Tweed; Jessica Erin,25,0,25,0
1739705059791,VIS 41,A06,833929,D'Elena-Tweed; Jessica Erin,25,0,25,0
1739705060817,VIS 70N,A01,833931,Garnett; Mariah J,22,0,22,0
1739705060817,VIS 70N,A02,833932,Garnett; Mariah J,21,0,22,1
1739705060817,VIS 70N,A03,833972,Garnett; Mariah J,22,0,22,0
1739705060817,VIS 70N,A04,833974,Garnett; Mariah J,20,0,22,2
1739705060817,VIS 70N,A05,834047,Garnett; Mariah J,22,0,22,0
1739705060817,VIS 70N,A06,834048,Garnett; Mariah J,22,0,22,0
1739705061843,VIS 85A,A01,834098,Balboni; Francesca Jean,32,0,34,2
1739705061843,VIS 85A,A02,834099,Balboni; Francesca Jean,33,0,34,1
1739705062876,VIS 87,A00,872413,Mullin; Jennifer S & Twomey; Robert Daniel,10,0,10,0
1739705063901,VIS 100A,A00,834100,Cruz; Edwin Teddy,7,0,15,8
1739705064929,VIS 102,A00,834103,Cruz; Edwin Teddy,140,0,146,6
1739705065954,VIS 105A,A00,834105,Adler; Amy,29,0,30,1
1739705066978,VIS 105B,A00,834106,Tonies; Joshua Vanjaymes,26,0,30,4
1739705068004,VIS 105C,A00,834107,Herc-Balaszek; Malgorzata,14,0,15,1
1739705069035,VIS 106A,A00,834184,Staff,25,0,25,0
1739705069035,VIS 106A,B00,834185,Chew Ii; Troy Lamarr,24,0,25,1
1739705070060,VIS 106B,A00,834191,Ortiz-Torres; Ruben,24,0,25,1
1739705071087,VIS 106C,A00,834192,Staff,12,0,15,3
1739705072115,VIS 107A,A00,834193,Staff,21,0,25,4
1739705073199,VIS 107B,A00,834194,Pylypchuk; Jonathan,22,0,25,3
1739705074223,VIS 110A,A00,834217,Dinco; Dino,14,0,15,1
1739705075248,VIS 110B,A00,834218,Iglesias; Janelle Ann,13,0,15,2
1739705076272,VIS 110D,A00,834220,Tonies; Joshua Vanjaymes,14,0,15,1
1739705077309,VIS 110F,A00,834224,Fayman; Eva,15,0,15,0
1739705078337,VIS 110N,A00,834226,Adler; Amy,15,0,15,0
1739705079361,VIS 113BN,A00,834227,Staff,14,0,15,1
1739705080387,VIS 117E,A00,834229,Newsome; Elizabeth Ann,11,0,15,4
1739705081436,VIS 121AN,A00,834231,Tronzo; William,72,0,75,3
1739705082465,VIS 124E,A00,834312,Rose; Jordan M,70,0,75,5
1739705083492,VIS 127B,A00,834313,Shen; Kuiyi,146,0,146,0
1739705084521,VIS 128A,A00,834314,Tronzo; William,73,0,75,2
1739705085549,VIS 133,A01,834317,Cantrell; Joe Leo,33,0,34,1
1739705085549,VIS 133,A02,834318,Cantrell; Joe Leo,34,0,34,0
1739705086582,VIS 133A,A00,834409,Chevalier; Clarissa Maria,15,0,15,0
1739705087607,VIS 134,A00,834422,Staff,70,0,75,5
1739705088632,VIS 141B,A00,834423,Stalbaum; Brett,13,0,15,2
1739705089659,VIS 145B,A00,834455,Akten; Mehmet,13,0,15,2
1739705089659,VIS 145B,B00,834467,Alexander; Amy J,14,0,15,1
1739705090691,VIS 146A,A00,834482,Paden; Jonathon Dean,18,0,22,4
1739705091718,VIS 147A,A01,834484,Stalbaum; Brett,20,0,22,2
1739705091718,VIS 147A,A02,834485,Stalbaum; Brett,22,0,22,0
1739705091718,VIS 147A,A03,834493,Stalbaum; Brett,21,0,22,1
1739705091718,VIS 147A,A04,834494,Stalbaum; Brett,20,0,22,2
1739705092742,VIS 147B,A00,834495,Paden; Jonathon Dean,15,0,15,0
1739705093768,VIS 149,A00,834496,Yoldas; Pinar,12,0,15,3
1739705094795,VIS 150A,A00,834506,Staff,11,0,15,4
1739705095820,VIS 152D,A01,834679,Wardwell; Mariana Razo,33,0,34,1
1739705095820,VIS 152D,A02,834754,Wardwell; Mariana Razo,34,0,34,0
1739705095820,VIS 152D,A03,834757,Wardwell; Mariana Razo,32,0,34,2
1739705095820,VIS 152D,A04,834760,Wardwell; Mariana Razo,33,0,34,1
1739705096845,VIS 159,A01,834850,Cartwright; Lisa,34,0,34,0
1739705096845,VIS 159,A02,834851,Cartwright; Lisa,30,0,34,4
1739705096845,VIS 159,A03,834852,Cartwright; Lisa,32,0,34,2
1739705096845,VIS 159,A04,834853,Cartwright; Lisa,34,0,34,0
1739705096845,VIS 159,A05,834855,Cartwright; Lisa,31,0,34,3
1739705096845,VIS 159,A06,834857,Cartwright; Lisa,34,0,34,0
1739705097869,VIS 160A,A00,871872,Paden; Jonathon Dean,15,0,15,0
1739705098895,VIS 160B,A00,834858,Akten; Mehmet,8,0,15,7
1739705098895,VIS 160B,B00,834860,Twomey; Robert Daniel,12,0,15,3
1739705098895,VIS 160B,C00,834861,Alexander; Amy J,13,0,15,2
1739705099923,VIS 164,A00,834867,Sprague; Sean Jeffrey,21,0,22,1
1739705099923,VIS 164,B00,834868,Zurita; Dmitri,22,0,22,0
1739705100950,VIS 167,A00,835011,Staff,22,0,22,0
1739705101977,VIS 168,A00,835015,Zurita; Dmitri,21,0,22,1
1739705103007,VIS 169A,A00,881456,Cross; Brian R,21,0,22,1
1739705104036,VIS 171,A00,835016,Cross; Brian R,20,0,22,2
1739705105061,VIS 172,A00,835090,Trigilio; Michael,20,0,22,2
1739705106087,VIS 174,A00,835102,Stone; Patricia,18,0,22,4
1739705106087,VIS 174,B00,835113,Zurita; Dmitri,21,0,22,1
1739705107116,VIS 177,A00,835114,Crandall; Jordan,22,0,22,0
1739705108142,VIS 179,A00,835118,Segade; Alexandro Abraham,22,0,22,0
1739705109169,VIS 180A,A00,835120,Dinco; Dino,22,0,22,0
1739705110198,VIS 180B,A00,835121,Miller; Nicole L,21,0,22,1
1739705111224,VIS 182,A00,835141,Dinco; Dino,17,0,22,5
1739705112248,VIS 185,A00,835142,Miller; Nicole L,22,0,22,0
1739705113275,VIS 190,A00,835143,Dominguez; Ricardo,15,0,15,0
1739705113275,VIS 190,B00,835144,D'Elena-Tweed; Jessica Erin,13,0,15,2
1739705113275,VIS 190,C00,835146,Yoldas; Pinar,15,0,15,0
1739705114300,VIS 202,A00,835148,Garnett; Mariah J,12,0,15,3
1739705115324,VIS 203,A00,835149,Iglesias; Janelle Ann,9,0,15,6
1739705116348,VIS 206,A00,835150,Kester; Grant,9,0,15,6
1739705117373,VIS 208,A00,835151,Moss; Ceci,15,0,15,0
1739705118398,VIS 211,A00,871767,Dean; Danielle Adobi,4,0,15,11
1739705119424,VIS 220,A00,835152,Williams; Alena J,11,0,15,4
1739705120452,VIS 258,A00,835153,Shen; Kuiyi,11,0,15,4
1739705121495,WCWP 10A,001,833211,Dhir; Simrita,20,0,20,0
1739705121495,WCWP 10A,002,833218,Dhir; Simrita,19,0,20,1
1739705121495,WCWP 10A,003,833221,Staff,0,0,0,0
1739705121495,WCWP 10A,006,833232,Susi; Natalie,0,0,0,0
1739705121495,WCWP 10A,011,833250,Staff,0,0,0,0
1739705121495,WCWP 10A,012,833255,Windham; Emily,18,0,20,2
1739705121495,WCWP 10A,013,833258,Windham; Emily,14,0,20,6
1739705121495,WCWP 10A,014,833259,Holloway Ii; Mathew,19,0,20,1
1739705121495,WCWP 10A,015,833261,Windham; Emily,17,0,20,3
1739705121495,WCWP 10A,016,833262,Holloway Ii; Mathew,20,0,20,0
1739705121495,WCWP 10A,017,833263,Holloway Ii; Mathew,20,0,20,0
1739705121495,WCWP 10A,018,872017,Escobar; Jordan Christophe,20,0,20,0
1739705121495,WCWP 10A,019,872087,Escobar; Jordan Christophe,19,0,20,1
1739705121495,WCWP 10A,020,872122,Escobar; Jordan Christophe,19,0,20,1
1739705121495,WCWP 10A,021,872361,Martiniuk; Jill,20,0,20,0
1739705121495,WCWP 10A,022,872362,Martiniuk; Jill,20,0,20,0
1739705121495,WCWP 10A,023,872364,Martiniuk; Jill,20,0,20,0
1739705121495,WCWP 10A,024,872365,Welji; Haleema Nazir,0,0,0,0
1739705122533,WCWP 10B,003,833318,Merryman; Walter,20,0,20,0
1739705122533,WCWP 10B,005,833340,Merryman; Walter,19,0,20,1
1739705122533,WCWP 10B,006,833342,Merryman; Walter,18,0,20,2
1739705122533,WCWP 10B,007,833358,Staff,0,0,0,0
1739705122533,WCWP 10B,008,833359,Ornelas; Tricia,18,0,20,2
1739705122533,WCWP 10B,009,833364,Ornelas; Tricia,16,0,20,4
1739705122533,WCWP 10B,010,833371,Uriarte; Emma,9,0,20,11
1739705122533,WCWP 10B,011,833378,Gagnon; Jeffrey C,0,0,0,0
1739705122533,WCWP 10B,012,833395,Uriarte; Emma,17,0,20,3
1739705122533,WCWP 10B,013,833397,Uriarte; Emma,13,0,20,7
1739705122533,WCWP 10B,014,833398,Staff,0,0,0,0
1739705122533,WCWP 10B,019,833421,Staff,0,0,0,0
1739705122533,WCWP 10B,020,833422,Staff,0,0,0,0
1739705122533,WCWP 10B,021,833423,Staff,0,0,0,0
1739705122533,WCWP 10B,022,833455,Gagnon; Jeffrey C,15,0,16,1
1739705122533,WCWP 10B,023,833489,Gagnon; Jeffrey C,14,0,16,2
1739705122533,WCWP 10B,024,833614,Staff,0,0,0,0
1739705122533,WCWP 10B,025,833615,Gagnon; Jeffrey C,15,0,16,1
1739705122533,WCWP 10B,026,833635,Gagnon; Jeffrey C,16,0,16,0
1739705122533,WCWP 10B,027,833667,Staff,0,0,0,0
1739705122533,WCWP 10B,028,874686,Gagnon; Jeffrey C,14,0,16,2
1739705122533,WCWP 10B,029,874687,Gagnon; Jeffrey C,15,0,16,1
1739705123563,WCWP 100,A00,833668,McCleary; Keith Long,20,0,20,0
1739705123563,WCWP 100,B00,833669,McCleary; Keith Long,19,0,20,1
1739705123563,WCWP 100,C00,833673,Twohig; Niall Ivan,19,0,20,1
1739705123563,WCWP 100,D00,833677,Twohig; Niall Ivan,19,0,20,1
1739705123563,WCWP 100,E00,833678,Young; Mark T,18,0,20,2
1739705123563,WCWP 100,F00,833679,Young; Mark T,19,0,20,1
1739705124588,WES 207,A00,833201,Staff,20,0,20,0
1739705125614,WES 265,A00,833205,Staff,20,0,20,0
1739705127871,AAS 10R,A01,807278,Butler; Elizabeth Annette,28,0,34,6
1739705127871,AAS 10R,A02,807279,Butler; Elizabeth Annette,30,0,34,4
1739705128898,AAS 170R,A00,807281,Butler; Elizabeth Annette,26,0,28,2
1739705129923,AESE 261,A00,804942,Staff,30,0,30,0
1739705130947,AESE 278D,A00,804945,Staff,30,0,30,0
1739705131973,AESE 278E,A00,804981,Staff,30,0,30,0
1739705132998,AESE 279A,A00,804985,Staff,30,0,30,0
1739705134026,ANAR 100,A00,872378,Dunseth; Zachary Clark,19,0,20,1
1739705135052,ANAR 104,A01,803045,Shtienberg; Gilad,24,0,25,1
1739705135052,ANAR 104,A02,803066,Shtienberg; Gilad,0,0,0,0
1739705136077,ANAR 111,A00,803067,Dunseth; Zachary Clark,25,0,25,0
1739705137102,ANAR 138,A00,803079,Algaze; Guillermo,12,0,15,3
1739705138127,ANAR 155,A00,803081,Braswell; Geoffrey E.,19,0,25,6
1739705139152,ANBI 111,A00,803085,Staff,22,0,25,3
1739705140176,ANBI 116,A00,803087,Wilder; Linnea Lorene,149,0,150,1
1739705141202,ANBI 139,A00,870761,Gagneux; Pascal,137,0,145,8
1739705142230,ANBI 144,A00,803091,Wilder; Linnea Lorene,70,0,75,5
1739705143255,ANBI 149,A00,803093,Non; Amy L,19,0,20,1
1739705144282,ANBI 174,A00,803096,Strum; Shirley C.,15,0,15,0
1739705145306,ANES 296,001,866120,Suresh; Preetham John,4,0,5,1
1739705145306,ANES 296,002,866141,Staff,5,0,5,0
1739705145306,ANES 296,003,866168,Staff,5,0,5,0
1739705146335,ANSC 100,A00,803098,Bialecki; Jon Anthony,23,0,25,2
1739705146335,ANSC 100,B00,871150,Rabinowitz; Dan,20,0,20,0
1739705147359,ANSC 101,A00,803099,Sloane; Julia Kathryn,35,0,40,5
1739705148384,ANSC 117,A00,803100,Martin Sandino; Amanda Maria Yoland,16,0,18,2
1739705149410,ANSC 134,A00,803104,Petterson; John C.,25,0,25,0
1739705150440,ANSC 137,A00,803105,Stewart; Alexander B,39,0,40,1
1739705151465,ANSC 147,A00,803106,Stewart; Alexander B,36,0,40,4
1739705152490,ANSC 148,A00,803110,Schonberg; Jeffrey,45,0,46,1
1739705153518,ANSC 173,A00,803119,Brenner; Suzanne A,10,0,12,2
1739705154544,ANSC 180,A00,803121,Hankins; Joseph D.,22,0,25,3
1739705155571,ANSC 191,A00,803124,Yeh; Rihan Wen Xin,11,0,12,1
1739705156596,ANTH 2,A01,803000,Marchetto; Maria Carolina,32,0,33,1
1739705156596,ANTH 2,A02,803001,Marchetto; Maria Carolina,32,0,33,1
1739705156596,ANTH 2,A03,803005,Marchetto; Maria Carolina,30,0,33,3
1739705156596,ANTH 2,A04,803006,Marchetto; Maria Carolina,30,0,33,3
1739705156596,ANTH 2,A05,803007,Marchetto; Maria Carolina,33,0,33,0
1739705156596,ANTH 2,A06,803008,Marchetto; Maria Carolina,31,0,31,0
1739705157622,ANTH 3,A01,803012,Algaze; Guillermo,30,0,30,0
1739705157622,ANTH 3,A02,803013,Algaze; Guillermo,30,0,30,0
1739705157622,ANTH 3,A03,803015,Algaze; Guillermo,30,0,30,0
1739705157622,ANTH 3,A04,803016,Algaze; Guillermo,30,0,30,0
1739705158648,ANTH 4,A01,803020,Yeh; Rihan Wen Xin,27,0,30,3
1739705158648,ANTH 4,A02,803021,Yeh; Rihan Wen Xin,30,0,30,0
1739705158648,ANTH 4,A03,803022,Yeh; Rihan Wen Xin,30,0,30,0
1739705158648,ANTH 4,A04,803024,Yeh; Rihan Wen Xin,30,0,30,0
1739705159674,ANTH 10,A00,803025,Stewart; Alexander B,73,0,80,7
1739705160703,ANTH 21,A01,803027,Stone; Annika Britt,38,0,40,2
1739705160703,ANTH 21,A02,803030,Stone; Annika Britt,36,0,40,4
1739705160703,ANTH 21,A03,803031,Stone; Annika Britt,38,0,40,2
1739705160703,ANTH 21,A04,803032,Stone; Annika Britt,39,0,40,1
1739705161731,ANTH 23,A01,803034,Stone; Annika Britt,39,0,40,1
1739705161731,ANTH 23,A02,803036,Stone; Annika Britt,39,0,40,1
1739705161731,ANTH 23,A03,803037,Stone; Annika Britt,40,0,40,0
1739705161731,ANTH 23,A04,803038,Stone; Annika Britt,40,0,40,0
1739705162755,ANTH 87,A00,875928,Staff,20,0,20,0
1739705163783,ANTH 103,A00,803126,Hankins; Joseph D.,98,0,100,2
1739705164810,ANTH 105,A00,803130,Rabinowitz; Dan,73,0,75,2
1739705165837,ANTH 109,A00,803133,Staff,38,0,40,2
1739705166864,ANTH 110,A00,803135,Staff,15,0,20,5
1739705167890,ANTH 128B,A01,803139,Lewis; Leslie R,12,0,12,0
1739705168916,ANTH 196C,A00,803147,Varma; Saiba,20,0,20,0
1739705169941,ANTH 198,001,886925,Varma; Saiba,15,0,15,0
1739705170973,ANTH 200,A00,803150,Pedersen; David,15,0,15,0
1739705172000,ANTH 230,A00,889211,Gagneux; Pascal,17,0,20,3
1739705173025,ANTH 272,A00,803155,Gere; Catherina M.,9,0,10,1
1739705174051,ANTH 273,A00,803158,McKenzie; Kerry V.,10,0,10,0
1739705175077,ANTH 288,A00,803189,Braswell; Geoffrey E.,25,0,25,0
1739705176121,ANTH 295,001,887807,Algaze; Guillermo,3,0,3,0
1739705176121,ANTH 295,002,887809,Braswell; Geoffrey E.,3,0,3,0
1739705176121,ANTH 295,003,887890,Brenner; Suzanne A,3,0,3,0
1739705176121,ANTH 295,004,887891,Csordas; Thomas J.,3,0,3,0
1739705176121,ANTH 295,005,887909,Fox; Patrick Keolu Ozer,3,0,3,0
1739705176121,ANTH 295,006,887940,Gagneux; Pascal,3,0,3,0
1739705176121,ANTH 295,007,887941,Goldstein; Paul S,3,0,3,0
1739705176121,ANTH 295,008,887942,Hankins; Joseph D.,3,0,3,0
1739705176121,ANTH 295,009,887948,Jassal; Aftab,3,0,3,0
1739705176121,ANTH 295,010,887949,Jenkins; Janis A.,3,0,3,0
1739705176121,ANTH 295,011,887950,Jimenez Cano; Nayeli Guada,3,0,3,0
1739705176121,ANTH 295,012,887951,Kaiser; Bronwyn Nicole,3,0,3,0
1739705176121,ANTH 295,013,887955,Kang; Byung Chu,3,0,3,0
1739705176121,ANTH 295,014,887957,Marchetto; Maria Carolina,3,0,3,0
1739705176121,ANTH 295,015,887960,Non; Amy L,3,0,3,0
1739705176121,ANTH 295,016,887961,Pedersen; David,3,0,3,0
1739705176121,ANTH 295,017,887962,Rivera-Collazo; Isabel C,3,0,3,0
1739705176121,ANTH 295,018,887963,Varma; Saiba,3,0,3,0
1739705176121,ANTH 295,019,887969,Yeh; Rihan Wen Xin,3,0,3,0
1739705177206,ANTH 296,001,888015,Braswell; Geoffrey E.,3,0,3,0
1739705177206,ANTH 296,002,888024,Marchetto; Maria Carolina,3,0,3,0
1739705177206,ANTH 296,003,888035,Rivera-Collazo; Isabel C,3,0,3,0
1739705177206,ANTH 296,004,888050,Varma; Saiba,3,0,3,0
1739705177206,ANTH 296,005,888055,Algaze; Guillermo,3,0,3,0
1739705177206,ANTH 296,006,888067,Brenner; Suzanne A,3,0,3,0
1739705177206,ANTH 296,007,888075,Csordas; Thomas J.,3,0,3,0
1739705177206,ANTH 296,008,888081,Fox; Patrick Keolu Ozer,3,0,3,0
1739705177206,ANTH 296,009,888084,Gagneux; Pascal,3,0,3,0
1739705177206,ANTH 296,010,888086,Goldstein; Paul S,2,0,3,1
1739705177206,ANTH 296,011,888089,Hankins; Joseph D.,3,0,3,0
1739705177206,ANTH 296,012,888093,Jassal; Aftab,3,0,3,0
1739705177206,ANTH 296,013,888095,Jenkins; Janis A.,3,0,3,0
1739705177206,ANTH 296,014,888099,Jimenez Cano; Nayeli Guada,3,0,3,0
1739705177206,ANTH 296,015,888101,Kaiser; Bronwyn Nicole,3,0,3,0
1739705177206,ANTH 296,016,888102,Kang; Byung Chu,3,0,3,0
1739705177206,ANTH 296,017,888106,Levy; Thomas E,3,0,3,0
1739705177206,ANTH 296,018,888109,Non; Amy L,3,0,3,0
1739705177206,ANTH 296,019,888111,Pedersen; David,3,0,3,0
1739705177206,ANTH 296,020,888112,Postero; Nancy Grey,3,0,3,0
1739705177206,ANTH 296,021,888116,Semendeferi; Ekaterini,3,0,3,0
1739705177206,ANTH 296,022,888118,Yeh; Rihan Wen Xin,3,0,3,0
1739705178232,ASTR 2,A01,803214,Nadler; Ethan Oliver,296,0,300,4
1739705179256,ASTR 15,A01,803221,Wright; Shelley Adams,47,0,50,3
1739705180284,ASTR 18,A01,803234,Arnold; Kam S,30,0,30,0
1739705181313,ASTR 60,A01,803300,Burgasser; Adam Jonathan,14,0,15,1
1739705181313,ASTR 60,A02,803301,Burgasser; Adam Jonathan,15,0,15,0
1739705181313,ASTR 60,A03,803302,Burgasser; Adam Jonathan,15,0,15,0
1739705181313,ASTR 60,A04,803303,Burgasser; Adam Jonathan,15,0,15,0
1739705182344,ASTR 87,A00,871154,Burgasser; Adam Jonathan,20,0,20,0
1739705183371,ASTR 103,A01,803305,Diamond; Patrick H,30,0,30,0
1739705184402,ASTR 106,A01,803307,Boggs; Steven Edward,30,0,30,0
1739705185436,ASTR 123,A01,803343,Keres; Dusan,35,0,39,4
1739705186462,ASTR 154,A01,803345,Hosseinzadeh; Griffin Alex,40,0,40,0
1739705187487,ASTR 211,A00,803346,Broekgaarden; Floor Suzan,12,0,15,3
1739705188512,ASTR 250,A00,803347,Theissen; Christopher Alexander & Hosseinzadeh; Griffin Alex,26,0,30,4
1739705189540,ASTR 251,A00,803359,Theissen; Christopher Alexander & Hosseinzadeh; Griffin Alex,28,0,30,2
1739705190567,AUD 236,A00,804989,Harris; Jeffrey Paul,5,0,5,0
1739705191592,AUD 260,A01,804994,Zettner; Erika,13,0,13,0
1739705192618,AUD 272,A00,804997,Zettner; Erika,13,0,13,0
1739705193643,AUD 275,A00,805001,Zettner; Erika,13,0,13,0
1739705194670,AUD 284,A00,805004,Zettner; Erika,13,0,13,0
1739705195695,AUD 291,A00,805008,Zettner; Erika,13,0,13,0
1739705196720,AUD 296,A00,805013,Zettner; Erika,6,0,6,0
1739705197747,AWP 3,001,802590,O'Neil; Courtney L,9,0,9,0
1739705197747,AWP 3,002,802591,O'Neil; Courtney L,9,0,9,0
1739705197747,AWP 3,003,802592,Kolodezh; Samuel,8,0,9,1
1739705197747,AWP 3,004,802593,Zimmerman; Guy,9,0,9,0
1739705197747,AWP 3,005,802594,Vaughn; Kelsey Sara,9,0,9,0
1739705197747,AWP 3,006,802595,Vaughn; Kelsey Sara,9,0,9,0
1739705197747,AWP 3,007,802597,Given; William Allan,9,0,9,0
1739705198775,AWP 4A,A00,802601,Ajo; Frances Margaret,10,0,10,0
1739705198775,AWP 4A,B00,802602,Ajo; Frances Margaret,9,0,10,1
1739705198775,AWP 4A,C00,880738,Bauer; Holly Jean,10,0,10,0
1739705199830,AWP 4B,001,802603,Steinberg; Stacy A,0,0,0,0
1739705199830,AWP 4B,002,802604,Steinberg; Stacy A,0,0,0,2
1739705199830,AWP 4B,003,802605,Gilmore; Lauren Monica,0,0,0,1
1739705199830,AWP 4B,004,802606,Gilmore; Lauren Monica,0,0,0,0
1739705199830,AWP 4B,007,802609,Bolin; Jillian,0,0,0,0
1739705199830,AWP 4B,008,802610,Bolin; Jillian,0,0,0,0
1739705199830,AWP 4B,009,802611,Zroka; Amy Liane,0,0,0,0
1739705199830,AWP 4B,010,802612,Zroka; Amy Liane,0,0,0,0
1739705199830,AWP 4B,011,802614,Christie; Veronica Ann,0,0,0,0
1739705199830,AWP 4B,012,802672,Christie; Veronica Ann,0,0,0,0
1739705199830,AWP 4B,013,802673,Jones; William Jadie,0,0,0,0
1739705199830,AWP 4B,014,802676,Jones; William Jadie,0,0,0,1
1739705199830,AWP 4B,015,802677,Heiser; Jerrod A,0,0,0,0
1739705199830,AWP 4B,016,802679,Heiser; Jerrod A,0,0,0,1
1739705199830,AWP 4B,017,802683,Bourdeau; Joseph Albert,0,0,0,0
1739705199830,AWP 4B,018,802684,Bourdeau; Joseph Albert,0,0,0,1
1739705199830,AWP 4B,019,802690,Wilson; Natalie Ann,0,0,0,0
1739705199830,AWP 4B,020,802691,Wilson; Natalie Ann,0,0,0,0
1739705199830,AWP 4B,021,802692,Stanton; Jennifer K,0,0,0,0
1739705199830,AWP 4B,022,802693,Stanton; Jennifer K,0,0,0,1
1739705199830,AWP 4B,023,802696,Riggle; Amanda L,0,0,0,1
1739705199830,AWP 4B,024,802699,Riggle; Amanda L,0,0,0,0
1739705199830,AWP 4B,025,802702,Homenick; Erik Christopher,0,0,0,0
1739705199830,AWP 4B,026,802703,Homenick; Erik Christopher,0,0,0,0
1739705199830,AWP 4B,027,802705,Ornelas Jr.; David Paul,0,0,0,0
1739705199830,AWP 4B,028,802706,Grant; Melinda G,0,0,0,0
1739705199830,AWP 4B,029,802707,Grant; Melinda G,0,0,0,0
1739705199830,AWP 4B,030,802708,Ornelas Jr.; David Paul,0,0,0,0
1739705199830,AWP 4B,031,802709,Falcon; Jennifer A,0,0,0,0
1739705199830,AWP 4B,032,802710,Falcon; Jennifer A,0,0,0,0
1739705199830,AWP 4B,033,802711,Westerfeld; Kevin John,0,0,0,0
1739705199830,AWP 4B,034,802712,Tiernan; Christa Michelle,0,0,0,0
1739705199830,AWP 4B,035,802714,Tiernan; Christa Michelle,0,0,0,0
1739705199830,AWP 4B,036,802980,Westerfeld; Kevin John,0,0,0,0
1739705199830,AWP 4B,038,802982,Gardella; Alexander Drew,0,0,0,0
1739705199830,AWP 4B,039,802983,Gardella; Alexander Drew,0,0,0,0
1739705199830,AWP 4B,040,802985,Coulter; Jane Elisabeth,0,0,0,0
1739705199830,AWP 4B,041,802986,Spicer; Jacqueline,0,0,0,0
1739705199830,AWP 4B,042,802987,Spicer; Jacqueline,0,0,0,0
1739705199830,AWP 4B,043,802989,Tsurska Svetina; Olena,0,0,0,0
1739705199830,AWP 4B,044,802990,Tsurska Svetina; Olena,0,0,0,1
1739705199830,AWP 4B,045,802991,Chandler; Bailee Daniele,0,0,0,0
1739705199830,AWP 4B,046,802993,Chandler; Bailee Daniele,0,0,0,1
1739705199830,AWP 4B,047,802994,Hall; Graham T,0,0,0,0
1739705199830,AWP 4B,048,802995,Hall; Graham T,0,0,0,0
1739705200859,AWP 10R,001,871136,Gocsik; Karen Marie,13,0,15,2
1739705201891,BENG 87,A00,886240,Sah; Robert Lie-Yuan,20,0,20,0
1739705201891,BENG 87,B00,886257,Sah; Robert Lie-Yuan,20,0,20,0
1739705202919,BENG 100,A01,805026,Alexandrov; Ludmil B,30,0,30,0
1739705202919,BENG 100,A02,805028,Alexandrov; Ludmil B,29,0,30,1
1739705202919,BENG 100,A03,805030,Alexandrov; Ludmil B,30,0,30,0
1739705202919,BENG 100,A04,805031,Alexandrov; Ludmil B,29,0,30,1
1739705203944,BENG 102,A00,805032,Chapelin; Fanny,52,0,56,4
1739705204976,BENG 103B,A00,805039,Fraley; Stephanie I.,116,0,120,4
1739705206003,BENG 112B,A01,805055,Shi; Lingyan,22,0,23,1
1739705206003,BENG 112B,A02,805056,Shi; Lingyan,20,0,23,3
1739705207030,BENG 125,A01,805058,Hasty; Jeff M,14,0,32,18
1739705207030,BENG 125,A02,805059,Hasty; Jeff M,31,0,32,1
1739705207030,BENG 125,A03,805060,Hasty; Jeff M,31,0,32,1
1739705207030,BENG 125,A04,805102,Hasty; Jeff M,32,0,32,0
1739705207030,BENG 125,A05,805109,Hasty; Jeff M,19,0,32,13
1739705208056,BENG 130,A00,805118,Kravets; Vira V.,37,0,40,3
1739705209090,BENG 134,A01,805171,Smarr; Benjamin,34,0,40,6
1739705210115,BENG 140B,A01,805175,Cabrales; Pedro,27,0,30,3
1739705210115,BENG 140B,A02,805176,Cabrales; Pedro,29,0,30,1
1739705210115,BENG 140B,A03,805177,Cabrales; Pedro,28,0,30,2
1739705211140,BENG 160,A50,805180,Aguado; Brian Alberto,18,0,25,7
1739705211140,BENG 160,A51,805181,Aguado; Brian Alberto,23,0,25,2
1739705211140,BENG 160,A52,805182,Aguado; Brian Alberto,25,0,25,0
1739705212169,BENG 168,A01,805184,Khojah; Reem I,30,0,30,0
1739705213195,BENG 172,A50,805187,Cabrales; Pedro & Sah; Robert Lie-Yuan,13,0,20,7
1739705213195,BENG 172,A51,805188,Cabrales; Pedro & Sah; Robert Lie-Yuan,19,0,20,1
1739705214220,BENG 182,A01,805190,Bafna; Vineet,29,0,35,6
1739705215245,BENG 186A,A01,805192,Kwon; Ester Jihae,0,0,25,25
1739705215245,BENG 186A,A02,805193,Kwon; Ester Jihae,23,0,25,2
1739705215245,BENG 186A,A04,805195,Kwon; Ester Jihae,17,0,25,8
1739705216271,BENG 186B,A01,805230,Aran; Kiana,39,0,40,1
1739705217297,BENG 187A,A00,805231,Taylor Amos; Alyssa C,152,0,170,18
1739705218322,BENG 187D,A00,805243,Taylor Amos; Alyssa C,34,0,60,26
1739705218322,BENG 187D,B00,805249,Taylor Amos; Alyssa C,50,0,60,10
1739705218322,BENG 187D,C00,805286,Taylor Amos; Alyssa C,41,0,60,19
1739705219347,BENG 190,A00,872568,Khojah; Reem I,24,0,40,16
1739705220374,BENG 193,A00,805288,Engler; Adam J.,0,0,0,0
1739705221402,BENG 196,A00,803380,Engler; Adam J.,9999,0,9999,0
1739705222426,BENG 197,A00,803381,Engler; Adam J.,9999,0,9999,0
1739705223456,BENG 203,A00,805307,Bafna; Vineet & Zhong; Sheng,20,0,20,0
1739705224489,BENG 207,A00,805308,Kwon; Ester Jihae,1,0,40,39
1739705224489,BENG 207,B00,805309,Taylor Amos; Alyssa C,0,0,30,30
1739705224489,BENG 207,C00,805310,Spang; Martin Thomas,15,0,40,25
1739705225515,BENG 209,A00,805311,Scholtes Acevedo; Claire,30,0,30,0
1739705226548,BENG 213,A00,805312,Palsson; Bernhard O.,16,0,20,4
1739705227582,BENG 224,A00,805313,Prado; Gustavo Rotelli,0,0,20,30
1739705228610,BENG 226,A01,805315,Staff,74,0,140,66
1739705229638,BENG 227,A00,805316,Fraley; Stephanie I.,42,0,120,78
1739705230664,BENG 230C,A00,805318,King; Kevin R,59,0,90,31
1739705231689,BENG 232,A01,805320,Sah; Robert Lie-Yuan,16,0,70,54
1739705232718,BENG 233,A00,805364,Shah; Sameer B,21,0,50,29
1739705233742,BENG 234,A00,805365,Silva; Gabriel,22,0,70,48
1739705234766,BENG 235,A00,805366,Bintu; Bogdan,18,0,40,22
1739705235828,BENG 276,A00,805367,Mc Culloch; Andrew Douglas,0,0,0,0
1739705236853,BENG 280C,A01,805370,McVeigh; Elliot R.,37,0,56,19
1739705237877,BENG 281,A00,805371,Smarr; Benjamin,40,0,110,70
1739705238909,BENG 283,A00,805372,Ghassemian; Majid & Sanchez Roige; Alexandra & Chavez; Alejandro,5,0,5,0
1739705239934,BENG 285,A00,805374,Alexandrov; Ludmil B,8,0,8,0
1739705240962,BENG 292,A01,805387,Ross; Camille,20,0,20,0
1739705241987,BENG 294C,A00,805396,Engler; Adam J.,0,0,0,0
1739705243017,BENG 295,A00,803924,Watson; John Thomas,9999,0,9999,0
1739705244043,BGGN 205,A00,851551,Daugherty; Matthew Dorton,53,0,60,7
1739705245070,BGGN 207,A01,851553,Ross; Camille,0,0,0,0
1739705246096,BGGN 215,A00,851554,Petrie; Katherine Lynn,0,0,30,30
1739705247124,BGGN 232,A00,851556,Briggs; Steven & Troemel; Emily Ruth,0,0,30,30
1739705248154,BGGN 239,A01,851558,Kronenberg; Mitchell E.,22,0,30,8
1739705249179,BGGN 240,A01,851560,Aoi; Mikio C,1,0,5,4
1739705249179,BGGN 240,A02,851561,Aoi; Mikio C,5,0,5,0
1739705249179,BGGN 240,A03,851562,Aoi; Mikio C,2,0,5,3
1739705249179,BGGN 240,A04,851564,Aoi; Mikio C,4,0,5,1
1739705250204,BGGN 249C,A00,851566,Miller; Cory T.,0,0,0,0
1739705251229,BGGN 255,A00,851567,Root; Cory Matthew,9,0,30,21
1739705252258,BGGN 267,A01,851569,Benna; Marcus K & Aljadeff; Johnatan,0,0,2,2
1739705252258,BGGN 267,A02,851570,Benna; Marcus K & Aljadeff; Johnatan,2,0,2,0
1739705252258,BGGN 267,A03,851571,Benna; Marcus K & Aljadeff; Johnatan,1,0,1,0
1739705252258,BGGN 267,A04,851572,Benna; Marcus K & Aljadeff; Johnatan,1,0,1,0
1739705253366,BGGN 271,001,881551,Ackerman; Susan,9999,0,9999,0
1739705253366,BGGN 271,002,881552,Akbari; Omar Sultan,9997,0,9999,2
1739705253366,BGGN 271,003,881553,Allen; Nicola J,9998,0,9999,1
1739705253366,BGGN 271,004,881554,Alperin; Mariann,9998,0,9999,1
1739705253366,BGGN 271,005,881555,Antal; Corina Elena,9999,0,9999,0
1739705253366,BGGN 271,006,881561,Boss; Gerard R.,9998,0,9999,1
1739705253366,BGGN 271,007,881562,Bouvet; Michael,9999,0,9999,0
1739705253366,BGGN 271,008,881563,Breen; Ellen C.,9999,0,9999,0
1739705253366,BGGN 271,009,881564,Bui; Jack D,9999,0,9999,0
1739705253366,BGGN 271,010,881565,Burnett; Lindsey,9998,0,9999,1
1739705253366,BGGN 271,011,881566,Caffrey; Conor,9998,0,9999,1
1739705253366,BGGN 271,012,881567,Castle; Michael James,9998,0,9999,1
1739705253366,BGGN 271,013,881568,Chang; John Tzu-yu,9999,0,9999,0
1739705253366,BGGN 271,014,881569,Cheng; Christine Shiang-Ling,9999,0,9999,0
1739705253366,BGGN 271,015,881612,Cheresh; David A.,9997,0,9999,2
1739705253366,BGGN 271,016,881616,Cherqui; Stephanie,9999,0,9999,0
1739705253366,BGGN 271,017,881620,Chu; Hiutung,9998,0,9999,1
1739705253366,BGGN 271,018,881627,Church; Kellie Breen,9999,0,9999,0
1739705253366,BGGN 271,019,881637,Cleland; Elsa Eleanor,9998,0,9999,1
1739705253366,BGGN 271,020,881638,Croker; Ben Adam,9999,0,9999,0
1739705253366,BGGN 271,021,881639,Crotty Alexander; Laura E,9997,0,9999,2
1739705253366,BGGN 271,022,881640,Daugherty; Matthew Dorton,9999,0,9999,0
1739705253366,BGGN 271,023,881641,De Silva; Shermin,9998,0,9999,1
1739705253366,BGGN 271,024,881642,Dhar; Debanjan,9999,0,9999,0
1739705253366,BGGN 271,025,881643,Doherty; Taylor Alan,9998,0,9999,1
1739705253366,BGGN 271,026,881644,Dore; Kim Bohemie,9998,0,9999,1
1739705253366,BGGN 271,027,881645,Dulawa; Stephanie Carole,9999,0,9999,0
1739705253366,BGGN 271,028,881646,Farley; Emma Kristen,9998,0,9999,1
1739705253366,BGGN 271,029,881647,Feng; Gen-Sheng,9998,0,9999,1
1739705253366,BGGN 271,030,881648,Fisch; Kathleen Marie,9995,0,9999,4
1739705253366,BGGN 271,031,881649,George; Olivier,9998,0,9999,1
1739705253366,BGGN 271,032,881650,Ghosh; Pradipta,9998,0,9999,1
1739705253366,BGGN 271,033,881651,Glasgow; Stacey Marie,9997,0,9999,2
1739705253366,BGGN 271,034,881652,Golden; James W,9999,0,9999,0
1739705253366,BGGN 271,035,881653,Gonzalez Gamboa; Ivonne,9999,0,9999,0
1739705253366,BGGN 271,036,881654,Goren; Alon M,9999,0,9999,0
1739705253366,BGGN 271,037,881655,Guatelli; John C,9998,0,9999,1
1739705253366,BGGN 271,038,881656,Guma; Monica,9999,0,9999,0
1739705253366,BGGN 271,039,881657,Gustafsson; Asa Birgitta,9998,0,9999,1
1739705253366,BGGN 271,040,881658,Hamdoun; Amr,9999,0,9999,0
1739705253366,BGGN 271,041,881659,Hao; Nan,9999,0,9999,0
1739705253366,BGGN 271,042,881660,Hasty; Jeff M,9998,0,9999,1
1739705253366,BGGN 271,043,881661,Jiang; Qingfei,9999,0,9999,0
1739705253366,BGGN 271,044,881664,Jin; Yishi,9998,0,9999,1
1739705253366,BGGN 271,045,881665,Joiner; William J.,9999,0,9999,0
1739705253366,BGGN 271,046,881666,Joshi; Shweta,9998,0,9999,1
1739705253366,BGGN 271,047,881667,Ju; Won-Kyu,9998,0,9999,1
1739705253366,BGGN 271,048,881668,Jun; Suckjoon,9999,0,9999,0
1739705253366,BGGN 271,049,881669,Kaech; Susan Michelle,9999,0,9999,0
1739705253366,BGGN 271,050,881670,Kauffman; Alexander,9997,0,9999,2
1739705253366,BGGN 271,051,881672,Koloski; Miranda Jane,9998,0,9999,1
1739705253366,BGGN 271,052,881673,Komiyama; Takaki,9998,0,9999,1
1739705253366,BGGN 271,053,881674,Kronenberg; Mitchell E.,9999,0,9999,0
1739705253366,BGGN 271,054,881675,Kufareva; Irina,9998,0,9999,1
1739705253366,BGGN 271,055,881676,Lee; Yun Sok,9999,0,9999,0
1739705253366,BGGN 271,056,881677,Leutgeb; Stefan,9999,0,9999,0
1739705253366,BGGN 271,057,881678,Li; Willis Xiaowei,9998,0,9999,1
1739705253366,BGGN 271,058,881679,Lim; Byungkook,9999,0,9999,0
1739705253366,BGGN 271,059,881680,Lo; Stanley M.,9998,0,9999,1
1739705253366,BGGN 271,060,881681,Lopez Ramirez; Miguel Alej,9999,0,9999,0
1739705253366,BGGN 271,061,881740,Lu; Li-Fan,9999,0,9999,0
1739705253366,BGGN 271,062,881741,Lu; Pengzhe,9998,0,9999,1
1739705253366,BGGN 271,063,881743,Lyons; Deirdre Colleen,9998,0,9999,1
1739705253366,BGGN 271,064,881744,Lyumkis; Dmitry Evgenievich,9999,0,9999,0
1739705253366,BGGN 271,065,881746,McConville; Patrick James,9999,0,9999,0
1739705253366,BGGN 271,066,881749,Mertens; Jerome Stefan,9997,0,9999,2
1739705253366,BGGN 271,067,881751,Morris; Gerald P,9999,0,9999,0
1739705253366,BGGN 271,068,881752,Muroyama; Andrew David,9999,0,9999,0
1739705253366,BGGN 271,069,881757,Murre; Cornelis,9999,0,9999,0
1739705253366,BGGN 271,070,881758,Nieh; James Charles,9997,0,9999,2
1739705253366,BGGN 271,071,881759,Niwa; Maho,9999,0,9999,0
1739705253366,BGGN 271,072,881760,Parast; Mana,9999,0,9999,0
1739705253366,BGGN 271,073,881761,Perry; Michael William,9999,0,9999,0
1739705253366,BGGN 271,074,881762,Pillus; Lorraine,9998,0,9999,1
1739705253366,BGGN 271,075,881765,Pogliano; Joseph,9998,0,9999,1
1739705253366,BGGN 271,076,881767,Pruneda-Paz; Jose L.,9999,0,9999,0
1739705253366,BGGN 271,077,881768,Rana; Tariq,9999,0,9999,0
1739705253366,BGGN 271,078,881769,Rao; Anjana,9999,0,9999,0
1739705253366,BGGN 271,079,881771,Raz; Eyal,9998,0,9999,1
1739705253366,BGGN 271,080,881772,Ren; Bing,9999,0,9999,0
1739705253366,BGGN 271,081,881775,Rifkin; Scott,9998,0,9999,1
1739705253366,BGGN 271,082,881777,Risbrough; Victoria Blythe,9999,0,9999,0
1739705253366,BGGN 271,083,881778,Rose; Noah Hartmann,9999,0,9999,0
1739705253366,BGGN 271,084,881779,Saier; Milton H.,9998,0,9999,1
1739705253366,BGGN 271,085,881781,Saltiel; Alan,9997,0,9999,2
1739705253366,BGGN 271,086,881782,Sanchez-Lopez; Elsa,9998,0,9999,1
1739705253366,BGGN 271,087,881784,Schroeder; Julian I,9999,0,9999,0
1739705253366,BGGN 271,088,881794,Sebat; Lilia Mikhailovna,9998,0,9999,1
1739705253366,BGGN 271,089,881796,Sen; George L,9999,0,9999,0
1739705253366,BGGN 271,090,881797,Shaner; Nathan C.,9999,0,9999,0
1739705253366,BGGN 271,091,881804,Shurin; Jonathan,9998,0,9999,1
1739705253366,BGGN 271,092,881819,Sicklick; Jason Keith,9999,0,9999,0
1739705253366,BGGN 271,093,881908,Signer; Robert,9999,0,9999,0
1739705253366,BGGN 271,094,881909,Simonson; Tatum Sasha Summ,9999,0,9999,0
1739705253366,BGGN 271,095,881923,Steinmetz; Nicole F,9999,0,9999,0
1739705253366,BGGN 271,096,881924,Su; Chih-Ying,9999,0,9999,0
1739705253366,BGGN 271,097,881936,Telese; Francesca,9999,0,9999,0
1739705253366,BGGN 271,098,881955,Towers; Christina Garlingt,9998,0,9999,1
1739705253366,BGGN 271,099,881956,Wahlin; Karl Jonas,9997,0,9999,2
1739705253366,BGGN 271,100,882046,Webster; Nicholas J G,9998,0,9999,1
1739705253366,BGGN 271,101,882047,Weiskopf; Daniela,9999,0,9999,0
1739705253366,BGGN 271,102,882130,Welsbie; Derek,9999,0,9999,0
1739705253366,BGGN 271,103,882167,Wildonger; Jill Cathleen,9999,0,9999,0
1739705253366,BGGN 271,104,882168,Yeo; Eugene Wei-Ming,9998,0,9999,1
1739705253366,BGGN 271,105,882175,Ying; Wei,9998,0,9999,1
1739705253366,BGGN 271,106,882196,Young; Jared W.,9998,0,9999,1
1739705253366,BGGN 271,107,882235,Zage; Peter,9999,0,9999,0
1739705253366,BGGN 271,108,882236,Zengler; Karsten B,9999,0,9999,0
1739705253366,BGGN 271,109,882237,Zhang; Jin,9999,0,9999,0
1739705253366,BGGN 271,110,882238,Zhao; Yunde,9999,0,9999,0
1739705253366,BGGN 271,111,882239,Zheng; Ye,9998,0,9999,1
1739705253366,BGGN 271,112,882288,Zhou; Huilin,9999,0,9999,0
1739705253366,BGGN 271,113,882289,Zou; Yimin,9998,0,9999,1
1739705253366,BGGN 271,114,882290,Zuniga; Elina I,9999,0,9999,0
1739705254390,BGGN 273,A01,851574,Mueller; Liam O'Connor,13,0,50,37
1739705255415,BGGN 275,A00,851577,Flagg; Matthew Paul,0,0,0,5
1739705256441,BGGN 276,A00,851578,Flagg; Matthew Paul,0,0,0,5
1739705257465,BGGN 292,A00,851579,Shiau; Andrew K,35,0,35,0
1739705258494,BGGN 293,A00,851580,Wilhelm; James E.,0,0,0,5
1739705259520,BGGN 295,A00,851581,Juavinett; Ashley Lauren,0,0,30,30
1739705260546,BGJC 204,A00,851584,Lu; Li-Fan & Chang; John Tzu-yu,9991,0,9999,8
1739705261650,BGRD 200,001,883698,Ackerman; Susan,9999,0,9999,0
1739705261650,BGRD 200,002,883700,Akbari; Omar Sultan,9998,0,9999,1
1739705261650,BGRD 200,003,883710,Allen; Eric,9999,0,9999,0
1739705261650,BGRD 200,004,883736,Allen; Nicola J,9998,0,9999,1
1739705261650,BGRD 200,005,883737,Alperin; Mariann,9998,0,9999,1
1739705261650,BGRD 200,006,883765,Amaro; Rommie E,9999,0,9999,0
1739705261650,BGRD 200,007,883766,Antal; Corina Elena,9999,0,9999,0
1739705261650,BGRD 200,008,883827,Asahina; Kenta,9999,0,9999,0
1739705261650,BGRD 200,009,883879,Augustine; Vineet,9999,0,9999,0
1739705261650,BGRD 200,010,883881,Ayres; Janelle Samantha,9998,0,9999,1
1739705261650,BGRD 200,011,883883,Banghart; Matthew Ryan,9999,0,9999,0
1739705261650,BGRD 200,012,883884,Barton; Andrew David,9999,0,9999,0
1739705261650,BGRD 200,013,883886,Benna; Marcus K,9999,0,9999,0
1739705261650,BGRD 200,014,883887,Bennett; Eric J,9998,0,9999,1
1739705261650,BGRD 200,015,883888,Biering; Scott B,9999,0,9999,0
1739705261650,BGRD 200,016,883890,Bloodgood; Brenda Laurie,9999,0,9999,0
1739705261650,BGRD 200,017,883891,Boss; Gerard R.,9999,0,9999,0
1739705261650,BGRD 200,018,883893,Bouvet; Michael,9999,0,9999,0
1739705261650,BGRD 200,019,883894,Breen; Ellen C.,9999,0,9999,0
1739705261650,BGRD 200,020,883895,Briggs; Steven,9999,0,9999,0
1739705261650,BGRD 200,021,883896,Bui; Jack D,9999,0,9999,0
1739705261650,BGRD 200,022,883897,Burnett; Lindsey,9998,0,9999,1
1739705261650,BGRD 200,023,883899,Caffrey; Conor,9998,0,9999,1
1739705261650,BGRD 200,024,883908,Callaway; Edward M,9999,0,9999,0
1739705261650,BGRD 200,025,883911,Castle; Michael James,9999,0,9999,0
1739705261650,BGRD 200,026,883915,Chaim; Isaac,9998,0,9999,1
1739705261650,BGRD 200,027,883916,Chang; John Tzu-yu,9999,0,9999,0
1739705261650,BGRD 200,028,883917,Chen; Xu,9999,0,9999,0
1739705261650,BGRD 200,029,883919,Cheng; Christine Shiang-Ling,9999,0,9999,0
1739705261650,BGRD 200,030,883921,Cheresh; David A.,9997,0,9999,2
1739705261650,BGRD 200,031,883924,Cherqui; Stephanie,9999,0,9999,0
1739705261650,BGRD 200,032,883929,Chu; Hiutung,9998,0,9999,1
1739705261650,BGRD 200,033,883931,Church; Kellie Breen,9999,0,9999,0
1739705261650,BGRD 200,034,883933,Cleland; Elsa Eleanor,9998,0,9999,1
1739705261650,BGRD 200,035,883934,Cooper; Kimberly Lynn,9999,0,9999,0
1739705261650,BGRD 200,036,883935,Coufal; Nicole Gabriele,9999,0,9999,0
1739705261650,BGRD 200,037,883938,Croker; Ben Adam,9999,0,9999,0
1739705261650,BGRD 200,038,883939,Crotty Alexander; Laura E,9997,0,9999,2
1739705261650,BGRD 200,039,883940,Daugherty; Matthew Dorton,9999,0,9999,0
1739705261650,BGRD 200,040,883941,De Silva; Shermin,9998,0,9999,1
1739705261650,BGRD 200,041,883946,Desai; Arshad,9999,0,9999,0
1739705261650,BGRD 200,042,883949,Dhar; Debanjan,9999,0,9999,0
1739705261650,BGRD 200,043,883993,Dickinson; Alexandra Jazz,9999,0,9999,0
1739705261650,BGRD 200,044,884003,Dixon; Jesse,9999,0,9999,0
1739705261650,BGRD 200,045,884008,Doherty; Taylor Alan,9998,0,9999,1
1739705261650,BGRD 200,046,884028,Dore; Kim Bohemie,9998,0,9999,1
1739705261650,BGRD 200,047,884082,Dulawa; Stephanie Carole,9999,0,9999,0
1739705261650,BGRD 200,048,884084,Ecker; Joseph R,9999,0,9999,0
1739705261650,BGRD 200,049,884107,Engle; Dannielle D,9999,0,9999,0
1739705261650,BGRD 200,050,884337,Ernst; Andreas,9999,0,9999,0
1739705261650,BGRD 200,051,884338,Esko; Jeffrey D.,9999,0,9999,0
1739705261650,BGRD 200,052,884339,Farley; Emma Kristen,9998,0,9999,1
1739705261650,BGRD 200,053,884340,Feldstein; Ariel E,9999,0,9999,0
1739705261650,BGRD 200,054,884341,Feng; Gen-Sheng,9998,0,9999,1
1739705261650,BGRD 200,055,884342,Fisch; Kathleen Marie,9995,0,9999,4
1739705261650,BGRD 200,056,884343,Friedman; Rick Adam,9999,0,9999,0
1739705261650,BGRD 200,057,884344,Furnari; Frank,9999,0,9999,0
1739705261650,BGRD 200,058,884345,Gage; Fred H,9999,0,9999,0
1739705261650,BGRD 200,059,884346,George; Olivier,9998,0,9999,1
1739705261650,BGRD 200,060,884347,Ghosh; Pradipta,9998,0,9999,1
1739705261650,BGRD 200,061,884348,Glasgow; Stacey Marie,9997,0,9999,2
1739705261650,BGRD 200,062,884349,Glass; Christopher,9999,0,9999,0
1739705261650,BGRD 200,063,884350,Golden; James W,9999,0,9999,0
1739705261650,BGRD 200,064,884352,Golden; Susan S.,9999,0,9999,0
1739705261650,BGRD 200,065,884354,Gonzalez Gamboa; Ivonne,9999,0,9999,0
1739705261650,BGRD 200,066,884355,Goren; Alon M,9999,0,9999,0
1739705261650,BGRD 200,067,884356,Guatelli; John C,9998,0,9999,1
1739705261650,BGRD 200,068,884357,Guma; Monica,9999,0,9999,0
1739705261650,BGRD 200,069,884360,Gustafsson; Asa Birgitta,9998,0,9999,1
1739705261650,BGRD 200,070,884361,Gutkind; Jorge Silvio,9999,0,9999,0
1739705261650,BGRD 200,071,884362,Hamdoun; Amr,9999,0,9999,0
1739705261650,BGRD 200,072,884364,Hampton; Randolph Y.,9999,0,9999,0
1739705261650,BGRD 200,073,884367,Hao; Nan,9999,0,9999,0
1739705261650,BGRD 200,074,884368,Hargreaves; Diana Clare,9999,0,9999,0
1739705261650,BGRD 200,075,884369,Hasty; Jeff M,9998,0,9999,1
1739705261650,BGRD 200,076,884370,Hollern; Daniel Patrick,9999,0,9999,0
1739705261650,BGRD 200,077,884372,Holway; David A.,9999,0,9999,0
1739705261650,BGRD 200,078,884374,Huffaker; Alisa,9999,0,9999,0
1739705261650,BGRD 200,079,884375,Hui; Enfu,9999,0,9999,0
1739705261650,BGRD 200,080,884376,Hwa; Terence T.,9999,0,9999,0
1739705261650,BGRD 200,081,884377,Ideker; Trey,9999,0,9999,0
1739705261650,BGRD 200,082,884378,Jackrel; Sara,9998,0,9999,1
1739705261650,BGRD 200,083,884380,Jiang; Qingfei,9999,0,9999,0
1739705261650,BGRD 200,084,884382,Jin; Yishi,9998,0,9999,1
1739705261650,BGRD 200,085,884384,Joiner; William J.,9999,0,9999,0
1739705261650,BGRD 200,086,884385,Joshi; Shweta,9998,0,9999,1
1739705261650,BGRD 200,087,884386,Ju; Won-Kyu,9998,0,9999,1
1739705261650,BGRD 200,088,884387,Jun; Suckjoon,9999,0,9999,0
1739705261650,BGRD 200,089,884388,Kadonaga; James T,9999,0,9999,0
1739705261650,BGRD 200,090,884389,Kaech; Susan Michelle,9999,0,9999,0
1739705261650,BGRD 200,091,884391,Kauffman; Alexander,9997,0,9999,2
1739705261650,BGRD 200,092,884392,Kleinfeld; David,9999,0,9999,0
1739705261650,BGRD 200,093,884393,Knight; Robin,9999,0,9999,0
1739705261650,BGRD 200,094,884394,Koloski; Miranda Jane,9998,0,9999,1
1739705261650,BGRD 200,095,884395,Komiyama; Takaki,9998,0,9999,1
1739705261650,BGRD 200,096,884396,Kosuri; Pallav,9999,0,9999,0
1739705261650,BGRD 200,097,884397,Kronenberg; Mitchell E.,9999,0,9999,0
1739705261650,BGRD 200,099,884400,Kryazhimskiy; Sergey A,9999,0,9999,0
1739705261650,BGRD 200,100,884401,Kufareva; Irina,9998,0,9999,1
1739705261650,BGRD 200,101,884402,Lee; Kuo Fen,9999,0,9999,0
1739705261650,BGRD 200,102,884403,Lee; Yun Sok,9999,0,9999,0
1739705261650,BGRD 200,103,884404,Leutgeb; Jill K.,9999,0,9999,0
1739705261650,BGRD 200,104,884405,Leutgeb; Stefan,9999,0,9999,0
1739705261650,BGRD 200,105,884406,Li; Willis Xiaowei,9998,0,9999,1
1739705261650,BGRD 200,106,884407,Lim; Byungkook,9998,0,9999,1
1739705261650,BGRD 200,107,884410,Lo; Stanley M.,9998,0,9999,1
1739705261650,BGRD 200,108,884414,Looger; Loren Lee,9999,0,9999,0
1739705261650,BGRD 200,109,884415,Lopez Ramirez; Miguel Alej,9999,0,9999,0
1739705261650,BGRD 200,110,884416,Lovett-Barron; Matthew Rod,9999,0,9999,0
1739705261650,BGRD 200,111,884418,Lu; Li-Fan,9998,0,9999,1
1739705261650,BGRD 200,112,884419,Lu; Pengzhe,9998,0,9999,1
1739705261650,BGRD 200,113,884421,Lykke-Andersen; Jens,9999,0,9999,0
1739705261650,BGRD 200,114,884423,Lyons; Deirdre Colleen,9998,0,9999,1
1739705261650,BGRD 200,115,884424,Lyumkis; Dmitry Evgenievich,9999,0,9999,0
1739705261650,BGRD 200,116,884425,Manor; Uri,9999,0,9999,0
1739705261650,BGRD 200,117,884426,Mayfield; Stephen P.,9998,0,9999,1
1739705261650,BGRD 200,118,884427,McConville; Patrick James,9999,0,9999,0
1739705261650,BGRD 200,119,884428,McDonnell; Lisa Marie,9999,0,9999,0
1739705261650,BGRD 200,120,884429,Mertens; Jerome Stefan,9997,0,9999,2
1739705261650,BGRD 200,121,884430,Meyer; Justin Raymond,9999,0,9999,0
1739705261650,BGRD 200,122,884431,Morris; Gerald P,9999,0,9999,0
1739705261650,BGRD 200,123,884432,Mueller; Lena,9999,0,9999,0
1739705261650,BGRD 200,124,884433,Muotri; Alysson,9999,0,9999,0
1739705261650,BGRD 200,125,884434,Muroyama; Andrew David,9997,0,9999,2
1739705261650,BGRD 200,126,884435,Murre; Cornelis,9999,0,9999,0
1739705261650,BGRD 200,127,884436,Neal; Sonya E,9999,0,9999,0
1739705261650,BGRD 200,128,884438,Nieh; James Charles,9997,0,9999,2
1739705261650,BGRD 200,129,884441,Nimmerjahn; Axel,9999,0,9999,0
1739705261650,BGRD 200,130,884444,Niwa; Maho,9999,0,9999,0
1739705261650,BGRD 200,131,884445,Nizet; Victor F.,9998,0,9999,1
1739705261650,BGRD 200,132,884446,Oegema; Karen,9999,0,9999,0
1739705261650,BGRD 200,133,884447,Panda; Satchidananda,9999,0,9999,0
1739705261650,BGRD 200,134,884448,Parast; Mana,9999,0,9999,0
1739705261650,BGRD 200,135,884449,Pasquinelli; Amy,9998,0,9999,1
1739705261650,BGRD 200,136,884450,Pekkurnaz Banghart; Gulcin,9999,0,9999,0
1739705261650,BGRD 200,137,884451,Perry; Michael William,9999,0,9999,0
1739705261650,BGRD 200,138,884452,Pillus; Lorraine,9998,0,9999,1
1739705261650,BGRD 200,139,884454,Pogliano; Joseph,9998,0,9999,1
1739705261650,BGRD 200,140,884456,Pogliano; Kit J.,9999,0,9999,0
1739705261650,BGRD 200,141,884457,Pride; David Tevis,9999,0,9999,0
1739705261650,BGRD 200,142,884458,Pruneda-Paz; Jose L.,9999,0,9999,0
1739705261650,BGRD 200,143,884459,Ramanan; Deepshika,9998,0,9999,1
1739705261650,BGRD 200,144,884460,Rana; Tariq,9999,0,9999,0
1739705261650,BGRD 200,145,884461,Rao; Anjana,9999,0,9999,0
1739705261650,BGRD 200,146,884462,Raz; Eyal,9998,0,9999,1
1739705261650,BGRD 200,147,884464,Reck-Peterson; Samara L,9999,0,9999,0
1739705261650,BGRD 200,148,884468,Ren; Bing,9999,0,9999,0
1739705261650,BGRD 200,149,884469,Rennison; Diana,9999,0,9999,0
1739705261650,BGRD 200,150,884471,Reyes De Barboza; Nabora S,9999,0,9999,0
1739705261650,BGRD 200,151,884472,Rifkin; Scott,9998,0,9999,1
1739705261650,BGRD 200,152,884482,Risbrough; Victoria Blythe,9999,0,9999,0
1739705261650,BGRD 200,153,884484,Rivera; Fabian Chavez,9999,0,9999,0
1739705261650,BGRD 200,154,884486,Rohner; Patrick Thomas,9999,0,9999,0
1739705261650,BGRD 200,155,884488,Rose; Noah Hartmann,9999,0,9999,0
1739705261650,BGRD 200,156,884491,Rosenfeld; Michael G,9999,0,9999,0
1739705261650,BGRD 200,157,884493,Russell; Alistair B,9999,0,9999,0
1739705261650,BGRD 200,158,884494,Saier; Milton H.,9998,0,9999,1
1739705261650,BGRD 200,159,884496,Saltiel; Alan,9997,0,9999,2
1739705261650,BGRD 200,160,884498,Sanchez-Lopez; Elsa,9999,0,9999,0
1739705261650,BGRD 200,161,884502,Saphire; Erica Ollmann,9999,0,9999,0
1739705261650,BGRD 200,162,884504,Schroeder; Julian I,9999,0,9999,0
1739705261650,BGRD 200,163,884508,Sebat; Lilia Mikhailovna,9998,0,9999,1
1739705261650,BGRD 200,164,884510,Sen; George L,9999,0,9999,0
1739705261650,BGRD 200,165,884513,Shah; Sameer B,9999,0,9999,0
1739705261650,BGRD 200,166,884515,Shaner; Nathan C.,9999,0,9999,0
1739705261650,BGRD 200,167,884517,Sharpee; Tatyana,9999,0,9999,0
1739705261650,BGRD 200,168,884519,Shaw; Reuben,9998,0,9999,1
1739705261650,BGRD 200,169,884522,Shurin; Jonathan,9998,0,9999,1
1739705261650,BGRD 200,170,884524,Sicklick; Jason Keith,9999,0,9999,0
1739705261650,BGRD 200,171,884526,Signer; Robert,9999,0,9999,0
1739705261650,BGRD 200,172,884530,Simonson; Tatum Sasha Summ,9999,0,9999,0
1739705261650,BGRD 200,173,884533,Soncin; Francesca,9999,0,9999,0
1739705261650,BGRD 200,174,884535,Steinmetz; Nicole F,9999,0,9999,0
1739705261650,BGRD 200,175,884536,Su; Chih-Ying,9999,0,9999,0
1739705261650,BGRD 200,176,884537,Suel; Gurol Mehmet,9999,0,9999,0
1739705261650,BGRD 200,177,884538,Sun; Xin,9999,0,9999,0
1739705261650,BGRD 200,178,884540,Telese; Francesca,9999,0,9999,0
1739705261650,BGRD 200,179,884543,Towers; Christina Garlingt,9998,0,9999,1
1739705261650,BGRD 200,180,884544,Traver; David,9999,0,9999,0
1739705261650,BGRD 200,181,884545,Troemel; Emily Ruth,9999,0,9999,0
1739705261650,BGRD 200,182,884546,Valdez-Jasso; Daniela,9999,0,9999,0
1739705261650,BGRD 200,183,884549,Vijayanand; Pandurangan,9999,0,9999,0
1739705261650,BGRD 200,184,884552,Villa Rodriguez; Elizabeth,9999,0,9999,0
1739705261650,BGRD 200,185,884553,Wahlin; Karl Jonas,9997,0,9999,2
1739705261650,BGRD 200,186,884555,Wang; Jean Yin Jen,9998,0,9999,1
1739705261650,BGRD 200,187,884556,Webster; Nicholas J G,9998,0,9999,1
1739705261650,BGRD 200,188,884557,Welsbie; Derek,9999,0,9999,0
1739705261650,BGRD 200,189,884600,Wildonger; Jill Cathleen,9998,0,9999,1
1739705261650,BGRD 200,190,884644,Winzeler; Elizabeth A,9998,0,9999,1
1739705261650,BGRD 200,191,884686,Yaksh; Tony L.,9999,0,9999,0
1739705261650,BGRD 200,192,884695,Yelon; Deborah,9999,0,9999,0
1739705261650,BGRD 200,193,884698,Yeo; Eugene Wei-Ming,9998,0,9999,1
1739705261650,BGRD 200,194,884706,Ying; Wei,9998,0,9999,1
1739705261650,BGRD 200,195,884707,Young; Jared W.,9998,0,9999,1
1739705261650,BGRD 200,196,884737,Zage; Peter,9999,0,9999,0
1739705261650,BGRD 200,197,884740,Zengler; Karsten B,9999,0,9999,0
1739705261650,BGRD 200,198,884749,Zhang; Dong-Er,9999,0,9999,0
1739705261650,BGRD 200,199,884750,Zhang; Jin,9999,0,9999,0
1739705261650,BGRD 200,200,884751,Zhao; Yunde,9999,0,9999,0
1739705261650,BGRD 200,201,884766,Zheng; Binhai,9999,0,9999,0
1739705261650,BGRD 200,202,884774,Zheng; Ye,9998,0,9999,1
1739705261650,BGRD 200,203,884849,Zhou; Huilin,9999,0,9999,0
1739705261650,BGRD 200,204,884894,Zou; Yimin,9998,0,9999,1
1739705261650,BGRD 200,205,884895,Zuniga; Elina I,9999,0,9999,0
1739705262677,BGSE 200,A00,851586,Tour; Ella & Petrie; Katherine Lynn,9989,0,9999,10
1739705263704,BGSE 205,A00,851588,Bennett; Eric J,46,0,50,4
1739705263704,BGSE 205,C00,851589,Bennett; Eric J,43,0,50,7
1739705263704,BGSE 205,D00,851590,Bennett; Eric J,48,0,50,2
1739705263704,BGSE 205,E00,851591,Bennett; Eric J,49,0,50,1
1739705264729,BIBC 102,A01,864157,Hampton; Randolph Y.,48,0,73,25
1739705264729,BIBC 102,A02,864159,Hampton; Randolph Y.,66,0,73,7
1739705264729,BIBC 102,A03,864171,Hampton; Randolph Y.,69,0,73,4
1739705264729,BIBC 102,A04,864227,Hampton; Randolph Y.,63,0,73,10
1739705265756,BIBC 103,A01,850483,Coleman; Aaron B.,19,0,24,5
1739705265756,BIBC 103,A02,850484,Coleman; Aaron B.,24,0,24,0
1739705265756,BIBC 103,B01,850487,Coleman; Aaron B.,21,0,24,3
1739705265756,BIBC 103,B02,850489,Coleman; Aaron B.,24,0,24,0
1739705265756,BIBC 103,C01,850492,Burg; Michael,15,0,24,9
1739705265756,BIBC 103,C02,850493,Burg; Michael,23,0,24,1
1739705266786,BIBC 104,A01,850495,Zhao; Yunde,49,0,50,1
1739705266786,BIBC 104,A02,850496,Zhao; Yunde,50,0,50,0
1739705266786,BIBC 104,A03,850500,Zhao; Yunde,48,0,50,2
1739705266786,BIBC 104,A04,850501,Zhao; Yunde,48,0,50,2
1739705267817,BIBC 194,A00,850502,Ernst; Andreas,20,0,32,12
1739705267817,BIBC 194,B00,850503,Saier; Milton H.,21,0,32,11
1739705268848,BICD 100,A01,864248,Biering; Scott B,70,0,73,3
1739705268848,BICD 100,A02,864249,Biering; Scott B,72,0,73,1
1739705268848,BICD 100,A03,864274,Biering; Scott B,73,0,73,0
1739705268848,BICD 100,A04,864287,Biering; Scott B,70,0,73,3
1739705268848,BICD 100,B01,864290,Reinagel; Pam,70,0,73,3
1739705268848,BICD 100,B02,864291,Reinagel; Pam,72,0,73,1
1739705268848,BICD 100,B03,864294,Reinagel; Pam,72,0,73,1
1739705268848,BICD 100,B04,864299,Reinagel; Pam,73,0,73,0
1739705268848,BICD 100,C01,864303,Nguyen; Vu Quang,72,0,73,1
1739705268848,BICD 100,C02,864314,Nguyen; Vu Quang,71,0,73,2
1739705268848,BICD 100,C03,864347,Nguyen; Vu Quang,72,0,73,1
1739705268848,BICD 100,C04,864362,Nguyen; Vu Quang,73,0,73,0
1739705269873,BICD 110,A01,850512,Ernst; Andreas,42,0,73,31
1739705269873,BICD 110,A02,850513,Ernst; Andreas,53,0,73,20
1739705269873,BICD 110,A03,850516,Ernst; Andreas,61,0,73,12
1739705269873,BICD 110,A04,850518,Ernst; Andreas,53,0,73,20
1739705270901,BICD 123,A01,850521,Zhao; Yunde,29,0,36,7
1739705271926,BICD 140,A01,850561,Lu; Li-Fan,50,0,61,11
1739705271926,BICD 140,A02,850563,Lu; Li-Fan,57,0,61,4
1739705271926,BICD 140,A03,850569,Lu; Li-Fan,57,0,61,4
1739705271926,BICD 140,A04,850577,Lu; Li-Fan,60,0,62,2
1739705272951,BICD 158,A01,850601,Bier; Ethan,30,0,36,6
1739705272951,BICD 158,A02,850644,Bier; Ethan,32,0,36,4
1739705272951,BICD 158,A03,850655,Bier; Ethan,33,0,36,3
1739705272951,BICD 158,A04,850656,Bier; Ethan,36,0,37,1
1739705273979,BIEB 121,A00,850668,Butler; Shannon Rhey,25,0,32,7
1739705273979,BIEB 121,B00,850674,Butler; Shannon Rhey,21,0,32,11
1739705275005,BIEB 146,A01,850680,Petrie; Katherine Lynn,91,0,99,8
1739705275005,BIEB 146,A02,850682,Petrie; Katherine Lynn,81,0,99,18
1739705275005,BIEB 146,A03,850684,Petrie; Katherine Lynn,95,0,99,4
1739705275005,BIEB 146,A04,850687,Petrie; Katherine Lynn,94,0,98,4
1739705276035,BIEB 148,A01,850691,Rose; Noah Hartmann,25,0,36,11
1739705276035,BIEB 148,A02,850706,Rose; Noah Hartmann,33,0,36,3
1739705276035,BIEB 148,A03,850778,Rose; Noah Hartmann,34,0,36,2
1739705276035,BIEB 148,A04,850779,Rose; Noah Hartmann,24,0,36,12
1739705277066,BIEB 152,A01,850784,Wodarz; Dominik Franz Xave,70,0,75,5
1739705277066,BIEB 152,A02,850785,Wodarz; Dominik Franz Xave,73,0,75,2
1739705277066,BIEB 152,A03,850786,Wodarz; Dominik Franz Xave,69,0,75,6
1739705277066,BIEB 152,A04,850789,Wodarz; Dominik Franz Xave,67,0,75,8
1739705278103,BIEB 154,A01,850792,Stockwell; Sarah R,15,0,15,0
1739705278103,BIEB 154,A02,850795,Stockwell; Sarah R,14,0,15,1
1739705278103,BIEB 154,A03,850796,Stockwell; Sarah R,13,0,15,2
1739705278103,BIEB 154,A04,850854,Stockwell; Sarah R,15,0,15,0
1739705279128,BIEB 159,A00,850856,Jackrel; Sara,33,0,36,3
1739705280157,BIEB 164,A01,850859,De Silva; Shermin,47,0,50,3
1739705280157,BIEB 164,A02,850862,De Silva; Shermin,41,0,50,9
1739705280157,BIEB 164,A03,850863,De Silva; Shermin,45,0,50,5
1739705280157,BIEB 164,A04,850865,De Silva; Shermin,45,0,50,5
1739705281243,BILD 1,A01,860138,Patrick; Gentry,62,0,62,0
1739705281243,BILD 1,A02,860253,Patrick; Gentry,61,0,62,1
1739705281243,BILD 1,A03,860277,Patrick; Gentry,61,0,62,1
1739705281243,BILD 1,A04,860281,Patrick; Gentry,61,0,64,3
1739705281243,BILD 1,B01,860381,Gonzalez Gamboa; Ivonne,51,0,62,11
1739705281243,BILD 1,B02,860382,Gonzalez Gamboa; Ivonne,61,0,62,1
1739705281243,BILD 1,B03,860383,Gonzalez Gamboa; Ivonne,59,0,62,3
1739705281243,BILD 1,B04,860384,Gonzalez Gamboa; Ivonne,63,0,64,1
1739705281243,BILD 1,C01,860385,Cooper; Andrew Michael,61,0,62,1
1739705281243,BILD 1,C02,860386,Cooper; Andrew Michael,59,0,62,3
1739705281243,BILD 1,C03,860387,Cooper; Andrew Michael,62,0,62,0
1739705281243,BILD 1,C04,860388,Cooper; Andrew Michael,64,0,64,0
1739705282268,BILD 2,A01,860389,Reyes Gonzalez; Catalina,87,0,99,12
1739705282268,BILD 2,A02,860390,Reyes Gonzalez; Catalina,96,0,99,3
1739705282268,BILD 2,A03,860391,Reyes Gonzalez; Catalina,99,0,99,0
1739705282268,BILD 2,A04,860392,Reyes Gonzalez; Catalina,98,0,98,0
1739705283294,BILD 3,A01,860393,Stockwell; Sarah R,68,0,70,2
1739705283294,BILD 3,A02,860394,Stockwell; Sarah R,65,0,70,5
1739705283294,BILD 3,A03,860395,Stockwell; Sarah R,69,0,70,1
1739705283294,BILD 3,A04,860396,Stockwell; Sarah R,66,0,68,2
1739705283294,BILD 3,B01,860397,Hammond; LaTisha Marie,48,0,63,15
1739705283294,BILD 3,B02,860398,Hammond; LaTisha Marie,54,0,60,6
1739705283294,BILD 3,B03,860399,Hammond; LaTisha Marie,57,0,60,3
1739705283294,BILD 3,B04,860400,Hammond; LaTisha Marie,60,0,62,2
1739705283294,BILD 3,C01,860401,Hammond; LaTisha Marie,60,0,62,2
1739705283294,BILD 3,C02,860402,Hammond; LaTisha Marie,58,0,63,5
1739705283294,BILD 3,C03,860403,Hammond; LaTisha Marie,59,0,60,1
1739705283294,BILD 3,C04,860404,Hammond; LaTisha Marie,60,0,60,0
1739705284322,BILD 4,A01,850172,Ochoa Mikrut; Stacy Daniel,22,0,24,2
1739705284322,BILD 4,A02,850250,Ochoa Mikrut; Stacy Daniel,24,0,24,0
1739705284322,BILD 4,A03,850251,Ochoa Mikrut; Stacy Daniel,22,0,24,2
1739705284322,BILD 4,A04,850252,Ochoa Mikrut; Stacy Daniel,23,0,24,1
1739705284322,BILD 4,A05,850253,Ochoa Mikrut; Stacy Daniel,24,0,24,0
1739705284322,BILD 4,A06,850254,Ochoa Mikrut; Stacy Daniel,24,0,24,0
1739705284322,BILD 4,A07,850255,Ochoa Mikrut; Stacy Daniel,24,0,24,0
1739705284322,BILD 4,A08,850257,Ochoa Mikrut; Stacy Daniel,23,0,24,1
1739705284322,BILD 4,B01,850259,Reuther; Keefe,18,0,24,6
1739705284322,BILD 4,B02,850260,Reuther; Keefe,22,0,24,2
1739705284322,BILD 4,B03,850261,Reuther; Keefe,24,0,24,0
1739705284322,BILD 4,B04,850263,Reuther; Keefe,22,0,24,2
1739705284322,BILD 4,B05,850264,Reuther; Keefe,23,0,24,1
1739705284322,BILD 4,B06,850265,Reuther; Keefe,24,0,24,0
1739705284322,BILD 4,B07,850266,Reuther; Keefe,24,0,24,0
1739705284322,BILD 4,B08,850267,Reuther; Keefe,24,0,24,0
1739705284322,BILD 4,C01,850269,Gonzalez Gamboa; Ivonne,19,0,24,5
1739705284322,BILD 4,C02,850270,Gonzalez Gamboa; Ivonne,24,0,24,0
1739705284322,BILD 4,C03,850271,Gonzalez Gamboa; Ivonne,24,0,24,0
1739705284322,BILD 4,C04,850273,Gonzalez Gamboa; Ivonne,24,0,24,0
1739705284322,BILD 4,C05,850283,Gonzalez Gamboa; Ivonne,23,0,24,1
1739705284322,BILD 4,C06,850329,Gonzalez Gamboa; Ivonne,23,0,24,1
1739705284322,BILD 4,C07,850331,Gonzalez Gamboa; Ivonne,24,0,24,0
1739705284322,BILD 4,C08,850336,Gonzalez Gamboa; Ivonne,23,0,24,1
1739705285348,BILD 5,A01,860586,Reuther; Keefe,63,0,65,2
1739705285348,BILD 5,A02,860597,Reuther; Keefe,62,0,65,3
1739705285348,BILD 5,A03,860600,Reuther; Keefe,65,0,65,0
1739705285348,BILD 5,A04,860672,Reuther; Keefe,64,0,65,1
1739705285348,BILD 5,B01,860673,Yang; Mingyu,65,0,65,0
1739705285348,BILD 5,B02,860681,Yang; Mingyu,64,0,65,1
1739705285348,BILD 5,B03,860686,Yang; Mingyu,65,0,65,0
1739705285348,BILD 5,B04,860687,Yang; Mingyu,65,0,65,0
1739705285348,BILD 5,C01,860694,Day; Christopher D,62,0,65,3
1739705285348,BILD 5,C02,860697,Day; Christopher D,65,0,65,0
1739705285348,BILD 5,C03,860709,Day; Christopher D,63,0,65,2
1739705285348,BILD 5,C04,860714,Day; Christopher D,65,0,65,0
1739705286373,BILD 30,A01,850343,Madigan; Cressida Ariana,28,0,28,0
1739705286373,BILD 30,A02,850344,Madigan; Cressida Ariana,28,0,28,0
1739705286373,BILD 30,A03,850345,Madigan; Cressida Ariana,26,0,28,2
1739705286373,BILD 30,A04,850349,Madigan; Cressida Ariana,30,0,31,1
1739705287402,BILD 88,A00,850480,Kurle; Carolyn M.,20,0,20,0
1739705288426,BIMM 100,A01,860726,Farley; Emma Kristen,35,0,48,13
1739705288426,BIMM 100,A02,860737,Farley; Emma Kristen,43,0,48,5
1739705288426,BIMM 100,A03,860771,Farley; Emma Kristen,46,0,48,2
1739705288426,BIMM 100,A04,860812,Farley; Emma Kristen,45,0,48,3
1739705288426,BIMM 100,B01,860817,Wildonger; Jill Cathleen,35,0,48,13
1739705288426,BIMM 100,B02,860838,Wildonger; Jill Cathleen,38,0,48,10
1739705288426,BIMM 100,B03,860839,Wildonger; Jill Cathleen,44,0,48,4
1739705288426,BIMM 100,B04,860840,Wildonger; Jill Cathleen,46,0,48,2
1739705289458,BIMM 101,A01,850871,Meaders; Clara Leigh,0,0,24,24
1739705289458,BIMM 101,A02,850872,Meaders; Clara Leigh,1,0,24,23
1739705289458,BIMM 101,B01,850876,Day; Christopher D,23,0,24,1
1739705289458,BIMM 101,B02,850877,Day; Christopher D,22,0,24,2
1739705289458,BIMM 101,C01,850880,Cooper; Andrew Michael,17,0,24,7
1739705289458,BIMM 101,C02,850887,Cooper; Andrew Michael,22,0,24,2
1739705289458,BIMM 101,D01,850890,Grossman; Emily N,19,0,24,5
1739705289458,BIMM 101,D02,850894,Grossman; Emily N,20,0,24,4
1739705289458,BIMM 101,E01,850897,Grossman; Emily N,19,0,24,5
1739705289458,BIMM 101,E02,850900,Grossman; Emily N,22,0,24,2
1739705289458,BIMM 101,F01,850906,Rusert; Jessica Marie,21,0,24,3
1739705289458,BIMM 101,F02,850910,Rusert; Jessica Marie,24,0,24,0
1739705289458,BIMM 101,G01,850920,Rusert; Jessica Marie,20,0,24,4
1739705289458,BIMM 101,G02,850921,Rusert; Jessica Marie,24,0,24,0
1739705290487,BIMM 118,A01,850923,David; Michael,25,0,29,4
1739705290487,BIMM 118,A02,850926,David; Michael,27,0,29,2
1739705290487,BIMM 118,A03,850927,David; Michael,25,0,29,4
1739705290487,BIMM 118,A04,850928,David; Michael,27,0,28,1
1739705291513,BIMM 120,A01,850932,Saier; Milton H.,78,0,87,9
1739705291513,BIMM 120,A02,850934,Saier; Milton H.,71,0,87,16
1739705291513,BIMM 120,A03,850986,Saier; Milton H.,81,0,87,6
1739705291513,BIMM 120,A04,851000,Saier; Milton H.,84,0,87,3
1739705292544,BIMM 121,A01,851020,Gustafson-Brown; Cindy,18,0,24,6
1739705292544,BIMM 121,A02,851023,Gustafson-Brown; Cindy,23,0,24,1
1739705292544,BIMM 121,B01,851032,Gustafson-Brown; Cindy,15,0,24,9
1739705292544,BIMM 121,B02,851058,Gustafson-Brown; Cindy,19,0,24,5
1739705292544,BIMM 121,C01,851077,Staff,2,0,24,22
1739705292544,BIMM 121,C02,851081,Staff,19,0,24,5
1739705292544,BIMM 121,D01,851152,Staff,15,0,24,9
1739705292544,BIMM 121,D02,851169,Staff,23,0,24,1
1739705293570,BIMM 134,A01,851210,Burg; Michael,94,0,103,9
1739705293570,BIMM 134,A02,851211,Burg; Michael,93,0,103,10
1739705293570,BIMM 134,A03,851212,Burg; Michael,93,0,103,10
1739705293570,BIMM 134,A04,851213,Burg; Michael,96,0,101,5
1739705294596,BIMM 143,A01,851215,Grant; Barry J,28,0,40,12
1739705294596,BIMM 143,B01,851218,Bozinovic; Goran,38,0,40,2
1739705294596,BIMM 143,C01,851220,Bozinovic; Goran,40,0,40,0
1739705295626,BIMM 182,A01,851597,Bafna; Vineet,31,0,50,19
1739705296654,BIMM 194,A00,851222,Russell; Alistair B,23,0,32,9
1739705297679,BIOM 202,A01,806511,Sheikh; Farah,21,0,40,19
1739705298703,BIOM 218,A00,806606,Gagneux; Pascal,10,0,12,2
1739705299727,BIOM 219,A00,806612,Ross; Camille,1,0,1,0
1739705300755,BIOM 222,A00,872553,Esko; Jeffrey D.,0,0,0,0
1739705301782,BIOM 229,A00,806613,Gagneux; Pascal,12,0,12,0
1739705302807,BIOM 231,A00,881485,Daneman; Richard & Newton; Alexandra C.,0,0,0,0
1739705302807,BIOM 231,B00,881487,Staff,0,0,0,0
1739705302807,BIOM 231,C00,881488,Schoeneberg; Johannes,0,0,0,0
1739705303835,BIOM 234,A00,881480,Newton; Alexandra C.,0,0,0,0
1739705304863,BIOM 242,A00,806624,Hamilton; Bruce Alan,0,0,0,0
1739705305888,BIOM 246,A00,872559,Gordts; Philip & Lewis; Amanda Lark & Godula; Kamil & Gagneux; Pascal & Esko; Jeffrey D. & Bode; Lars,0,0,0,0
1739705306915,BIOM 252,A00,806625,Ayyagari; Radha,7,0,20,13
1739705307940,BIOM 283,A00,806628,Ghassemian; Majid,0,0,0,0
1739705308965,BIOM 295,A00,806638,Joiner; William J.,0,0,0,0
1739705310001,BIPN 100,A01,860405,Augustine; Vineet,32,0,36,4
1739705310001,BIPN 100,A02,860406,Augustine; Vineet,35,0,36,1
1739705310001,BIPN 100,A03,860407,Augustine; Vineet,35,0,36,1
1739705310001,BIPN 100,A04,860408,Augustine; Vineet,36,0,37,1
1739705310001,BIPN 100,B01,860409,George; Monique Leana,27,0,36,9
1739705310001,BIPN 100,B02,860410,George; Monique Leana,33,0,36,3
1739705310001,BIPN 100,B03,860411,George; Monique Leana,31,0,36,5
1739705310001,BIPN 100,B04,860412,George; Monique Leana,31,0,37,6
1739705310001,BIPN 100,C01,860413,Maita; Isabella Vincenza,36,0,36,0
1739705310001,BIPN 100,C02,860414,Maita; Isabella Vincenza,35,0,36,1
1739705310001,BIPN 100,C03,860415,Maita; Isabella Vincenza,33,0,36,3
1739705310001,BIPN 100,C04,860416,Maita; Isabella Vincenza,36,0,37,1
1739705310001,BIPN 100,D01,860417,Marino; Marc J,47,0,50,3
1739705310001,BIPN 100,D02,860418,Marino; Marc J,48,0,50,2
1739705310001,BIPN 100,D03,860419,Marino; Marc J,48,0,50,2
1739705310001,BIPN 100,D04,860420,Marino; Marc J,50,0,50,0
1739705310001,BIPN 100,E01,860421,Yang; Mingyu,36,0,36,0
1739705310001,BIPN 100,E02,860422,Yang; Mingyu,34,0,36,2
1739705310001,BIPN 100,E03,860423,Yang; Mingyu,36,0,36,0
1739705310001,BIPN 100,E04,860424,Yang; Mingyu,37,0,37,0
1739705311027,BIPN 102,A01,851476,Reyes Gonzalez; Catalina,45,0,54,9
1739705311027,BIPN 102,A02,851477,Reyes Gonzalez; Catalina,48,0,54,6
1739705311027,BIPN 102,A03,851478,Reyes Gonzalez; Catalina,53,0,54,1
1739705311027,BIPN 102,A04,851479,Reyes Gonzalez; Catalina,51,0,54,3
1739705312053,BIPN 105,A01,851482,Armour; Jon Christopher,13,0,21,8
1739705312053,BIPN 105,A02,851483,Armour; Jon Christopher,20,0,21,1
1739705312053,BIPN 105,B01,851487,Armour; Jon Christopher,10,0,21,11
1739705312053,BIPN 105,B02,851488,Armour; Jon Christopher,20,0,21,1
1739705313083,BIPN 140,A01,851492,Owens; Melinda Tsao-Ying,37,0,40,3
1739705313083,BIPN 140,A02,851493,Owens; Melinda Tsao-Ying,38,0,40,2
1739705313083,BIPN 140,A03,851494,Owens; Melinda Tsao-Ying,39,0,40,1
1739705313083,BIPN 140,A04,851495,Owens; Melinda Tsao-Ying,32,0,38,6
1739705314111,BIPN 144,A01,851498,Zou; Yimin,35,0,40,5
1739705314111,BIPN 144,A02,851499,Zou; Yimin,35,0,40,5
1739705314111,BIPN 144,A03,851500,Zou; Yimin,40,0,40,0
1739705314111,BIPN 144,A04,851501,Zou; Yimin,37,0,38,1
1739705315141,BIPN 145,A01,851505,Maita; Isabella Vincenza,33,0,42,9
1739705315141,BIPN 145,B01,851507,Juavinett; Ashley Lauren,36,0,42,6
1739705315141,BIPN 145,C01,851512,Marino; Marc J,34,0,42,8
1739705316167,BIPN 147,A01,851516,Sejnowski; Terrence J,5,0,16,11
1739705316167,BIPN 147,A02,851517,Sejnowski; Terrence J,16,0,16,0
1739705316167,BIPN 147,A03,851520,Sejnowski; Terrence J,13,0,16,3
1739705316167,BIPN 147,A04,851521,Sejnowski; Terrence J,14,0,16,2
1739705317196,BIPN 152,A01,860841,Halpain; Shelley,32,0,44,12
1739705317196,BIPN 152,A02,860842,Halpain; Shelley,43,0,44,1
1739705317196,BIPN 152,A03,860843,Halpain; Shelley,42,0,44,2
1739705317196,BIPN 152,A04,860844,Halpain; Shelley,40,0,43,3
1739705318222,BIPN 162,A01,851524,Aoi; Mikio C,7,0,8,1
1739705318222,BIPN 162,A02,851525,Aoi; Mikio C,7,0,8,1
1739705318222,BIPN 162,A03,851527,Aoi; Mikio C,6,0,8,2
1739705318222,BIPN 162,A04,851529,Aoi; Mikio C,6,0,6,0
1739705319251,BIPN 164,A01,851531,Benna; Marcus K & Aljadeff; Johnatan,13,0,14,1
1739705319251,BIPN 164,A02,851532,Benna; Marcus K & Aljadeff; Johnatan,13,0,14,1
1739705319251,BIPN 164,A03,851533,Benna; Marcus K & Aljadeff; Johnatan,13,0,14,1
1739705319251,BIPN 164,A04,851535,Benna; Marcus K & Aljadeff; Johnatan,12,0,12,0
1739705320280,BIPN 194,A00,851536,Glasgow; Stacey Marie,29,0,32,3
1739705320280,BIPN 194,B00,851537,Augustine; Vineet,28,0,32,4
1739705320280,BIPN 194,C00,851539,Reinagel; Pam,31,0,32,1
1739705321305,BISP 170,A00,851540,French; Kathleen Ann,28,0,30,2
1739705322329,BISP 182,A00,869152,Pogliano; Joseph,9999,0,9999,0
1739705323356,BISP 194,A00,851542,Greenspan; Ralph J.,10,0,32,22
1739705323356,BISP 194,B00,851543,Nguyen; Vu Quang,25,0,32,7
1739705323356,BISP 194,C00,869153,Patrick; Gentry,23,0,32,9
1739705324382,BNFO 281,A00,805637,Gaasterland; Theresa,94,0,100,6
1739705325410,BNFO 283,A00,805640,Chavez; Alejandro & D'Antonio; Matteo,48,0,50,2
1739705325410,BNFO 283,B00,805642,Carter; Hannah Kathryn & Sanchez Roige; Alexandra,47,0,50,3
1739705326434,BNFO 285,A00,805666,Alexandrov; Ludmil B,6,0,8,2
1739705327462,BNFO 294,A01,805680,Ross; Camille,49,0,50,1
1739705328510,CAT 3,A01,813335,Marchisotto; Jennifer Anne,16,0,16,0
1739705328510,CAT 3,A02,813336,Marchisotto; Jennifer Anne,16,0,16,0
1739705328510,CAT 3,A03,813341,Marchisotto; Jennifer Anne,8,0,16,8
1739705328510,CAT 3,A04,813343,Marchisotto; Jennifer Anne,12,0,16,4
1739705328510,CAT 3,A05,813345,Marchisotto; Jennifer Anne,16,0,16,0
1739705328510,CAT 3,A06,813346,Marchisotto; Jennifer Anne,12,0,16,4
1739705328510,CAT 3,A07,813347,Marchisotto; Jennifer Anne,15,0,16,1
1739705328510,CAT 3,A08,813349,Marchisotto; Jennifer Anne,15,0,16,1
1739705328510,CAT 3,A09,813350,Marchisotto; Jennifer Anne,16,0,16,0
1739705328510,CAT 3,A10,813365,Marchisotto; Jennifer Anne,15,0,16,1
1739705328510,CAT 3,A11,813366,Marchisotto; Jennifer Anne,5,0,16,11
1739705328510,CAT 3,A12,813384,Marchisotto; Jennifer Anne,16,0,16,0
1739705328510,CAT 3,A13,813385,Marchisotto; Jennifer Anne,16,0,16,0
1739705328510,CAT 3,A14,813434,Marchisotto; Jennifer Anne,15,0,16,1
1739705328510,CAT 3,B01,813444,Popko; Elizabeth Ashley,16,0,16,0
1739705328510,CAT 3,B02,813445,Popko; Elizabeth Ashley,12,0,16,4
1739705328510,CAT 3,B03,813464,Popko; Elizabeth Ashley,14,0,16,2
1739705328510,CAT 3,B04,813465,Popko; Elizabeth Ashley,7,0,16,9
1739705328510,CAT 3,B05,813466,Popko; Elizabeth Ashley,12,0,16,4
1739705328510,CAT 3,B06,813475,Popko; Elizabeth Ashley,13,0,16,3
1739705328510,CAT 3,B07,813531,Popko; Elizabeth Ashley,15,0,16,1
1739705328510,CAT 3,B08,813538,Popko; Elizabeth Ashley,15,0,16,1
1739705328510,CAT 3,B09,813539,Popko; Elizabeth Ashley,11,0,16,5
1739705328510,CAT 3,B10,813543,Popko; Elizabeth Ashley,12,0,16,4
1739705328510,CAT 3,B11,813545,Popko; Elizabeth Ashley,16,0,16,0
1739705328510,CAT 3,B12,813551,Popko; Elizabeth Ashley,16,0,16,0
1739705328510,CAT 3,B13,813552,Popko; Elizabeth Ashley,15,0,16,1
1739705328510,CAT 3,B14,813554,Popko; Elizabeth Ashley,16,0,16,0
1739705328510,CAT 3,B15,813556,Popko; Elizabeth Ashley,16,0,16,0
1739705328510,CAT 3,B16,813558,Popko; Elizabeth Ashley,16,0,16,0
1739705328510,CAT 3,C01,813564,Glaser; Amelia,15,0,16,1
1739705328510,CAT 3,C02,813578,Glaser; Amelia,13,0,16,3
1739705328510,CAT 3,C03,813602,Glaser; Amelia,4,0,16,12
1739705328510,CAT 3,C04,813604,Glaser; Amelia,3,0,16,13
1739705328510,CAT 3,C05,813606,Glaser; Amelia,14,0,16,2
1739705328510,CAT 3,C06,813607,Glaser; Amelia,14,0,16,2
1739705328510,CAT 3,C07,813609,Glaser; Amelia,14,0,16,2
1739705328510,CAT 3,C08,813611,Glaser; Amelia,16,0,16,0
1739705328510,CAT 3,C09,813613,Glaser; Amelia,15,0,16,1
1739705328510,CAT 3,C10,813614,Glaser; Amelia,13,0,16,3
1739705328510,CAT 3,C11,813617,Glaser; Amelia,14,0,16,2
1739705328510,CAT 3,C12,813618,Glaser; Amelia,16,0,16,0
1739705328510,CAT 3,C13,813622,Glaser; Amelia,15,0,16,1
1739705328510,CAT 3,C14,813623,Glaser; Amelia,15,0,16,1
1739705328510,CAT 3,D01,813625,Bigham; David Joseph,11,0,16,5
1739705328510,CAT 3,D02,813627,Bigham; David Joseph,8,0,16,8
1739705328510,CAT 3,D03,813632,Bigham; David Joseph,15,0,16,1
1739705328510,CAT 3,D04,813637,Bigham; David Joseph,15,0,16,1
1739705328510,CAT 3,D05,813641,Bigham; David Joseph,16,0,16,0
1739705328510,CAT 3,D06,813642,Bigham; David Joseph,15,0,16,1
1739705328510,CAT 3,D07,813644,Bigham; David Joseph,15,0,16,1
1739705328510,CAT 3,D08,813645,Bigham; David Joseph,15,0,16,1
1739705328510,CAT 3,D09,813648,Bigham; David Joseph,15,0,16,1
1739705328510,CAT 3,D10,813651,Bigham; David Joseph,16,0,16,0
1739705328510,CAT 3,D11,813654,Bigham; David Joseph,16,0,16,0
1739705328510,CAT 3,D12,813656,Bigham; David Joseph,16,0,16,0
1739705328510,CAT 3,D13,813657,Bigham; David Joseph,16,0,16,0
1739705328510,CAT 3,D14,813658,Bigham; David Joseph,16,0,16,0
1739705328510,CAT 3,D15,813662,Bigham; David Joseph,15,0,16,1
1739705328510,CAT 3,D16,813663,Bigham; David Joseph,16,0,16,0
1739705329536,CAT 3CE,A01,813665,Bronstein; Phoebe Malan,25,0,25,0
1739705330562,CAT 87,A00,813667,Bronstein; Phoebe Malan,20,0,20,0
1739705330562,CAT 87,B00,886854,Geibel; William,20,0,20,0
1739705331590,CAT 98,001,881482,Geibel; William,20,0,20,0
1739705332627,CAT 124,A01,813672,Geibel; William,20,0,20,0
1739705332627,CAT 124,B01,813675,Rose; Becca Rae,20,0,20,0
1739705333661,CAT 125,A00,813692,Marchisotto; Jennifer Anne,17,0,20,3
1739705333661,CAT 125,B00,813696,Bigham; David Joseph,18,0,20,2
1739705333661,CAT 125,C00,813698,Vanderschuit; Maya Alysia,20,0,20,0
1739705333661,CAT 125,D00,813700,Vanderschuit; Maya Alysia,20,0,20,0
1739705333661,CAT 125,E00,813703,Vanderschuit; Maya Alysia,20,0,20,0
1739705333661,CAT 125,F00,813711,Morales; Celeste Georgianna,19,0,20,1
1739705333661,CAT 125,G00,813714,Morales; Celeste Georgianna,18,0,20,2
1739705333661,CAT 125,H00,813717,Morales; Celeste Georgianna,20,0,20,0
1739705333661,CAT 125,I00,813720,Rose; Becca Rae,20,0,20,0
1739705333661,CAT 125,J00,813744,Rose; Becca Rae,19,0,20,1
1739705333661,CAT 125,K00,813761,Tosun; Adriana,18,0,20,2
1739705333661,CAT 125,L00,813762,Tosun; Adriana,19,0,20,1
1739705333661,CAT 125,M00,872512,Delaville; Romain,19,0,20,1
1739705333661,CAT 125,N00,872514,Irwin; Matthew Joseph,18,0,20,2
1739705333661,CAT 125,O00,872516,Irwin; Matthew Joseph,20,0,20,0
1739705333661,CAT 125,P00,872517,Irwin; Matthew Joseph,19,0,20,1
1739705334691,CAT 125R,A00,813763,Smith; Lauryn Alissa,17,0,20,3
1739705334691,CAT 125R,B00,813764,Smith; Lauryn Alissa,18,0,20,2
1739705334691,CAT 125R,C00,813765,Smith; Lauryn Alissa,20,0,20,0
1739705334691,CAT 125R,D00,813766,Hyland; Tina Mae,16,0,20,4
1739705334691,CAT 125R,E00,813767,Hyland; Tina Mae,15,0,20,5
1739705334691,CAT 125R,F00,813768,Hyland; Tina Mae,19,0,20,1
1739705334691,CAT 125R,G00,813769,Tosun; Adriana,17,0,20,3
1739705335718,CCE 1,A00,815913,Merryman; Ashley,39,0,40,1
1739705335718,CCE 1,D00,815916,Garcia; Kathryn Mary,39,0,40,1
1739705335718,CCE 1,E00,815918,Labat Ii; Michael Luis,36,0,40,4
1739705335718,CCE 1,F00,815919,Bigley; Michele Heather,39,0,40,1
1739705335718,CCE 1,G00,815921,Santos; Vabianna Daria,40,0,40,0
1739705335718,CCE 1,H00,815922,Lee; Kassandra,39,0,40,1
1739705336771,CCE 3,001,815923,Kenley; Nicole,15,0,20,5
1739705336771,CCE 3,002,815924,Quijada; David,19,0,20,1
1739705336771,CCE 3,003,815926,Crawford; James,20,0,20,0
1739705336771,CCE 3,004,815963,Williams; Danielle,20,0,20,0
1739705336771,CCE 3,005,815964,Merryman; Ashley,20,0,20,0
1739705336771,CCE 3,006,815965,Merryman; Ashley,20,0,20,0
1739705336771,CCE 3,007,815966,Lee; Kassandra,19,0,20,1
1739705336771,CCE 3,008,815967,Lee; Kassandra,20,0,20,0
1739705336771,CCE 3,009,816009,Garcia; Kathryn Mary,19,0,20,1
1739705336771,CCE 3,010,816011,Garcia; Kathryn Mary,19,0,20,1
1739705336771,CCE 3,011,816012,Labat Ii; Michael Luis,18,0,20,2
1739705336771,CCE 3,012,816013,Labat Ii; Michael Luis,20,0,20,0
1739705336771,CCE 3,013,816014,Bigley; Michele Heather,18,0,20,2
1739705336771,CCE 3,014,816015,Santos; Vabianna Daria,20,0,20,0
1739705336771,CCE 3,015,816016,Santos; Vabianna Daria,20,0,20,0
1739705336771,CCE 3,016,889148,Crawford; James,39,0,40,1
1739705337797,CENG 101B,A00,808970,Chen; Shaochen,50,0,50,0
1739705338823,CENG 101C,A00,808971,Li; Yanran,144,0,146,2
1739705339850,CENG 113,A00,808993,Li; Wan-Lu,67,0,70,3
1739705339850,CENG 113,B00,808994,Chen; Zheng,70,0,70,0
1739705340876,CENG 124B,A00,808995,Drews; Aaron,46,0,60,14
1739705340876,CENG 124B,B00,809012,Powell; Alyssa,51,0,60,9
1739705341905,CENG 160,A00,809013,Powell; Alyssa,65,0,70,5
1739705342933,CENG 170,A01,809059,Drews; Aaron,28,0,30,2
1739705343962,CENG 176B,A01,809097,Opatkiewicz; Justin Paul,55,0,60,5
1739705343962,CENG 176B,B01,809104,Shah; Nisarg,47,0,48,1
1739705344987,CENG 205,A00,809106,Jahed Motlagh; Zeinab,41,0,60,19
1739705346015,CENG 260,A00,809107,Powell; Alyssa,30,0,30,0
1739705347041,CENG 273,A00,809114,Shah; Nisarg,23,0,30,7
1739705348067,CGS 2B,A01,812749,Whitley; Leila Marie,23,0,25,2
1739705348067,CGS 2B,A02,812761,Whitley; Leila Marie,24,0,24,0
1739705349095,CGS 87,A00,812765,Wesling; Megan E.,20,0,20,0
1739705350120,CGS 100B,A00,812766,Whitley; Leila Marie,30,0,33,3
1739705351148,CGS 105,A01,812868,Wesling; Megan E.,22,0,23,1
1739705351148,CGS 105,A02,812869,Wesling; Megan E.,22,0,23,1
1739705351148,CGS 105,A03,812872,Wesling; Megan E.,23,0,23,0
1739705352176,CGS 106,A00,812873,Whitley; Leila Marie,46,0,50,4
1739705353203,CGS 112,A00,812902,Cuong; Marisol,30,0,30,0
1739705354231,CGS 114,A00,812906,Cuong; Marisol,20,0,22,2
1739705355256,CGS 117,A00,812907,Martin Sandino; Amanda Maria Yoland,13,0,16,3
1739705356284,CGS 120,A00,812908,Hankins; Joseph D.,21,0,22,1
1739705357308,CGS 121,A00,812916,Martin Sandino; Amanda Maria Yoland,20,0,20,0
1739705358336,CGS 122,A00,812917,Martin Sandino; Amanda Maria Yoland,19,0,20,1
1739705359364,CGS 147,A00,872913,Staff,20,0,20,0
1739705360390,CGS 196B,A00,812923,Taylor-Garcia; Daphne,0,0,0,0
1739705360390,CGS 196B,B00,812971,Hankins; Joseph D.,0,0,0,0
1739705360390,CGS 196B,C00,812978,Perez; Roy,0,0,0,0
1739705361415,CGS 198,001,812980,Anderson; Patrick W.,0,0,0,0
1739705361415,CGS 198,002,813054,Anderson; Patrick W.,0,0,0,0
1739705361415,CGS 198,003,813102,Anderson; Patrick W.,0,0,0,0
1739705361415,CGS 198,004,813257,Anderson; Patrick W.,0,0,0,0
1739705362440,CGS 200,A00,813286,Okonkwo; Holly,0,0,0,0
1739705363470,CHEM 6A,A01,860027,Lam; Tin Yiu,40,0,40,0
1739705363470,CHEM 6A,A02,860042,Lam; Tin Yiu,37,0,40,3
1739705363470,CHEM 6A,A03,860049,Lam; Tin Yiu,35,0,40,5
1739705363470,CHEM 6A,A04,860050,Lam; Tin Yiu,37,0,40,3
1739705363470,CHEM 6A,A05,860051,Lam; Tin Yiu,35,0,40,5
1739705363470,CHEM 6A,A06,860052,Lam; Tin Yiu,40,0,40,0
1739705363470,CHEM 6A,A07,860065,Lam; Tin Yiu,40,0,40,0
1739705363470,CHEM 6A,A08,860068,Lam; Tin Yiu,39,0,40,1
1739705364531,CHEM 6B,A01,859962,Lam; Tin Yiu,39,0,40,1
1739705364531,CHEM 6B,A02,859975,Lam; Tin Yiu,40,0,40,0
1739705364531,CHEM 6B,A03,859990,Lam; Tin Yiu,36,0,40,4
1739705364531,CHEM 6B,A04,859994,Lam; Tin Yiu,39,0,40,1
1739705364531,CHEM 6B,A05,859999,Lam; Tin Yiu,40,0,40,0
1739705364531,CHEM 6B,A06,860019,Lam; Tin Yiu,40,0,40,0
1739705364531,CHEM 6B,A07,860024,Lam; Tin Yiu,40,0,40,0
1739705364531,CHEM 6B,B01,861221,Zajac; Eva L,34,0,40,6
1739705364531,CHEM 6B,B02,861224,Zajac; Eva L,36,0,40,4
1739705364531,CHEM 6B,B03,861229,Zajac; Eva L,39,0,40,1
1739705364531,CHEM 6B,B04,861232,Zajac; Eva L,38,0,40,2
1739705364531,CHEM 6B,B05,861239,Zajac; Eva L,37,0,40,3
1739705364531,CHEM 6B,B06,861240,Zajac; Eva L,36,0,40,4
1739705364531,CHEM 6B,B07,861242,Zajac; Eva L,40,0,40,0
1739705365559,CHEM 6C,A01,861431,Hopkins; Patrycja Anna,35,0,40,5
1739705365559,CHEM 6C,A02,861466,Hopkins; Patrycja Anna,38,0,40,2
1739705365559,CHEM 6C,A03,861467,Hopkins; Patrycja Anna,40,0,40,0
1739705365559,CHEM 6C,A04,861530,Hopkins; Patrycja Anna,40,0,40,0
1739705365559,CHEM 6C,A05,861531,Hopkins; Patrycja Anna,38,0,40,2
1739705365559,CHEM 6C,A06,861622,Hopkins; Patrycja Anna,40,0,40,0
1739705365559,CHEM 6C,A07,861649,Hopkins; Patrycja Anna,39,0,40,1
1739705365559,CHEM 6C,A08,861650,Hopkins; Patrycja Anna,0,0,0,0
1739705365559,CHEM 6C,B01,861651,Zajac; Eva L,31,0,40,9
1739705365559,CHEM 6C,B02,861763,Zajac; Eva L,37,0,40,3
1739705365559,CHEM 6C,B03,861768,Zajac; Eva L,38,0,40,2
1739705365559,CHEM 6C,B04,861770,Zajac; Eva L,38,0,40,2
1739705365559,CHEM 6C,B05,861771,Zajac; Eva L,35,0,40,5
1739705365559,CHEM 6C,B06,861773,Zajac; Eva L,39,0,40,1
1739705365559,CHEM 6C,B07,861777,Zajac; Eva L,40,0,40,0
1739705365559,CHEM 6C,B08,861781,Zajac; Eva L,0,0,0,0
1739705365559,CHEM 6C,D01,859938,Stallings; Dontarie M,39,0,40,1
1739705365559,CHEM 6C,D02,859942,Stallings; Dontarie M,32,0,40,8
1739705365559,CHEM 6C,D03,859943,Stallings; Dontarie M,38,0,40,2
1739705365559,CHEM 6C,D04,859952,Stallings; Dontarie M,38,0,40,2
1739705365559,CHEM 6C,D05,859953,Stallings; Dontarie M,19,0,40,21
1739705365559,CHEM 6C,D06,859959,Stallings; Dontarie M,37,0,40,3
1739705365559,CHEM 6C,D07,859960,Stallings; Dontarie M,37,0,40,3
1739705365559,CHEM 6C,D08,859961,Stallings; Dontarie M,0,0,0,0
1739705365559,CHEM 6C,E01,861810,Debelouchina; Galia T,40,0,40,0
1739705365559,CHEM 6C,E02,861860,Debelouchina; Galia T,40,0,40,0
1739705365559,CHEM 6C,E03,861879,Debelouchina; Galia T,39,0,40,1
1739705365559,CHEM 6C,E04,861880,Debelouchina; Galia T,39,0,40,1
1739705365559,CHEM 6C,E05,861890,Debelouchina; Galia T,39,0,40,1
1739705365559,CHEM 6C,E06,861908,Debelouchina; Galia T,40,0,40,0
1739705365559,CHEM 6C,E07,861910,Debelouchina; Galia T,40,0,40,0
1739705365559,CHEM 6C,E08,861911,Debelouchina; Galia T,0,0,0,0
1739705366584,CHEM 6CH,A01,859928,Tezcan; Faik,39,0,40,1
1739705367613,CHEM 7L,A01,844470,Piercy; Marc Anthony,17,0,24,7
1739705367613,CHEM 7L,A02,844472,Piercy; Marc Anthony,21,0,24,3
1739705367613,CHEM 7L,A03,844473,Piercy; Marc Anthony,22,0,24,2
1739705367613,CHEM 7L,A04,844475,Piercy; Marc Anthony,24,0,24,0
1739705367613,CHEM 7L,A05,844476,Piercy; Marc Anthony,23,0,24,1
1739705367613,CHEM 7L,A06,844482,Piercy; Marc Anthony,22,0,24,2
1739705367613,CHEM 7L,A07,844490,Piercy; Marc Anthony,20,0,24,4
1739705367613,CHEM 7L,A08,844493,Piercy; Marc Anthony,24,0,24,0
1739705367613,CHEM 7L,A09,844496,Piercy; Marc Anthony,23,0,24,1
1739705367613,CHEM 7L,A10,844503,Piercy; Marc Anthony,24,0,24,0
1739705367613,CHEM 7L,B01,844506,Piercy; Marc Anthony,2,0,24,22
1739705367613,CHEM 7L,B02,844508,Piercy; Marc Anthony,23,0,24,1
1739705367613,CHEM 7L,B03,844661,Piercy; Marc Anthony,22,0,24,2
1739705367613,CHEM 7L,B04,844716,Piercy; Marc Anthony,24,0,24,0
1739705367613,CHEM 7L,B05,844717,Piercy; Marc Anthony,21,0,24,3
1739705367613,CHEM 7L,B06,844719,Piercy; Marc Anthony,22,0,24,2
1739705367613,CHEM 7L,B07,844841,Piercy; Marc Anthony,24,0,24,0
1739705367613,CHEM 7L,B08,845021,Piercy; Marc Anthony,23,0,24,1
1739705367613,CHEM 7L,B09,845022,Piercy; Marc Anthony,23,0,24,1
1739705367613,CHEM 7L,B10,845184,Piercy; Marc Anthony,24,0,24,0
1739705368638,CHEM 7LM,A01,845187,Leigh; Brian,24,0,24,0
1739705368638,CHEM 7LM,A02,845321,Leigh; Brian,21,0,21,0
1739705368638,CHEM 7LM,A03,845322,Leigh; Brian,24,0,24,0
1739705368638,CHEM 7LM,A04,845340,Leigh; Brian,19,0,21,2
1739705368638,CHEM 7LM,A05,845350,Leigh; Brian,23,0,24,1
1739705368638,CHEM 7LM,A06,845398,Leigh; Brian,21,0,21,0
1739705368638,CHEM 7LM,A07,845399,Leigh; Brian,18,0,24,6
1739705368638,CHEM 7LM,A08,845406,Leigh; Brian,20,0,21,1
1739705369664,CHEM 11,A01,861914,Albizati; Kim F.,37,0,40,3
1739705369664,CHEM 11,A02,861934,Albizati; Kim F.,38,0,40,2
1739705369664,CHEM 11,A03,861939,Albizati; Kim F.,40,0,40,0
1739705369664,CHEM 11,A04,861940,Albizati; Kim F.,40,0,40,0
1739705369664,CHEM 11,A05,861951,Albizati; Kim F.,36,0,40,4
1739705369664,CHEM 11,A06,861975,Albizati; Kim F.,40,0,40,0
1739705370695,CHEM 40A,A01,861976,Hopkins; Patrycja Anna,32,0,40,8
1739705370695,CHEM 40A,A02,861977,Hopkins; Patrycja Anna,36,0,40,4
1739705370695,CHEM 40A,A03,861978,Hopkins; Patrycja Anna,37,0,40,3
1739705370695,CHEM 40A,A04,862061,Hopkins; Patrycja Anna,38,0,40,2
1739705370695,CHEM 40A,A05,862062,Hopkins; Patrycja Anna,38,0,40,2
1739705370695,CHEM 40A,A06,862063,Hopkins; Patrycja Anna,37,0,40,3
1739705370695,CHEM 40A,A07,862064,Hopkins; Patrycja Anna,39,0,40,1
1739705370695,CHEM 40A,A08,862065,Hopkins; Patrycja Anna,37,0,40,3
1739705371721,CHEM 40B,A01,862066,Weizman; Haim,29,0,40,11
1739705371721,CHEM 40B,A02,862067,Weizman; Haim,38,0,40,2
1739705371721,CHEM 40B,A03,862077,Weizman; Haim,40,0,40,0
1739705371721,CHEM 40B,A04,862085,Weizman; Haim,37,0,40,3
1739705371721,CHEM 40B,A05,862086,Weizman; Haim,34,0,40,6
1739705371721,CHEM 40B,A06,862087,Weizman; Haim,40,0,40,0
1739705371721,CHEM 40B,A07,862088,Weizman; Haim,39,0,40,1
1739705371721,CHEM 40B,A08,862089,Weizman; Haim,0,0,0,0
1739705372750,CHEM 41B,A01,860069,Klosterman; Jeremy K,32,0,40,8
1739705372750,CHEM 41B,A02,860074,Klosterman; Jeremy K,37,0,40,3
1739705372750,CHEM 41B,A03,860081,Klosterman; Jeremy K,39,0,40,1
1739705373782,CHEM 41C,A01,862090,Romero; Nathan A,39,0,40,1
1739705373782,CHEM 41C,A02,862091,Romero; Nathan A,40,0,40,0
1739705373782,CHEM 41C,A03,862092,Romero; Nathan A,39,0,40,1
1739705373782,CHEM 41C,A04,862213,Romero; Nathan A,39,0,40,1
1739705373782,CHEM 41C,A05,862214,Romero; Nathan A,38,0,40,2
1739705373782,CHEM 41C,A06,862215,Romero; Nathan A,40,0,40,0
1739705373782,CHEM 41C,A07,862216,Romero; Nathan A,38,0,40,2
1739705374810,CHEM 43A,A01,845450,Ternansky; Robert J.,15,0,24,9
1739705374810,CHEM 43A,A02,845676,Ternansky; Robert J.,21,0,24,3
1739705374810,CHEM 43A,A03,845679,Ternansky; Robert J.,21,0,24,3
1739705374810,CHEM 43A,A04,845682,Ternansky; Robert J.,23,0,24,1
1739705374810,CHEM 43A,A05,845684,Ternansky; Robert J.,22,0,24,2
1739705374810,CHEM 43A,A06,845686,Ternansky; Robert J.,19,0,24,5
1739705374810,CHEM 43A,A07,845692,Ternansky; Robert J.,22,0,24,2
1739705374810,CHEM 43A,A08,845694,Ternansky; Robert J.,17,0,24,7
1739705374810,CHEM 43A,A09,845697,Ternansky; Robert J.,24,0,24,0
1739705374810,CHEM 43A,A10,845698,Ternansky; Robert J.,23,0,24,1
1739705374810,CHEM 43A,A11,845700,Ternansky; Robert J.,23,0,24,1
1739705374810,CHEM 43A,A12,845702,Ternansky; Robert J.,24,0,24,0
1739705374810,CHEM 43A,A13,845704,Ternansky; Robert J.,22,0,24,2
1739705374810,CHEM 43A,B01,845707,Ternansky; Robert J.,23,0,24,1
1739705374810,CHEM 43A,B02,845712,Ternansky; Robert J.,22,0,24,2
1739705374810,CHEM 43A,B03,845794,Ternansky; Robert J.,14,0,24,10
1739705374810,CHEM 43A,B04,845797,Ternansky; Robert J.,20,0,24,4
1739705374810,CHEM 43A,B05,845800,Ternansky; Robert J.,22,0,24,2
1739705374810,CHEM 43A,B06,845801,Ternansky; Robert J.,20,0,24,4
1739705374810,CHEM 43A,B07,845816,Ternansky; Robert J.,21,0,24,3
1739705374810,CHEM 43A,B08,845817,Ternansky; Robert J.,19,0,24,5
1739705374810,CHEM 43A,B09,845827,Ternansky; Robert J.,23,0,24,1
1739705374810,CHEM 43A,B10,845832,Ternansky; Robert J.,22,0,24,2
1739705374810,CHEM 43A,B11,845866,Ternansky; Robert J.,22,0,24,2
1739705374810,CHEM 43A,B12,845867,Ternansky; Robert J.,21,0,24,3
1739705375835,CHEM 96,A00,845868,Brydges; Stacey,18,0,20,2
1739705376859,CHEM 100A,A01,845921,Staff,0,0,0,0
1739705376859,CHEM 100A,A02,845922,Staff,0,0,0,0
1739705376859,CHEM 100A,A03,845983,Staff,0,0,0,0
1739705376859,CHEM 100A,A04,845984,Staff,0,0,0,0
1739705376859,CHEM 100A,A05,845985,Staff,0,0,0,0
1739705376859,CHEM 100A,A06,845986,Staff,0,0,0,0
1739705377884,CHEM 100B,A01,845988,Pomeroy; Robert S.,27,0,30,3
1739705378940,CHEM 105A,A01,845991,Young; Mark,33,0,40,7
1739705379966,CHEM 108,A01,845993,Mrse; Anthony Adrian,18,0,20,2
1739705379966,CHEM 108,A02,845994,Mrse; Anthony Adrian,18,0,24,6
1739705379966,CHEM 108,B01,845996,Mrse; Anthony Adrian,16,0,20,4
1739705379966,CHEM 108,B02,845997,Mrse; Anthony Adrian,23,0,24,1
1739705380993,CHEM 109,A01,845999,McHugh; Colleen A,11,0,20,9
1739705380993,CHEM 109,A02,846000,McHugh; Colleen A,24,0,24,0
1739705380993,CHEM 109,B01,846002,McHugh; Colleen A,18,0,20,2
1739705380993,CHEM 109,B02,846003,McHugh; Colleen A,23,0,24,1
1739705382019,CHEM 114B,A01,862223,Mishanina; Tatiana V,37,0,40,3
1739705382019,CHEM 114B,A02,862224,Mishanina; Tatiana V,40,0,40,0
1739705382019,CHEM 114B,A03,862225,Mishanina; Tatiana V,40,0,40,0
1739705383071,CHEM 114C,A01,859769,Joseph; Simpson,35,0,40,5
1739705383071,CHEM 114C,A02,859782,Joseph; Simpson,29,0,40,11
1739705383071,CHEM 114C,A03,859790,Joseph; Simpson,25,0,40,15
1739705383071,CHEM 114C,A04,859791,Joseph; Simpson,40,0,40,0
1739705383071,CHEM 114C,A05,859793,Joseph; Simpson,37,0,40,3
1739705383071,CHEM 114C,A06,859804,Joseph; Simpson,37,0,40,3
1739705383071,CHEM 114C,A07,859805,Joseph; Simpson,0,0,0,0
1739705383071,CHEM 114C,A08,859810,Joseph; Simpson,0,0,0,0
1739705384096,CHEM 114D,A00,846006,Ghosh; Gourisankar,19,0,25,6
1739705385177,CHEM 118,A01,862235,Donoghue; Daniel J.,28,0,40,12
1739705385177,CHEM 118,A02,862236,Donoghue; Daniel J.,38,0,40,2
1739705385177,CHEM 118,A03,862238,Donoghue; Daniel J.,28,0,40,12
1739705385177,CHEM 118,A04,862240,Donoghue; Daniel J.,39,0,40,1
1739705385177,CHEM 118,A05,862242,Donoghue; Daniel J.,39,0,40,1
1739705385177,CHEM 118,A06,862243,Donoghue; Daniel J.,39,0,40,1
1739705386203,CHEM 120B,A01,859811,Staff,32,0,40,8
1739705386203,CHEM 120B,A02,859812,Staff,39,0,40,1
1739705386203,CHEM 120B,A03,859813,Staff,0,0,0,0
1739705387228,CHEM 123,A00,846009,Schimpf; Alina M,0,0,0,2
1739705388256,CHEM 125,A00,846010,Tezcan; Faik,17,0,20,3
1739705389284,CHEM 126B,A01,859888,Tauber; Michael,27,0,40,13
1739705389284,CHEM 126B,A02,859927,Tauber; Michael,0,0,0,0
1739705390309,CHEM 132,A01,862270,Tauber; Michael,39,0,40,1
1739705390309,CHEM 132,A02,862271,Tauber; Michael,36,0,40,4
1739705391336,CHEM 135,A01,860846,Xiong; Wei,14,0,15,1
1739705392365,CHEM 143B,A01,846015,Klosterman; Jeremy K,20,0,24,4
1739705392365,CHEM 143B,A02,846016,Klosterman; Jeremy K,15,0,24,9
1739705393400,CHEM 156,A00,846017,Romero; Erik Anthony,29,0,30,1
1739705394434,CHEM 157,A00,846018,Tor; Yitzhak,74,0,80,6
1739705395470,CHEM 158,A00,846020,Molinski; Tadeusz,9,0,10,1
1739705396500,CHEM 167,A01,862285,Deshmukh; Lalit,36,0,40,4
1739705396500,CHEM 167,A02,862286,Deshmukh; Lalit,39,0,40,1
1739705396500,CHEM 167,A03,862287,Deshmukh; Lalit,37,0,40,3
1739705396500,CHEM 167,A04,862288,Deshmukh; Lalit,39,0,40,1
1739705397529,CHEM 173,A00,846023,Young; Mark,36,0,40,4
1739705398553,CHEM 174,A01,851594,Pomeroy; Robert S.,58,0,60,2
1739705399581,CHEM 185,A00,846025,Paesani; Francesco,21,0,26,5
1739705400609,CHEM 188,A00,846026,Brydges; Stacey,20,0,20,0
1739705401635,CHEM 207,A00,846088,Deshmukh; Lalit,23,0,30,7
1739705402663,CHEM 214,A00,846089,Ghosh; Gourisankar,5,0,15,10
1739705403688,CHEM 217,A00,846092,Joseph; Simpson,15,0,30,15
1739705404717,CHEM 225,A00,846095,Tezcan; Faik,5,0,10,5
1739705405743,CHEM 227,A00,846097,Schimpf; Alina M,30,0,30,0
1739705406767,CHEM 229,A00,846100,Stauber; Julia Megan,19,0,20,1
1739705407792,CHEM 235,A01,860847,Xiong; Wei,17,0,20,3
1739705408816,CHEM 236,A00,846106,Kummel; Andrew C,5,0,15,10
1739705409844,CHEM 237,A00,872555,Esko; Jeffrey D.,7,0,7,0
1739705410873,CHEM 250,A00,846107,Weizman; Haim,0,0,0,0
1739705411898,CHEM 256,A00,846108,Romero; Erik Anthony,20,0,20,0
1739705412923,CHEM 257,A00,846109,Tor; Yitzhak,28,0,30,2
1739705413950,CHEM 258,A00,846110,Molinski; Tadeusz,13,0,15,2
1739705414975,CHEM 262,A00,846111,Kubiak; Clifford Paul,26,0,30,4
1739705416000,CHEM 273,A00,846118,Young; Mark,15,0,20,5
1739705417024,CHEM 276,A00,846119,Mc Culloch; Andrew Douglas,4,0,5,1
1739705418052,CHEM 283,A00,846120,Ghassemian; Majid,10,0,10,0
1739705419080,CHEM 285,A00,846121,Paesani; Francesco,18,0,20,2
1739705420105,CHEM 291,A00,846122,Debelouchina; Galia T,20,0,20,0
1739705421131,CHEM 294,A00,846123,Pun; Andrew Brian,48,0,50,2
1739705422157,CHIN 10CD,A01,809156,Liu; Mingming,17,0,17,0
1739705422157,CHIN 10CD,A02,809192,Liu; Mingming,18,0,18,0
1739705423186,CHIN 10CM,A01,809196,Chen; Pei-Chia,15,0,15,0
1739705423186,CHIN 10CM,A02,809197,Chen; Pei-Chia,19,0,20,1
1739705424212,CHIN 10CN,A01,809203,Xu; Li,12,0,14,2
1739705424212,CHIN 10CN,A03,809218,Xu; Li,14,0,14,0
1739705424212,CHIN 10CN,B01,809296,Xu; Li,13,0,14,1
1739705424212,CHIN 10CN,B02,809307,Xu; Li,10,0,14,4
1739705424212,CHIN 10CN,B03,809361,Xu; Li,14,0,14,0
1739705425237,CHIN 20CM,A01,809437,Wang; Xiao,10,0,10,0
1739705425237,CHIN 20CM,A02,809458,Wang; Xiao,10,0,10,0
1739705426268,CHIN 20CN,A01,809462,Anderson; Qin-Hong,12,0,12,0
1739705426268,CHIN 20CN,A02,809463,Anderson; Qin-Hong,12,0,12,0
1739705426268,CHIN 20CN,A03,871383,Anderson; Qin-Hong,12,0,12,0
1739705426268,CHIN 20CN,B01,809488,Anderson; Qin-Hong,12,0,12,0
1739705427295,CHIN 100CM,A00,809489,Anderson; Qin-Hong,23,0,24,1
1739705428320,CHIN 100CN,A00,809490,Chen; Pei-Chia,24,0,24,0
1739705429347,CHIN 169B,A00,809720,Wang; Xiao,20,0,20,0
1739705430372,CHIN 182B,A00,809728,Liu; Mingming,17,0,20,3
1739705431400,CLAS 196B,A00,869154,Myerston Santana; Jacobo,1,0,1,0
1739705432428,CLIN 294C,A00,870690,Wierenga; Christina E & Banks; Sarah Jane,20,0,20,0
1739705433455,CLIN 296,001,870694,Brookman; Lauren Irene,100,0,100,0
1739705433455,CLIN 296,002,870695,Brookman; Lauren Irene,10,0,10,0
1739705433455,CLIN 296,003,870696,Wall; Tamara Lynn,100,0,100,0
1739705434481,CLRE 238R,A00,809924,Mehta; Ravindra L.,9999,0,9999,0
1739705435509,CLRE 254,A00,809952,Vaida; Florin,9999,0,9999,0
1739705436534,CLRE 255,A01,809989,Cuomo; Raphael Eduardo,9999,0,9999,0
1739705437558,CLRE 256,A01,810211,Morris; Sheldon,9999,0,9999,0
1739705438584,CLRE 257,A00,810214,Mehta; Ravindra L.,9999,0,9999,0
1739705439612,CLRE 258,A00,810216,Mehta; Ravindra L.,9999,0,9999,0
1739705440637,CLRE 260,A00,810217,Cuomo; Raphael Eduardo,9999,0,9999,0
1739705441673,CLRE 265,A00,810220,Vaida; Florin,9999,0,9999,0
1739705442699,CLRE 297,001,810222,Cuomo; Raphael Eduardo,9999,0,9999,0
1739705443725,CLX 87,A00,809115,Castro; Robert Jess,20,0,20,0
1739705444750,CMM 225,A00,872556,Esko; Jeffrey D.,7,0,7,0
1739705445775,CMM 246,A00,872560,Gordts; Philip & Lewis; Amanda Lark & Godula; Kamil & Gagneux; Pascal & Esko; Jeffrey D. & Bode; Lars,10,0,10,0
1739705446798,CMM 250,A00,884466,Willert; Karl Heinrich,60,0,60,0
1739705447824,COGR 201D,A00,808201,Serlin; David,10,0,10,0
1739705448848,COGR 219,A00,808207,Harb; Anthony Joseph,5,0,10,5
1739705449873,COGR 225B,A00,808212,Gere; Catherina M.,10,0,10,0
1739705450902,COGR 225C,A00,808214,McKenzie; Kerry V.,10,0,10,0
1739705451930,COGR 275,A00,808219,Jack; Caroline Sarah,8,0,10,2
1739705452958,COGR 296,A00,808221,Ybarra; Megan,5,0,5,0
1739705453997,COGS 1,A01,810294,Deak; Gedeon O.,58,0,60,2
1739705453997,COGS 1,A02,810296,Deak; Gedeon O.,57,0,60,3
1739705453997,COGS 1,A03,810298,Deak; Gedeon O.,56,0,60,4
1739705453997,COGS 1,A04,810299,Deak; Gedeon O.,57,0,60,3
1739705453997,COGS 1,A05,810300,Deak; Gedeon O.,60,0,60,0
1739705453997,COGS 1,A06,810301,Deak; Gedeon O.,59,0,60,1
1739705453997,COGS 1,A07,810302,Deak; Gedeon O.,57,0,57,0
1739705455028,COGS 2,A01,810304,Boyle; Mary E. T.,54,0,56,2
1739705455028,COGS 2,A02,810305,Boyle; Mary E. T.,56,0,56,0
1739705455028,COGS 2,A03,810307,Boyle; Mary E. T.,54,0,56,2
1739705455028,COGS 2,A04,810309,Boyle; Mary E. T.,57,0,60,3
1739705455028,COGS 2,A05,810310,Boyle; Mary E. T.,67,0,67,0
1739705456054,COGS 9,A01,810312,Shannon; Kyle Michael,49,0,50,1
1739705456054,COGS 9,A02,810313,Shannon; Kyle Michael,49,0,50,1
1739705456054,COGS 9,A03,810314,Shannon; Kyle Michael,49,0,50,1
1739705456054,COGS 9,A04,810316,Shannon; Kyle Michael,50,0,50,0
1739705456054,COGS 9,A05,810320,Shannon; Kyle Michael,50,0,50,0
1739705456054,COGS 9,A06,810321,Shannon; Kyle Michael,49,0,50,1
1739705457077,COGS 11,A01,810324,Boroditsky; Lera,134,0,140,6
1739705458104,COGS 13,A01,810328,Rossano; Federico,42,0,50,8
1739705458104,COGS 13,A02,810329,Rossano; Federico,48,0,49,1
1739705458104,COGS 13,A03,810330,Rossano; Federico,48,0,50,2
1739705458104,COGS 13,A04,810331,Rossano; Federico,48,0,49,1
1739705458104,COGS 13,A05,810332,Rossano; Federico,48,0,49,1
1739705458104,COGS 13,A06,810333,Rossano; Federico,49,0,49,0
1739705459130,COGS 14A,A01,810335,Barrera; Steven James,45,0,50,5
1739705459130,COGS 14A,A02,810336,Barrera; Steven James,47,0,50,3
1739705459130,COGS 14A,A03,810338,Barrera; Steven James,49,0,50,1
1739705459130,COGS 14A,A04,810339,Barrera; Steven James,56,0,60,4
1739705459130,COGS 14A,A05,810340,Barrera; Steven James,50,0,50,0
1739705459130,COGS 14A,A06,810341,Barrera; Steven James,50,0,50,0
1739705459130,COGS 14A,A07,810343,Barrera; Steven James,54,0,56,2
1739705460160,COGS 14B,A01,810346,Hoffman; Drew Ellen,54,0,57,3
1739705460160,COGS 14B,A02,810347,Hoffman; Drew Ellen,55,0,55,0
1739705460160,COGS 14B,A03,810348,Hoffman; Drew Ellen,52,0,55,3
1739705460160,COGS 14B,A04,810350,Hoffman; Drew Ellen,54,0,55,1
1739705460160,COGS 14B,A05,810351,Hoffman; Drew Ellen,53,0,55,2
1739705461186,COGS 17,A01,810353,Johnson; Christine M.,49,0,50,1
1739705461186,COGS 17,A02,810354,Johnson; Christine M.,48,0,50,2
1739705461186,COGS 17,A03,810356,Johnson; Christine M.,48,0,50,2
1739705461186,COGS 17,A04,810357,Johnson; Christine M.,47,0,50,3
1739705461186,COGS 17,A05,810359,Johnson; Christine M.,49,0,50,1
1739705461186,COGS 17,A06,810360,Johnson; Christine M.,50,0,50,0
1739705461186,COGS 17,A07,810361,Johnson; Christine M.,52,0,55,3
1739705461186,COGS 17,A08,810362,Johnson; Christine M.,54,0,55,1
1739705462214,COGS 18,A01,810366,Ellis; Shannon Elizabeth,31,0,35,4
1739705462214,COGS 18,A02,810367,Ellis; Shannon Elizabeth,31,0,35,4
1739705462214,COGS 18,A03,810371,Ellis; Shannon Elizabeth,30,0,35,5
1739705462214,COGS 18,A04,810372,Ellis; Shannon Elizabeth,34,0,35,1
1739705462214,COGS 18,A05,810373,Ellis; Shannon Elizabeth,32,0,35,3
1739705462214,COGS 18,A06,810374,Ellis; Shannon Elizabeth,35,0,35,0
1739705462214,COGS 18,A07,810375,Ellis; Shannon Elizabeth,35,0,35,0
1739705462214,COGS 18,A08,810376,Ellis; Shannon Elizabeth,34,0,35,1
1739705462214,COGS 18,A09,810377,Ellis; Shannon Elizabeth,35,0,35,0
1739705462214,COGS 18,B01,810379,Ellis; Shannon Elizabeth,33,0,35,2
1739705462214,COGS 18,B02,810384,Ellis; Shannon Elizabeth,34,0,35,1
1739705462214,COGS 18,B03,810385,Ellis; Shannon Elizabeth,34,0,35,1
1739705462214,COGS 18,B04,810388,Ellis; Shannon Elizabeth,34,0,35,1
1739705462214,COGS 18,B05,810389,Ellis; Shannon Elizabeth,31,0,35,4
1739705462214,COGS 18,B06,810390,Ellis; Shannon Elizabeth,31,0,35,4
1739705462214,COGS 18,B07,810392,Ellis; Shannon Elizabeth,34,0,35,1
1739705462214,COGS 18,B08,810393,Ellis; Shannon Elizabeth,34,0,35,1
1739705462214,COGS 18,B09,810395,Ellis; Shannon Elizabeth,32,0,35,3
1739705463240,COGS 87,A00,810426,Deak; Gedeon O.,20,0,20,0
1739705464269,COGS 100,A01,810564,Morgan; Eric,49,0,56,7
1739705464269,COGS 100,A02,810582,Morgan; Eric,54,0,56,2
1739705464269,COGS 100,A03,810589,Morgan; Eric,55,0,56,1
1739705464269,COGS 100,A04,810651,Morgan; Eric,54,0,56,2
1739705464269,COGS 100,A05,810684,Morgan; Eric,56,0,56,0
1739705464269,COGS 100,A06,810690,Morgan; Eric,54,0,56,2
1739705465297,COGS 101A,A01,810697,Morgan; Eric,49,0,50,1
1739705465297,COGS 101A,A02,810701,Morgan; Eric,49,0,50,1
1739705465297,COGS 101A,A03,810707,Morgan; Eric,49,0,50,1
1739705465297,COGS 101A,A04,810708,Morgan; Eric,50,0,50,0
1739705466325,COGS 101B,A01,810716,Barrera; Steven James,49,0,50,1
1739705466325,COGS 101B,A02,810718,Barrera; Steven James,45,0,50,5
1739705466325,COGS 101B,A03,810719,Barrera; Steven James,47,0,50,3
1739705466325,COGS 101B,A04,810730,Barrera; Steven James,38,0,50,12
1739705467354,COGS 101C,A01,810737,Cooperrider; Kensy A,50,0,50,0
1739705467354,COGS 101C,A02,810742,Cooperrider; Kensy A,43,0,50,7
1739705467354,COGS 101C,A03,810743,Cooperrider; Kensy A,48,0,50,2
1739705468383,COGS 102A,A01,810750,Allen; Michael Gordon,49,0,50,1
1739705468383,COGS 102A,A02,810751,Allen; Michael Gordon,50,0,50,0
1739705468383,COGS 102A,A03,810754,Allen; Michael Gordon,44,0,49,5
1739705469407,COGS 107A,A01,810756,Boyle; Mary E. T.,54,0,56,2
1739705469407,COGS 107A,A02,810757,Boyle; Mary E. T.,52,0,56,4
1739705469407,COGS 107A,A03,810760,Boyle; Mary E. T.,55,0,56,1
1739705469407,COGS 107A,A04,810767,Boyle; Mary E. T.,54,0,56,2
1739705469407,COGS 107A,A05,810769,Boyle; Mary E. T.,54,0,56,2
1739705469407,COGS 107A,A06,810777,Boyle; Mary E. T.,55,0,56,1
1739705470434,COGS 107B,A03,810800,Mooshagian; Eric Frederick,41,0,50,9
1739705470434,COGS 107B,A04,810810,Mooshagian; Eric Frederick,33,0,50,17
1739705470434,COGS 107B,A05,810811,Mooshagian; Eric Frederick,44,0,50,6
1739705471459,COGS 107C,A01,810815,Chiba; Andrea,41,0,47,6
1739705471459,COGS 107C,A02,810816,Chiba; Andrea,35,0,50,15
1739705471459,COGS 107C,A03,810853,Chiba; Andrea,44,0,49,5
1739705472502,COGS 108,A01,810862,Fleischer; Jason G,42,0,50,8
1739705472502,COGS 108,A02,810870,Fleischer; Jason G,42,0,50,8
1739705472502,COGS 108,A03,810871,Fleischer; Jason G,50,0,50,0
1739705472502,COGS 108,A04,810874,Fleischer; Jason G,49,0,50,1
1739705472502,COGS 108,A05,810876,Fleischer; Jason G,47,0,50,3
1739705472502,COGS 108,A06,810879,Fleischer; Jason G,48,0,50,2
1739705472502,COGS 108,A07,810896,Fleischer; Jason G,50,0,50,0
1739705472502,COGS 108,B01,810950,Fleischer; Jason G,54,0,56,2
1739705472502,COGS 108,B02,810960,Fleischer; Jason G,54,0,56,2
1739705472502,COGS 108,B03,810961,Fleischer; Jason G,52,0,56,4
1739705472502,COGS 108,B04,810962,Fleischer; Jason G,43,0,60,17
1739705472502,COGS 108,B05,810963,Fleischer; Jason G,58,0,60,2
1739705472502,COGS 108,B06,810964,Fleischer; Jason G,57,0,60,3
1739705472502,COGS 108,B07,810965,Fleischer; Jason G,62,0,62,0
1739705474554,COGS 112,A01,811001,Hoffman; Drew Ellen,33,0,50,17
1739705474554,COGS 112,A02,811020,Hoffman; Drew Ellen,42,0,50,8
1739705474554,COGS 112,A03,811045,Hoffman; Drew Ellen,44,0,50,6
1739705474554,COGS 112,A04,811047,Hoffman; Drew Ellen,49,0,50,1
1739705475579,COGS 124,A00,811065,Guo; Philip J,1,0,25,24
1739705476607,COGS 125,A00,811079,Klemmer; Scott R,43,0,50,7
1739705477631,COGS 142,A01,811081,Rossano; Federico,50,0,50,0
1739705478656,COGS 143,A01,811108,Staff,46,0,50,4
1739705479698,COGS 150,A01,811185,Trott; Sean Thomas,35,0,50,15
1739705479698,COGS 150,A02,811319,Trott; Sean Thomas,50,0,50,0
1739705479698,COGS 150,A03,811360,Trott; Sean Thomas,41,0,49,8
1739705480726,COGS 157,A00,811371,Creel; Sarah,66,0,75,9
1739705481758,COGS 160,A00,872440,Saygin; Ayse P,29,0,30,1
1739705481758,COGS 160,B00,872441,Saygin; Ayse P,30,0,30,0
1739705481758,COGS 160,C00,872442,Kirsh; David Joel,30,0,30,0
1739705482786,COGS 172,A01,811389,Greene; Deanna Jacquelyn,46,0,50,4
1739705482786,COGS 172,A02,811390,Greene; Deanna Jacquelyn,48,0,50,2
1739705482786,COGS 172,A03,811391,Greene; Deanna Jacquelyn,45,0,50,5
1739705482786,COGS 172,A04,811392,Greene; Deanna Jacquelyn,47,0,50,3
1739705484838,COGS 179,A01,811401,Staff,43,0,50,7
1739705485863,COGS 184,A01,811403,Johnson; Christine M.,46,0,50,4
1739705486888,COGS 185,A01,811514,Tu; Zhuowen,38,0,50,12
1739705486888,COGS 185,A02,811580,Tu; Zhuowen,46,0,50,4
1739705487918,COGS 187A,A01,811589,Allen; Michael Gordon,45,0,50,5
1739705487918,COGS 187A,A02,811590,Allen; Michael Gordon,46,0,50,4
1739705487918,COGS 187A,A03,811591,Allen; Michael Gordon,44,0,49,5
1739705489004,COGS 190C,001,811592,Chiba; Andrea,9999,0,9999,0
1739705489004,COGS 190C,002,811601,Fleischer; Jason G,9999,0,9999,0
1739705489004,COGS 190C,003,811602,Boyle; Mary E. T.,9999,0,9999,0
1739705489004,COGS 190C,004,811604,Nitz; Douglas A.,9999,0,9999,0
1739705489004,COGS 190C,005,811605,Rangel; Lara M,9999,0,9999,0
1739705489004,COGS 190C,006,811609,Hoffman; Drew Ellen,9999,0,9999,0
1739705489004,COGS 190C,007,811610,Deak; Gedeon O.,9999,0,9999,0
1739705489004,COGS 190C,008,811613,Kiyonaga; Anastasia,9999,0,9999,0
1739705489004,COGS 190C,009,811716,Creel; Sarah,9999,0,9999,0
1739705489004,COGS 190C,010,811733,Voytek; Bradley Thomas,9999,0,9999,0
1739705489004,COGS 190C,011,811836,Beatty-Martinez; Anne,9999,0,9999,0
1739705489004,COGS 190C,012,811838,De Sa; Virginia,9999,0,9999,0
1739705489004,COGS 190C,013,811839,Kirsh; David Joel,9999,0,9999,0
1739705489004,COGS 190C,014,811843,Jernigan; Terry Lynne,9999,0,9999,0
1739705489004,COGS 190C,015,811844,Tu; Zhuowen,9999,0,9999,0
1739705490030,COGS 190D,A00,811922,Voytek; Bradley Thomas,25,0,25,0
1739705491059,COGS 194,A00,811949,Hill; Seth J,9999,0,9999,0
1739705492087,COGS 202,A00,872444,Khosla; Meenakshi,12,0,25,13
1739705493112,COGS 205,A00,812100,Chiba; Andrea,20,0,20,0
1739705494138,COGS 209,A00,812101,Mukamel; Eran A,25,0,46,21
1739705495164,COGS 210C,A00,812186,Kirsh; David Joel,9999,0,9999,0
1739705495164,COGS 210C,B00,812192,Greene; Deanna Jacquelyn,9999,0,9999,0
1739705495164,COGS 210C,C00,812199,Xia; Haijun,9999,0,9999,0
1739705495164,COGS 210C,D00,812206,Nitz; Douglas A.,9999,0,9999,0
1739705495164,COGS 210C,E00,812207,Hollan; James D.,9999,0,9999,0
1739705495164,COGS 210C,F00,812260,De Sa; Virginia,9999,0,9999,0
1739705495164,COGS 210C,G00,812261,Rossano; Federico,9999,0,9999,0
1739705495164,COGS 210C,H00,812262,Kiyonaga; Anastasia,9999,0,9999,0
1739705495164,COGS 210C,I00,812263,Guo; Philip J,9999,0,9999,0
1739705495164,COGS 210C,J00,812264,Dow; Steven P,9999,0,9999,0
1739705495164,COGS 210C,K00,812265,Bergen; Benjamin,9998,0,9999,1
1739705495164,COGS 210C,L00,812266,Coulson; Seana M,9999,0,9999,0
1739705495164,COGS 210C,M00,812267,Rangel; Lara M,9999,0,9999,0
1739705496191,COGS 211C,A00,812268,Boroditsky; Lera,19,0,20,1
1739705497235,COGS 229,A00,812269,Irani; Lilly C & Shvartzberg Carrio; Manuel,10,0,10,0
1739705498260,COGS 231,A00,812270,Guo; Philip J,0,0,20,20
1739705499283,COGS 238,A00,812271,Bergen; Benjamin,18,0,20,2
1739705500321,COMM 10,A01,807316,Whitworth-Smith; Andrew C,22,0,23,1
1739705500321,COMM 10,A02,807320,Whitworth-Smith; Andrew C,23,0,23,0
1739705500321,COMM 10,A03,807321,Whitworth-Smith; Andrew C,23,0,23,0
1739705500321,COMM 10,A04,807324,Whitworth-Smith; Andrew C,23,0,23,0
1739705500321,COMM 10,A05,807328,Whitworth-Smith; Andrew C,17,0,23,6
1739705500321,COMM 10,A06,807329,Whitworth-Smith; Andrew C,21,0,23,2
1739705500321,COMM 10,A07,807330,Whitworth-Smith; Andrew C,21,0,23,2
1739705500321,COMM 10,A08,807333,Whitworth-Smith; Andrew C,21,0,22,1
1739705500321,COMM 10,A09,807334,Whitworth-Smith; Andrew C,23,0,23,0
1739705500321,COMM 10,A11,807363,Whitworth-Smith; Andrew C,0,0,0,0
1739705500321,COMM 10,A12,807364,Whitworth-Smith; Andrew C,0,0,0,0
1739705500321,COMM 10,A13,807366,Whitworth-Smith; Andrew C,23,0,23,0
1739705500321,COMM 10,A15,807374,Whitworth-Smith; Andrew C,0,0,0,0
1739705500321,COMM 10,A16,807427,Whitworth-Smith; Andrew C,23,0,23,0
1739705500321,COMM 10,A17,807428,Whitworth-Smith; Andrew C,23,0,23,0
1739705500321,COMM 10,A18,807429,Whitworth-Smith; Andrew C,0,0,0,0
1739705501349,COMM 20,A01,807435,Hill; Erin Truesdell,72,0,75,3
1739705502384,COMM 30,A00,807436,Metcalf; Kathryne Young,73,0,75,2
1739705503410,COMM 50,A00,807438,Armenta; John E,22,0,25,3
1739705504436,COMM 80,A01,807440,Campbell; Robert Harold,0,0,0,0
1739705505467,COMM 100B,A01,807446,Serlin; David,20,0,25,5
1739705505467,COMM 100B,A02,807447,Serlin; David,23,0,25,2
1739705505467,COMM 100B,A03,807450,Serlin; David,25,0,25,0
1739705505467,COMM 100B,A05,807453,Serlin; David,23,0,25,2
1739705505467,COMM 100B,A06,807454,Serlin; David,25,0,25,0
1739705505467,COMM 100B,A07,807455,Serlin; David,18,0,25,7
1739705505467,COMM 100B,A08,807458,Serlin; David,22,0,25,3
1739705505467,COMM 100B,A09,807459,Serlin; David,21,0,25,4
1739705505467,COMM 100B,A10,807462,Serlin; David,25,0,25,0
1739705505467,COMM 100B,A11,807464,Serlin; David,25,0,25,0
1739705506493,COMM 101,A01,807470,Davis; Zeinabu I.,15,0,15,0
1739705506493,COMM 101,A02,807513,Davis; Zeinabu I.,15,0,15,0
1739705506493,COMM 101,A03,807516,Davis; Zeinabu I.,15,0,15,0
1739705506493,COMM 101,A04,807517,Davis; Zeinabu I.,14,0,15,1
1739705507521,COMM 101D,A00,807570,Halm; Gavin Patrick,18,0,18,0
1739705508548,COMM 101K,A00,807571,Martinico; Daniel J,16,0,16,0
1739705509573,COMM 101N,A00,807572,Martinico; Daniel J,16,0,16,0
1739705510599,COMM 101T,A00,807573,Halm; Gavin Patrick,17,0,18,1
1739705510599,COMM 101T,B00,807588,Dewey; Matthew D,10,0,10,0
1739705510599,COMM 101T,C00,807592,Dewey; Matthew D,9,0,10,1
1739705511625,COMM 102C,A01,807604,Campion; Camille E,6,0,6,0
1739705511625,COMM 102C,A02,807605,Campion; Camille E,6,0,6,0
1739705511625,COMM 102C,A03,807612,Campion; Camille E,3,0,6,3
1739705512653,COMM 102M,A01,807638,Ahn; Patricia Jeehyun,9,0,9,0
1739705512653,COMM 102M,A02,807639,Ahn; Patricia Jeehyun,7,0,9,2
1739705513678,COMM 106F,A00,807672,McKenna; Denise,69,0,75,6
1739705514705,COMM 106I,A00,807926,Irani; Lilly C,71,0,75,4
1739705515730,COMM 109P,A00,807927,Jack; Caroline Sarah,39,0,40,1
1739705516755,COMM 110M,A00,807928,Abuelhiga; Soraya Jill,40,0,40,0
1739705517779,COMM 113T,A00,807929,Dominguez Rubio; Fernando,39,0,40,1
1739705518807,COMM 114A,A00,807930,Zilberg; Elana,37,0,40,3
1739705519833,COMM 114F,A00,808016,Rojo Solis; Juan Jose,38,0,40,2
1739705520858,COMM 114P,A00,808034,Abuelhiga; Soraya Jill,38,0,40,2
1739705521887,COMM 114W,A00,808035,Walkover; Lillian B,17,0,20,3
1739705522922,COMM 115,A00,808037,Alac; Morana,33,0,35,2
1739705523949,COMM 132,A00,808058,McKenna; Denise,37,0,40,3
1739705524974,COMM 139,A00,808063,Davis; Zeinabu I.,23,0,30,7
1739705525999,COMM 143,A00,808064,Rojo Solis; Juan Jose,38,0,40,2
1739705527024,COMM 146,A00,808068,Ahn; Patricia Jeehyun,34,0,35,1
1739705528049,COMM 155,A00,808072,Pavon Aramburu; Maria Laur,39,0,40,1
1739705529074,COMM 158,A00,808073,Fields; Gary,40,0,40,0
1739705530099,COMM 171,A00,808082,Zilberg; Elana,24,0,25,1
1739705531124,COMM 172,A00,808083,Staff,23,0,25,2
1739705532148,COMM 173,A00,808091,Alac; Morana,25,0,25,0
1739705533173,COMM 180,A00,808162,Leuning; Grant Maurstad,25,0,25,0
1739705534202,COMM 190,A00,808168,Dominguez Rubio; Fernando,22,0,23,1
1739705534202,COMM 190,B00,808169,Harb; Anthony Joseph,22,0,23,1
1739705534202,COMM 190,C00,808170,Rojo Solis; Juan Jose,22,0,23,1
1739705534202,COMM 190,D00,870218,Boateng; Boatema,22,0,23,1
1739705535226,COMM 194,A00,851599,Staff,0,0,0,0
1739705536252,CSE 6R,A01,842851,Moshiri; Niema,142,0,149,7
1739705536252,CSE 6R,B01,876602,Moshiri; Niema,50,0,50,0
1739705537279,CSE 8A,A50,842974,Porter; Leonard Emerson,38,0,38,0
1739705537279,CSE 8A,A51,843001,Porter; Leonard Emerson,37,0,38,1
1739705537279,CSE 8A,A52,843011,Porter; Leonard Emerson,38,0,38,0
1739705537279,CSE 8A,A53,843012,Porter; Leonard Emerson,37,0,38,1
1739705537279,CSE 8A,A54,874345,Porter; Leonard Emerson,38,0,38,0
1739705537279,CSE 8A,A55,874414,Porter; Leonard Emerson,35,0,38,3
1739705537279,CSE 8A,A56,874418,Porter; Leonard Emerson,38,0,38,0
1739705538303,CSE 11,A01,860850,Ochoa; Benjamin Lawrence,300,0,320,20
1739705539327,CSE 12,A01,860851,Cao; Yingjun,117,0,120,3
1739705539327,CSE 12,B01,865865,Cao; Yingjun,109,0,120,11
1739705540354,CSE 20,A01,865892,Jones; Miles E,97,0,100,3
1739705540354,CSE 20,A02,865908,Jones; Miles E,97,0,100,3
1739705541378,CSE 21,A01,865911,Jones; Miles E,97,0,100,3
1739705541378,CSE 21,A02,865914,Jones; Miles E,94,0,100,6
1739705542404,CSE 29,A50,843454,Solares; Edwin A,9,0,10,1
1739705542404,CSE 29,A51,843459,Solares; Edwin A,10,0,10,0
1739705542404,CSE 29,A52,843460,Solares; Edwin A,8,0,10,2
1739705542404,CSE 29,A53,843549,Solares; Edwin A,5,0,5,0
1739705542404,CSE 29,B50,843559,Soosai Raj; Adalbert Geral,5,0,10,5
1739705542404,CSE 29,B51,843750,Soosai Raj; Adalbert Geral,4,0,10,6
1739705542404,CSE 29,B52,843757,Soosai Raj; Adalbert Geral,8,0,10,2
1739705542404,CSE 29,B53,843758,Soosai Raj; Adalbert Geral,4,0,5,1
1739705543434,CSE 30,A01,864415,Chin; Bryan W.,120,0,125,5
1739705543434,CSE 30,B01,864419,Chin; Bryan W.,99,0,100,1
1739705544460,CSE 87,A00,875925,Moshiri; Niema,20,0,20,0
1739705545489,CSE 89,A00,872519,Minnes Kemp; Mor Mia,100,0,100,0
1739705545489,CSE 89,B00,872520,Minnes Kemp; Mor Mia,100,0,100,0
1739705546512,CSE 95,A00,843802,Cao; Yingjun,100,0,100,0
1739705547538,CSE 100,A01,864420,Sahoo; Debashis,100,0,120,20
1739705548562,CSE 101,A01,860868,Impagliazzo; Russell,0,0,10,10
1739705548562,CSE 101,A02,860869,Impagliazzo; Russell,0,0,10,10
1739705548562,CSE 101,A03,860870,Impagliazzo; Russell,6,0,10,4
1739705549587,CSE 105,A01,864426,Lovett; Shachar,222,0,250,28
1739705550611,CSE 107,A01,864427,Bellare; Mihir,92,0,96,4
1739705551640,CSE 110,A50,843823,Powell; Thomas Allan,111,0,116,5
1739705551640,CSE 110,A51,843827,Powell; Thomas Allan,93,0,116,23
1739705551640,CSE 110,A52,843828,Powell; Thomas Allan,106,0,116,10
1739705552666,CSE 120,A01,860871,Ousterhout; Amy,300,0,328,28
1739705553696,CSE 124,A01,864431,Porter; George M,138,0,196,58
1739705554720,CSE 125,A00,843848,Voelker; Geoffrey M.,30,0,30,0
1739705555745,CSE 127,A01,865915,Fernandes; Earlence T,172,0,192,20
1739705556771,CSE 130,A01,865928,Polikarpova; Nadezhda,176,0,192,16
1739705557798,CSE 131,A01,865936,Ding; Yufei,65,0,75,10
1739705558827,CSE 140,A01,865937,Eldon; John,184,0,196,12
1739705559853,CSE 140L,A01,843892,Eldon; John,173,0,196,23
1739705560882,CSE 141,A01,865939,Pannuto; Patrick William,165,0,192,27
1739705561910,CSE 141L,A01,843910,Eldon; John,158,0,196,38
1739705562935,CSE 145,A00,843915,Kastner; Ryan Charles,25,0,25,0
1739705563963,CSE 150A,A01,860873,Bonjour; Trevor,181,0,196,15
1739705564991,CSE 150B,A01,864429,Gao; Sicun,329,0,362,33
1739705566015,CSE 151A,A01,860874,Dasgupta; Sanjoy,297,0,325,28
1739705567043,CSE 151B,A01,864435,Yu; Qi,164,0,192,28
1739705568071,CSE 152B,A01,874283,Chandraker; Manmohan Krishna,57,0,70,13
1739705569096,CSE 153,A01,872732,McAuley; Julian John,181,0,196,15
1739705570125,CSE 153R,A01,872798,McAuley; Julian John,215,0,250,35
1739705570125,CSE 153R,B01,877492,Staff,50,0,50,0
1739705571152,CSE 165,A01,844081,Weibel; Nadir,23,0,35,12
1739705572182,CSE 168,A01,860875,Ramamoorthi; Ravi,23,0,28,5
1739705572182,CSE 168,A02,860876,Ramamoorthi; Ravi,26,0,28,2
1739705573207,CSE 175,A01,865941,Kumar; Rakesh,50,0,50,0
1739705575260,CSE 182,A01,851596,Bafna; Vineet,44,0,49,5
1739705576290,CSE 185,A01,844113,Moshiri; Niema,25,0,45,20
1739705576290,CSE 185,A02,844118,Moshiri; Niema,38,0,45,7
1739705577316,CSE 190,A00,844121,Grier; Daniel T,52,0,52,0
1739705577316,CSE 190,B00,844124,Soosai Raj; Adalbert Geral,81,0,100,19
1739705577316,CSE 190,C00,881308,Prithviraj; Ammanabrolu,45,0,50,5
1739705577316,CSE 190,D00,844127,Stefan; Deian,50,0,50,0
1739705578341,CSE 191,A00,844133,Minnes Kemp; Mor Mia,9999,0,9999,0
1739705579366,CSE 205A,A00,844166,Vianu; Victor Dan,0,0,0,0
1739705580395,CSE 209A,A00,844205,Impagliazzo; Russell,0,0,0,0
1739705581421,CSE 209B,A00,844216,Bellare; Mihir,0,0,0,0
1739705582446,CSE 217,A01,844235,Weibel; Nadir,0,0,0,0
1739705583470,CSE 219,A00,844246,Irani; Lilly C & Shvartzberg Carrio; Manuel,0,0,0,0
1739705584495,CSE 223B,A00,844249,Snoeren; Alex C.,0,0,0,0
1739705585521,CSE 224,A01,864433,Porter; George M,0,0,0,0
1739705586546,CSE 227,A00,844270,Stefan; Deian,0,0,0,0
1739705587574,CSE 229A,A00,844274,Ousterhout; Amy,0,0,0,0
1739705588598,CSE 229C,A00,844280,Fernandes; Earlence T,0,0,0,0
1739705589630,CSE 230,A00,844311,D'Antoni; Loris,0,0,0,0
1739705590655,CSE 237D,A00,844312,Kastner; Ryan Charles,0,0,0,0
1739705591683,CSE 239A,A00,844313,Vianu; Victor Dan,0,0,0,0
1739705592764,CSE 239B,A00,844314,Coblenz; Michael J,0,0,0,0
1739705593789,CSE 240A,A00,844315,Zhao; Jishen,0,0,0,0
1739705594817,CSE 241A,A00,844316,Kahng; Andrew Byun,0,0,0,0
1739705595845,CSE 250A,A00,844317,Bonjour; Trevor,0,0,0,0
1739705596873,CSE 251B,A01,864438,Yu; Qi,0,0,0,0
1739705597897,CSE 252D,A00,844320,Chandraker; Manmohan Krishna,0,0,0,0
1739705598922,CSE 253,A01,872796,McAuley; Julian John,0,0,0,0
1739705599950,CSE 253R,A01,872838,McAuley; Julian John,0,0,0,0
1739705602002,CSE 276F,A01,872476,Su; Hao,0,0,0,0
1739705603028,CSE 283,A00,844332,Bafna; Vineet & Zhong; Sheng,0,0,0,0
1739705604054,CSE 290,A00,844338,Gao; Sicun,0,0,0,0
1739705604054,CSE 290,B00,844366,Pannuto; Patrick William,0,0,0,0
1739705604054,CSE 290,C00,844379,Stefan; Deian,0,0,0,0
1739705604054,CSE 290,D00,881470,Yu; Qi,0,0,0,0
1739705604054,CSE 290,E00,844387,Chern; Albert Ren-Haur,0,0,0,0
1739705604054,CSE 290,F00,891163,Ding; Yufei,0,0,0,0
1739705605080,CSE 291,A00,844398,Bandeira; Nuno Filipe Cabrita,0,0,0,0
1739705605080,CSE 291,B00,844401,Li; Tzumao,0,0,0,0
1739705605080,CSE 291,C00,844402,Heninger; Nadia A,0,0,0,0
1739705605080,CSE 291,D00,844407,Chern; Albert Ren-Haur,0,0,0,0
1739705605080,CSE 291,E00,844409,Savage; Stefan,0,0,0,0
1739705605080,CSE 291,F00,881310,Niethammer; Marc S,0,0,0,0
1739705605080,CSE 291,H00,844419,Kahng; Andrew Byun,0,0,0,0
1739705606112,CSE 293,001,877922,Bafna; Vineet,9999,0,9999,0
1739705606112,CSE 293,002,877923,Bellare; Mihir,9999,0,9999,0
1739705606112,CSE 293,003,877942,Berg-Kirkpatrick; Taylor D,9999,0,9999,0
1739705606112,CSE 293,004,877943,Chandraker; Manmohan Krishna,9999,0,9999,0
1739705606112,CSE 293,005,877945,Cheng; Chung Kuan,9999,0,9999,0
1739705606112,CSE 293,006,877947,Christensen; Henrik I,9999,0,9999,0
1739705606112,CSE 293,007,877950,Coblenz; Michael J,9999,0,9999,0
1739705606112,CSE 293,008,877951,Cottrell; Garrison W,9999,0,9999,0
1739705606112,CSE 293,009,877952,Deutsch; Alin Bernard,9999,0,9999,0
1739705606112,CSE 293,010,877954,Esmaeilzadeh; Hadi,9999,0,9999,0
1739705606112,CSE 293,011,878049,Freund; Yoav,9999,0,9999,0
1739705606112,CSE 293,012,878145,Griswold; William G.,9999,0,9999,0
1739705606112,CSE 293,013,878152,Gymrek; Melissa Ann,9999,0,9999,0
1739705606112,CSE 293,014,878207,Heninger; Nadia A,9999,0,9999,0
1739705606112,CSE 293,015,878221,Impagliazzo; Russell,9999,0,9999,0
1739705606112,CSE 293,016,878223,Jhala; Ranjit,9999,0,9999,0
1739705606112,CSE 293,017,878262,Kahng; Andrew Byun,9999,0,9999,0
1739705606112,CSE 293,018,878267,Kane; Daniel Mertz,9999,0,9999,0
1739705606112,CSE 293,019,878270,Kriegman; David J,9999,0,9999,0
1739705606112,CSE 293,020,878273,Kumar; Arun Kumar,9999,0,9999,0
1739705606112,CSE 293,021,878275,Lerner; Sorin,9999,0,9999,0
1739705606112,CSE 293,022,878276,Lovett; Shachar,9999,0,9999,0
1739705606112,CSE 293,023,878311,McAuley; Julian John,9999,0,9999,0
1739705606112,CSE 293,024,878312,Micciancio; Daniele,9999,0,9999,0
1739705606112,CSE 293,025,878313,Orailoglu; Alex,9999,0,9999,0
1739705606112,CSE 293,026,878314,Pannuto; Patrick William,9999,0,9999,0
1739705606112,CSE 293,027,878315,Paturi; Ramamohan,9999,0,9999,0
1739705606112,CSE 293,028,878330,Polikarpova; Nadezhda,9999,0,9999,0
1739705606112,CSE 293,029,878358,Politz; Joseph Gibbs,9999,0,9999,0
1739705606112,CSE 293,030,878392,Porter; George M,9999,0,9999,0
1739705606112,CSE 293,031,878399,Porter; Leonard Emerson,9999,0,9999,0
1739705606112,CSE 293,032,878415,Ramamoorthi; Ravi,9999,0,9999,0
1739705606112,CSE 293,033,878416,Riek; Laurel D,9999,0,9999,0
1739705606112,CSE 293,034,878417,Sahoo; Debashis,9999,0,9999,0
1739705606112,CSE 293,035,878418,Saul; Lawrence,9999,0,9999,0
1739705606112,CSE 293,036,878419,Savage; Stefan,9999,0,9999,0
1739705606112,CSE 293,037,878420,Schulze; Jurgen P.,9999,0,9999,0
1739705606112,CSE 293,038,878421,Snoeren; Alex C.,9999,0,9999,0
1739705606112,CSE 293,039,878422,Shang; Jingbo,9999,0,9999,0
1739705606112,CSE 293,040,878423,Stefan; Deian,9999,0,9999,0
1739705606112,CSE 293,041,878424,Su; Hao,9999,0,9999,0
1739705606112,CSE 293,042,878425,Swanson; Steven James,9999,0,9999,0
1739705606112,CSE 293,043,878460,Tullsen; Dean Michael,9999,0,9999,0
1739705606112,CSE 293,044,878476,Vaccaro; Kristen Marie,9999,0,9999,0
1739705606112,CSE 293,045,878517,Voelker; Geoffrey M.,9999,0,9999,0
1739705606112,CSE 293,046,878541,Zhao; Jishen,9999,0,9999,0
1739705606112,CSE 293,047,878663,Zhou; Yuan-Yuan,9999,0,9999,0
1739705606112,CSE 293,048,878664,Gao; Sicun,9999,0,9999,0
1739705606112,CSE 293,049,878665,Weibel; Nadir,9999,0,9999,0
1739705606112,CSE 293,050,878666,Gupta; Rajesh K.,9999,0,9999,0
1739705606112,CSE 293,051,878667,Soosai Raj; Adalbert Geral,9999,0,9999,0
1739705606112,CSE 293,052,891170,Tu; Zhuowen,9999,0,9999,0
1739705607138,CSE 294,A00,844429,Voelker; Geoffrey M.,0,0,0,0
1739705608166,CSS 1,A01,864447,Staff,34,0,36,2
1739705608166,CSS 1,A02,864476,Staff,30,0,36,6
1739705608166,CSS 1,A03,864511,Staff,34,0,36,2
1739705608166,CSS 1,A04,864512,Staff,36,0,36,0
1739705609195,CSS 100,A01,864537,Trott; Sean Thomas,30,0,36,6
1739705609195,CSS 100,A02,864538,Trott; Sean Thomas,36,0,36,0
1739705610222,CSS 120,A01,864563,Mignozzetti; Umberto,28,0,28,0
1739705610222,CSS 120,A02,864564,Mignozzetti; Umberto,28,0,30,2
1739705611249,CSS 206,A00,812747,Mukamel; Eran A,6,0,24,18
1739705612277,CSS 209,A00,864566,Mignozzetti; Umberto,27,0,45,18
1739705613307,CSS 296,001,864568,Mignozzetti; Umberto,0,0,0,4
1739705613307,CSS 296,002,864569,Mignozzetti; Umberto,0,0,0,3
1739705613307,CSS 296,003,864571,Leas; Eric Craig,0,0,0,1
1739705613307,CSS 296,004,864577,Okonkwo; Holly,0,0,0,1
1739705613307,CSS 296,005,864605,Fleischer; Jason G,0,0,0,1
1739705613307,CSS 296,006,864634,Creel; Sarah,0,0,0,1
1739705613307,CSS 296,007,864661,Patel; Hemal,0,0,0,1
1739705613307,CSS 296,008,864688,Martin; Isaac,0,0,0,0
1739705613307,CSS 296,009,864697,Styler; William Francis,0,0,0,1
1739705613307,CSS 296,010,864751,Grigoryan; Aram,0,0,0,1
1739705613307,CSS 296,011,864752,Bonjour; Trevor,0,0,0,1
1739705613307,CSS 296,012,864753,Martin; Isaac,0,0,0,2
1739705614331,DDPM 210,A00,814899,Ma; Joseph David,29,0,32,3
1739705615358,DDPM 211,A00,814901,Ma; Joseph David,29,0,32,3
1739705616386,DDPM 214,A00,814907,Ma; Joseph David,29,0,32,3
1739705617410,DERM 296,001,866221,Eichenfield; Dawn Zhang,4,0,5,1
1739705617410,DERM 296,002,866222,Staff,5,0,5,0
1739705617410,DERM 296,003,866229,Staff,5,0,5,0
1739705618460,DOC 3,A01,813868,Staff,0,0,0,0
1739705618460,DOC 3,A02,813884,Staff,0,0,0,0
1739705618460,DOC 3,A03,813885,Staff,0,0,0,0
1739705618460,DOC 3,A04,813886,Staff,0,0,0,0
1739705618460,DOC 3,A05,813887,Staff,0,0,0,0
1739705618460,DOC 3,A06,813888,Staff,0,0,0,0
1739705618460,DOC 3,A07,813889,Staff,0,0,0,0
1739705618460,DOC 3,A08,813890,Staff,0,0,0,0
1739705618460,DOC 3,A09,813891,Staff,0,0,0,0
1739705618460,DOC 3,A10,813892,Staff,0,0,0,0
1739705618460,DOC 3,A11,813893,Staff,0,0,0,0
1739705618460,DOC 3,A12,813894,Staff,0,0,0,0
1739705618460,DOC 3,A13,813895,Staff,0,0,0,0
1739705618460,DOC 3,A14,813896,Staff,0,0,0,0
1739705618460,DOC 3,A15,813897,Staff,0,0,0,0
1739705618460,DOC 3,A16,813898,Staff,0,0,0,0
1739705618460,DOC 3,B01,813900,Staff,0,0,0,0
1739705618460,DOC 3,B02,813901,Staff,0,0,0,0
1739705618460,DOC 3,B03,813902,Staff,0,0,0,0
1739705618460,DOC 3,B04,813903,Staff,0,0,0,0
1739705618460,DOC 3,B05,813904,Staff,0,0,0,0
1739705618460,DOC 3,B06,813905,Staff,0,0,0,0
1739705618460,DOC 3,B07,813906,Staff,0,0,0,0
1739705618460,DOC 3,B08,813907,Staff,0,0,0,0
1739705618460,DOC 3,B09,813908,Staff,0,0,0,0
1739705618460,DOC 3,B10,813910,Staff,0,0,0,0
1739705618460,DOC 3,B11,813911,Staff,0,0,0,0
1739705618460,DOC 3,B12,813913,Staff,0,0,0,0
1739705618460,DOC 3,B13,813914,Staff,0,0,0,0
1739705618460,DOC 3,B14,813915,Staff,0,0,0,0
1739705618460,DOC 3,B15,813916,Staff,0,0,0,0
1739705618460,DOC 3,B16,813917,Staff,0,0,0,0
1739705618460,DOC 3,C01,813919,Staff,0,0,0,0
1739705618460,DOC 3,C02,813920,Staff,0,0,0,0
1739705618460,DOC 3,C03,813921,Staff,0,0,0,0
1739705618460,DOC 3,C04,813922,Staff,0,0,0,0
1739705618460,DOC 3,C05,813923,Staff,0,0,0,0
1739705618460,DOC 3,C06,813926,Staff,0,0,0,0
1739705618460,DOC 3,C07,813927,Staff,0,0,0,0
1739705618460,DOC 3,C08,813928,Staff,0,0,0,0
1739705618460,DOC 3,C09,813929,Staff,0,0,0,0
1739705618460,DOC 3,C10,813931,Staff,0,0,0,0
1739705618460,DOC 3,C11,813932,Staff,0,0,0,0
1739705618460,DOC 3,C12,813933,Staff,0,0,0,0
1739705618460,DOC 3,C13,813936,Staff,0,0,0,0
1739705618460,DOC 3,C14,813937,Staff,0,0,0,0
1739705618460,DOC 3,C15,813938,Staff,0,0,0,0
1739705618460,DOC 3,C16,813939,Staff,0,0,0,0
1739705618460,DOC 3,D01,813942,Staff,0,0,0,0
1739705618460,DOC 3,D02,813943,Staff,0,0,0,0
1739705618460,DOC 3,D03,813944,Staff,0,0,0,0
1739705618460,DOC 3,D04,813945,Staff,0,0,0,0
1739705618460,DOC 3,D05,813979,Staff,0,0,0,0
1739705618460,DOC 3,D06,813981,Staff,0,0,0,0
1739705618460,DOC 3,D07,813985,Staff,0,0,0,0
1739705618460,DOC 3,D08,813986,Staff,0,0,0,0
1739705618460,DOC 3,D09,813988,Staff,0,0,0,0
1739705618460,DOC 3,D10,813991,Staff,0,0,0,0
1739705618460,DOC 3,D11,813993,Staff,0,0,0,0
1739705618460,DOC 3,D12,813994,Staff,0,0,0,0
1739705618460,DOC 3,D13,814000,Staff,0,0,0,0
1739705618460,DOC 3,D14,814002,Staff,0,0,0,0
1739705618460,DOC 3,D15,814003,Staff,0,0,0,0
1739705618460,DOC 3,D16,814012,Staff,0,0,0,0
1739705618460,DOC 3,D17,814014,Staff,0,0,0,0
1739705619483,DOC 100D,A00,814015,Pass; Natalye,24,0,25,1
1739705619483,DOC 100D,B00,814017,Pass; Natalye,24,0,25,1
1739705620513,DSC 10,A01,841644,Tiefenbruck; Janine LoBue,146,0,146,0
1739705620513,DSC 10,B01,870243,Tiefenbruck; Janine LoBue,143,0,146,3
1739705621540,DSC 20,A01,841647,Langlois; Marina,60,0,60,0
1739705621540,DSC 20,B01,841649,Langlois; Marina,60,0,60,0
1739705622570,DSC 30,A01,841651,Liao; Soohyun Nam,189,0,190,1
1739705622570,DSC 30,B01,841653,Liao; Soohyun Nam,188,0,190,2
1739705623594,DSC 40A,A01,841659,Shannon; Kyle Michael,143,0,146,3
1739705624621,DSC 40B,A01,841663,Eldridge; Justin Matthew,175,0,180,5
1739705625650,DSC 80,A01,841667,Rahman; Tauhidur,116,0,120,4
1739705626676,DSC 95,A01,841669,Tiefenbruck; Janine LoBue,40,0,40,0
1739705627704,DSC 100,A01,841671,Salimi; Babak,146,0,146,0
1739705628729,DSC 102,A01,841674,Staff,293,0,300,7
1739705629754,DSC 106,B01,841679,Lau; Samuel Ethan,98,0,100,2
1739705629754,DSC 106,C01,841681,Lau; Samuel Ethan,100,0,100,0
1739705630780,DSC 140A,A01,841683,Ustun; Tevfik Berk,150,0,150,0
1739705631807,DSC 140B,A01,841687,Weng; Tsui-Wei (lily),121,0,125,4
1739705632835,DSC 161,A00,841688,Roberts; Margaret Earling,40,0,40,0
1739705633861,DSC 190,A01,841690,Silberman; Jack,30,0,30,0
1739705633861,DSC 190,B01,841692,Langlois; Marina,99,0,100,1
1739705633861,DSC 190,C01,841694,Weng; Tsui-Wei (lily),28,0,30,2
1739705633861,DSC 190,D01,841696,Ustun; Tevfik Berk,30,0,30,0
1739705634889,DSC 197,001,841699,Eldridge; Justin Matthew,9999,0,9999,0
1739705635916,DSC 204A,A00,841700,Bellur; Umesh,0,0,0,0
1739705636939,DSC 208R,A01,841703,Jin; Haojian,34,0,40,6
1739705637965,DSC 212,A00,841705,Staff,77,0,90,13
1739705638991,DSC 214,A00,841706,Wang; Yusu,0,0,60,60
1739705640020,DSC 232R,A01,841708,Solares; Edwin A,49,0,80,31
1739705641048,DSC 240,A00,841710,Belkin; Mikhail,114,0,120,6
1739705642074,DSC 241,A00,841712,Schwartzman; Armin,20,0,90,70
1739705643099,DSC 255R,A01,841714,Staff,32,0,40,8
1739705644125,DSC 258R,A01,841716,Shang; Jingbo,35,0,60,25
1739705645149,DSC 267R,A01,841718,Danks; David J,53,0,60,7
1739705646174,DSC 291,A00,841719,Ustun; Tevfik Berk,0,0,30,30
1739705646174,DSC 291,B00,841723,Huang; Biwei,3,0,60,57
1739705646174,DSC 291,C00,841724,Weng; Tsui-Wei (lily),0,0,30,30
1739705646174,DSC 291,D00,841725,Hu; Zhiting,54,0,90,36
1739705646174,DSC 291,E00,841726,Warstadt; Alexander Scott,7,0,60,53
1739705647202,DSC 293,A00,841727,Ustun; Tevfik Berk,9995,0,9999,4
1739705648228,DSC 297,001,872917,Rahman; Tauhidur,9999,0,9999,0
1739705649254,DSE 210,A00,869159,Staff,20,0,20,0
1739705650279,DSE 230,A00,813774,Staff,25,0,25,0
1739705651305,DSE 260B,A00,813775,Staff,25,0,25,0
1739705652335,DSGN 1,A01,810429,Klemmer; Scott R,49,0,50,1
1739705652335,DSGN 1,A02,810431,Klemmer; Scott R,49,0,50,1
1739705652335,DSGN 1,A03,810434,Klemmer; Scott R,50,0,50,0
1739705652335,DSGN 1,A04,810436,Klemmer; Scott R,48,0,50,2
1739705652335,DSGN 1,A05,810438,Klemmer; Scott R,39,0,40,1
1739705653363,DSGN 2,A01,810443,Hollan; James D.,49,0,50,1
1739705654390,DSGN 100,A01,811981,Rill; Bryan,18,0,18,0
1739705654390,DSGN 100,A02,811982,Rill; Bryan,10,0,18,8
1739705654390,DSGN 100,A03,811983,Rill; Bryan,15,0,18,3
1739705654390,DSGN 100,A04,812053,Rill; Bryan,6,0,16,10
1739705655415,DSGN 119,A00,812054,Irani; Lilly C & Shvartzberg Carrio; Manuel,63,0,80,17
1739705657466,DSGN 219,A00,812273,Irani; Lilly C & Shvartzberg Carrio; Manuel,12,0,15,3
1739705658500,ECE 5,A01,816583,Morris; Karcher William,0,0,0,0
1739705658500,ECE 5,A02,816584,Morris; Karcher William,0,0,0,0
1739705658500,ECE 5,A03,816586,Morris; Karcher William,22,0,22,0
1739705658500,ECE 5,A04,816589,Morris; Karcher William,22,0,22,0
1739705659526,ECE 15,A01,816591,Sahay; Rajeev,114,0,120,6
1739705660551,ECE 16,A01,816594,Wang; Edward Jay,25,0,30,5
1739705661576,ECE 17,A01,816599,Sahay; Rajeev,67,0,75,8
1739705662606,ECE 25,A50,816722,Dey; Sujit,30,0,30,0
1739705662606,ECE 25,A51,816734,Dey; Sujit,29,0,30,1
1739705663631,ECE 30,A50,816809,Mir Arabbaygi; Siavash,25,0,30,5
1739705663631,ECE 30,A51,816811,Mir Arabbaygi; Siavash,25,0,30,5
1739705663631,ECE 30,A52,816812,Mir Arabbaygi; Siavash,30,0,30,0
1739705663631,ECE 30,A53,816814,Mir Arabbaygi; Siavash,30,0,30,0
1739705663631,ECE 30,A54,816817,Mir Arabbaygi; Siavash,27,0,27,0
1739705664661,ECE 35,A50,816821,Ndao; Abdoulaye,25,0,26,1
1739705664661,ECE 35,A51,816822,Ndao; Abdoulaye,24,0,26,2
1739705664661,ECE 35,A52,816825,Ndao; Abdoulaye,26,0,26,0
1739705664661,ECE 35,A53,816826,Ndao; Abdoulaye,26,0,26,0
1739705665686,ECE 45,A01,816828,Zeger; Kenneth A.,187,0,192,5
1739705666712,ECE 65,A50,816873,Baghdadchi; Saharnaz,28,0,30,2
1739705666712,ECE 65,A51,816874,Baghdadchi; Saharnaz,28,0,30,2
1739705666712,ECE 65,A52,816877,Baghdadchi; Saharnaz,30,0,30,0
1739705666712,ECE 65,A53,816880,Baghdadchi; Saharnaz,30,0,30,0
1739705666712,ECE 65,A54,816882,Baghdadchi; Saharnaz,30,0,30,0
1739705666712,ECE 65,A55,816883,Baghdadchi; Saharnaz,29,0,30,1
1739705666712,ECE 65,A56,816884,Baghdadchi; Saharnaz,30,0,30,0
1739705667740,ECE 100,A01,816926,Hsueh; Tzu-Chien,29,0,30,1
1739705667740,ECE 100,A02,816939,Hsueh; Tzu-Chien,26,0,30,4
1739705667740,ECE 100,A03,816945,Hsueh; Tzu-Chien,29,0,30,1
1739705667740,ECE 100,A04,816950,Hsueh; Tzu-Chien,29,0,30,1
1739705667740,ECE 100,A05,816962,Hsueh; Tzu-Chien,29,0,30,1
1739705668766,ECE 101,A01,816993,Siegel; Paul H.,57,0,60,3
1739705668766,ECE 101,A02,817165,Siegel; Paul H.,57,0,60,3
1739705669791,ECE 103,A01,817352,Nomura; Kenji,43,0,50,7
1739705670814,ECE 108,A01,817373,Kang; Mingu,99,0,120,21
1739705671844,ECE 109,A01,817418,Orlitsky; Alon,72,0,73,1
1739705671844,ECE 109,A02,817420,Orlitsky; Alon,73,0,73,0
1739705672872,ECE 111,A01,817426,Eldon; John,167,0,180,13
1739705673900,ECE 115,A01,817432,Yip; Michael,20,0,26,6
1739705674928,ECE 123,A01,817448,Sievenpiper; Daniel F.,28,0,37,9
1739705675954,ECE 125B,A50,817453,Esmaili; Gholamreza,18,0,24,6
1739705675954,ECE 125B,A51,817455,Esmaili; Gholamreza,23,0,24,1
1739705676982,ECE 134,A00,817457,Ng; Tse Nga,47,0,50,3
1739705678009,ECE 136L,A01,817459,Dayeh; Shadi Ahmad,5,0,5,0
1739705678009,ECE 136L,A02,817461,Dayeh; Shadi Ahmad,2,0,5,3
1739705678009,ECE 136L,A03,817462,Dayeh; Shadi Ahmad,3,0,5,2
1739705678009,ECE 136L,A04,817463,Dayeh; Shadi Ahmad,4,0,5,1
1739705679038,ECE 139,A00,817537,Nomura; Kenji,29,0,30,1
1739705680070,ECE 140B,A50,817654,Khoshabeh; Ramsin & Gessner; Richard K.,23,0,24,1
1739705680070,ECE 140B,A51,817662,Khoshabeh; Ramsin & Gessner; Richard K.,22,0,24,2
1739705680070,ECE 140B,A52,817663,Khoshabeh; Ramsin & Gessner; Richard K.,22,0,22,0
1739705681096,ECE 141B,A01,872372,Gessner; Richard K.,26,0,30,4
1739705682124,ECE 148,A01,817698,Silberman; Jack,22,0,26,4
1739705683153,ECE 153,A01,817703,Naghizadeh Ardabili; Parinaz,74,0,90,16
1739705684178,ECE 157A,A01,817708,Bharadia; Dinesh,21,0,25,4
1739705685204,ECE 161C,A00,817865,Harris; Frederick Joel,48,0,50,2
1739705686230,ECE 165,A51,817880,Mercier; Patrick Philip,26,0,30,4
1739705686230,ECE 165,A52,817882,Mercier; Patrick Philip,23,0,30,7
1739705686230,ECE 165,A53,817885,Mercier; Patrick Philip,27,0,30,3
1739705686230,ECE 165,A54,817888,Mercier; Patrick Philip,29,0,30,1
1739705687264,ECE 171A,A01,817892,Zheng; Yang,93,0,100,7
1739705688291,ECE 175B,A01,817899,Xie; Pengtao,47,0,50,3
1739705689316,ECE 183,A01,817903,Mookherjea; Shayan,26,0,30,4
1739705690342,ECE 185,A01,817907,Liu; Zhaowei,20,0,20,0
1739705691373,ECE 196,A00,817908,Morris; Karcher William,15,0,24,9
1739705691373,ECE 196,B00,817913,Morris; Karcher William,26,0,28,2
1739705692399,ECE 197,001,816579,Mercier; Patrick Philip,9999,0,9999,0
1739705693422,ECE 198,001,816580,Nguyen; Truong Quang,9999,0,9999,0
1739705694447,ECE 204,A00,817918,Alexandrov; Ludmil B,0,0,0,0
1739705695474,ECE 208,A00,817920,Mir Arabbaygi; Siavash,0,0,0,0
1739705696555,ECE 212CN,A00,817921,Liu; Zhaowei,0,0,0,0
1739705697582,ECE 222D,A00,817922,Sievenpiper; Daniel F.,0,0,0,0
1739705698606,ECE 227,A00,817926,Franceschetti; Massimo,0,0,0,0
1739705699631,ECE 228,A00,817928,Shi; Yuanyuan,0,0,0,0
1739705700658,ECE 236B,A00,817929,Lo; Yu-Hwa,0,0,0,0
1739705701685,ECE 238B,A00,817934,Garay; Javier,0,0,0,0
1739705702714,ECE 240C,A00,818013,Mookherjea; Shayan,0,0,0,0
1739705703742,ECE 241A,A00,818014,Rubin; Noah,0,0,0,0
1739705704767,ECE 251B,A00,818015,Vasconcelos; Manuela,0,0,0,0
1739705705791,ECE 258B,A00,818016,Milstein; Laurence B.,0,0,0,0
1739705706820,ECE 260C,A00,818017,Kahng; Andrew Byun,0,0,0,0
1739705707845,ECE 264B,A00,818018,Galton; Ian A,0,0,0,0
1739705708873,ECE 265B,A00,818019,Gudem; Prasad S.S.,0,0,0,0
1739705709901,ECE 266,A01,818021,Hall; Drew A.,0,0,0,0
1739705710927,ECE 268,A00,818022,Koushanfar; Farinaz,0,0,0,0
1739705711955,ECE 272A,A01,818064,Poveda Fonseca; Jorge,0,0,0,0
1739705712982,ECE 273,A00,818065,Wang; Jun-Kun,0,0,0,0
1739705714007,ECE 275A,A00,818066,Meyer; Florian,0,0,0,0
1739705715038,ECE 276B,A00,818067,Atanasov; Nikolay A.,0,0,0,0
1739705716063,ECE 284,A00,818068,Wang; Edward,0,0,0,0
1739705717093,ECE 285,A00,818069,Wang; Xiaolong,0,0,0,0
1739705717093,ECE 285,B00,818070,Antipa; Nicholas A,0,0,0,0
1739705717093,ECE 285,C00,818071,Xie; Pengtao,0,0,0,0
1739705718119,ECE 287,A00,872497,Gonzalez Prelcic; Nuria,0,0,0,0
1739705719144,ECON 1,A01,814026,Famulari; Melissa,118,0,120,2
1739705719144,ECON 1,A02,814028,Famulari; Melissa,114,0,115,1
1739705719144,ECON 1,A03,814029,Famulari; Melissa,115,0,115,0
1739705719144,ECON 1,B01,814039,Famulari; Melissa,46,0,50,4
1739705720170,ECON 2,A01,814045,Crane; Meredith Helen,95,0,96,1
1739705721199,ECON 3,A01,814154,Crane; Meredith Helen,91,0,95,4
1739705721199,ECON 3,A02,814155,Crane; Meredith Helen,93,0,95,2
1739705721199,ECON 3,B01,814188,Crane; Meredith Helen,95,0,95,0
1739705721199,ECON 3,B02,814195,Crane; Meredith Helen,91,0,95,4
1739705722226,ECON 4,A01,814197,Levkoff; Steven B.,50,0,54,4
1739705722226,ECON 4,A02,814210,Levkoff; Steven B.,54,0,54,0
1739705722226,ECON 4,A03,814224,Levkoff; Steven B.,54,0,54,0
1739705722226,ECON 4,B01,814273,Brooks; Marcus Raymond,3,0,3,0
1739705723252,ECON 5,A01,814495,Arnold; David Hall,66,0,72,6
1739705723252,ECON 5,A02,814507,Arnold; David Hall,72,0,72,0
1739705723252,ECON 5,A03,814508,Arnold; David Hall,71,0,72,1
1739705723252,ECON 5,A04,814509,Arnold; David Hall,71,0,72,1
1739705723252,ECON 5,A05,814510,Arnold; David Hall,72,0,72,0
1739705723252,ECON 5,B01,814513,Dai; Yinlin,44,0,45,1
1739705723252,ECON 5,B02,814514,Dai; Yinlin,39,0,45,6
1739705724280,ECON 100A,A01,814516,Newhouse; Herbert S,76,0,79,3
1739705724280,ECON 100A,A02,814517,Newhouse; Herbert S,79,0,79,0
1739705724280,ECON 100A,B01,814519,Newhouse; Herbert S,82,0,83,1
1739705724280,ECON 100A,B02,814520,Newhouse; Herbert S,73,0,75,2
1739705725308,ECON 100AH,A00,814521,Famulari; Melissa,20,0,20,0
1739705726338,ECON 100B,A01,814523,Boomhower; Judson P,74,0,85,11
1739705726338,ECON 100B,A02,814524,Boomhower; Judson P,82,0,85,3
1739705726338,ECON 100B,A03,814525,Boomhower; Judson P,78,0,80,2
1739705726338,ECON 100B,B01,814527,Boomhower; Judson P,0,0,0,0
1739705727364,ECON 100BH,A00,814528,Boomhower; Judson P,20,0,20,0
1739705728387,ECON 100C,A01,814530,Newhouse; Herbert S,95,0,98,3
1739705728387,ECON 100C,A02,814531,Newhouse; Herbert S,98,0,98,0
1739705729415,ECON 101,A00,814532,Esfahani; Sara,112,0,120,8
1739705730439,ECON 109T,A00,814533,Trevino; Isabel,20,0,20,0
1739705731465,ECON 110A,A01,814535,Candido; Maria Teresa,97,0,100,3
1739705732494,ECON 110B,A01,814537,Herreno Lopera; Juan,91,0,100,9
1739705732494,ECON 110B,A02,814538,Herreno Lopera; Juan,100,0,100,0
1739705732494,ECON 110B,A03,814539,Herreno Lopera; Juan,99,0,100,1
1739705732494,ECON 110B,A04,814540,Herreno Lopera; Juan,98,0,100,2
1739705733520,ECON 120A,A01,814542,Dai; Yinlin,90,0,95,5
1739705733520,ECON 120A,A02,814543,Dai; Yinlin,94,0,95,1
1739705733520,ECON 120A,B01,814545,Dai; Yinlin,93,0,95,2
1739705733520,ECON 120A,B02,814546,Dai; Yinlin,94,0,95,1
1739705734548,ECON 120B,A01,814548,Candido; Maria Teresa,91,0,95,4
1739705734548,ECON 120B,A02,814549,Candido; Maria Teresa,89,0,95,6
1739705734548,ECON 120B,B01,814551,Candido; Maria Teresa,91,0,95,4
1739705734548,ECON 120B,B02,814552,Candido; Maria Teresa,95,0,95,0
1739705735578,ECON 120C,A01,814554,Sun; Yixiao,38,0,40,2
1739705735578,ECON 120C,B01,814556,Sun; Yixiao,33,0,40,7
1739705735578,ECON 120C,C01,814585,Sun; Yixiao,39,0,40,1
1739705736603,ECON 125,A00,814588,Vogl; Tom Saul,96,0,100,4
1739705737627,ECON 129,A00,814589,Eckert; Fabian Paul,99,0,100,1
1739705738653,ECON 132,A00,814595,Carson; Richard T,72,0,75,3
1739705738653,ECON 132,B00,814599,Carson; Richard T,73,0,75,2
1739705739679,ECON 132T,A00,814600,Carson; Richard T,20,0,20,0
1739705740703,ECON 134,A00,814601,Gelber; Alexander Michael,47,0,50,3
1739705741732,ECON 137,A00,814602,Niehaus; Paul,20,0,20,0
1739705742756,ECON 140,A00,814630,Clemens; Jeffrey,44,0,49,5
1739705743781,ECON 142,A00,814647,Trevino; Isabel,50,0,50,0
1739705743781,ECON 142,B00,814656,Trevino; Isabel,45,0,50,5
1739705744807,ECON 147,A00,814683,Betts; Julian,100,0,100,0
1739705745831,ECON 164,A00,814684,Muralidharan; Karthik,219,0,220,1
1739705746856,ECON 168,A00,814691,Maron; Asa,74,0,80,6
1739705747882,ECON 173B,A01,814700,Levkoff; Steven B.,39,0,40,1
1739705747882,ECON 173B,B01,814734,Levkoff; Steven B.,40,0,40,0
1739705748906,ECON 191A,A00,814768,Cullen; Julie,20,0,20,0
1739705749931,ECON 200C,A00,814811,Grigoryan; Aram & Trevino; Isabel & Sobel; Joel,24,0,25,1
1739705750959,ECON 210C,A00,814815,Herreno Lopera; Juan,25,0,25,0
1739705751984,ECON 220C,A00,814816,Sun; Yixiao,23,0,25,2
1739705753010,ECON 220F,A00,814817,Carson; Richard T,28,0,30,2
1739705754039,ECON 221,A00,814818,Zhu; Ying,15,0,15,0
1739705755066,ECON 241,A00,814819,Muralidharan; Karthik,14,0,15,1
1739705756092,ECON 243,A00,814820,Niehaus; Paul & Adhvaryu; Achyuta Rasendra,15,0,15,0
1739705757121,ECON 248,A00,814821,Eckert; Fabian Paul & Trottner; Fabian Gunter We,13,0,15,2
1739705758146,ECON 250C,A00,814840,Arnold; David Hall & Betts; Julian,24,0,25,1
1739705759174,ECON 281,A00,814850,Wu; Pak Yeung & Herreno Lopera; Juan,14,0,15,1
1739705760202,ECON 285,A00,814851,Eckert; Fabian Paul,25,0,25,0
1739705761226,ECON 286,A00,814852,Hamilton; James D.,20,0,20,0
1739705761226,ECON 286,B00,814853,Shishkin; Denis,19,0,20,1
1739705762251,ECON 296,A00,814854,Eckert; Fabian Paul,24,0,25,1
1739705763276,EDS 31,A00,815023,Brydges; Stacey,17,0,20,3
1739705764303,EDS 39,A01,815025,Heinzman; Erica M.,25,0,25,0
1739705765331,EDS 102,A01,815042,Hopkins; Megan Beth,40,0,45,5
1739705767384,EDS 115,A00,815058,Jones; Gabrielle Anastasia,48,0,50,2
1739705768413,EDS 117,A01,851605,Jones; Makeba,33,0,37,4
1739705768413,EDS 117,A02,851607,Jones; Makeba,35,0,37,2
1739705768413,EDS 117,A03,851608,Jones; Makeba,38,0,38,0
1739705768413,EDS 117,A04,851610,Jones; Makeba,36,0,38,2
1739705768413,EDS 117,B01,870849,Staff,24,0,25,1
1739705768413,EDS 117,B02,870920,Staff,25,0,25,0
1739705768413,EDS 117,B03,870978,Staff,25,0,25,0
1739705768413,EDS 117,B04,870979,Staff,25,0,25,0
1739705769439,EDS 118,A00,815184,Staff,57,0,60,3
1739705770462,EDS 123,A00,815186,Brydges; Stacey,20,0,20,0
1739705771486,EDS 124AR,A00,815196,Simon; Elizabeth A,189,0,200,11
1739705771486,EDS 124AR,B00,815197,Simon; Elizabeth A,99,0,100,1
1739705771486,EDS 124AR,C00,872649,Simon; Elizabeth A,40,0,40,0
1739705772512,EDS 124BR,A00,815259,Eguchi; Emi,57,0,75,18
1739705772512,EDS 124BR,B00,872641,Eguchi; Emi,25,0,25,0
1739705773538,EDS 125,A00,815260,Aragon; Maria Jose,55,0,60,5
1739705774563,EDS 126,A01,851619,Jones; Makeba,25,0,33,8
1739705774563,EDS 126,A02,815283,Jones; Makeba,31,0,33,2
1739705774563,EDS 126,A03,815284,Jones; Makeba,33,0,34,1
1739705775589,EDS 128B,A01,815311,Pappas; Elizabeth,24,0,25,1
1739705775589,EDS 128B,A02,815312,Pappas; Elizabeth,25,0,25,0
1739705775589,EDS 128B,A03,870748,Pappas; Elizabeth,20,0,20,0
1739705776628,EDS 129C,A01,815314,Millstone; Rachel Diana,60,0,60,0
1739705777657,EDS 130,A01,815383,Mendez; Kathrina Mendoza,18,0,20,2
1739705777657,EDS 130,A02,815384,Mendez; Kathrina Mendoza,20,0,20,0
1739705777657,EDS 130,A03,815390,Mendez; Kathrina Mendoza,20,0,20,0
1739705778682,EDS 133,A01,815456,Bintliff; Amy S.V.,12,0,15,3
1739705778682,EDS 133,A02,815457,Bintliff; Amy S.V.,15,0,15,0
1739705778682,EDS 133,A03,815458,Bintliff; Amy S.V.,14,0,15,1
1739705778682,EDS 133,A04,815459,Bintliff; Amy S.V.,10,0,10,0
1739705779709,EDS 136,A01,815462,Hemans; Patricia Ann Benitez,17,0,20,3
1739705779709,EDS 136,A02,815463,Hemans; Patricia Ann Benitez,20,0,20,0
1739705779709,EDS 136,A03,815467,Hemans; Patricia Ann Benitez,20,0,20,0
1739705780738,EDS 139,A00,815469,Pappas; Elizabeth,47,0,50,3
1739705780738,EDS 139,B00,815470,Millstone; Rachel Diana,60,0,60,0
1739705780738,EDS 139,C00,815471,Mendez; Kathrina Mendoza,58,0,60,2
1739705780738,EDS 139,D00,815472,Bintliff; Amy S.V.,57,0,60,3
1739705780738,EDS 139,E00,815473,Hemans; Patricia Ann Benitez,57,0,60,3
1739705780738,EDS 139,F00,815474,Mamas; Christoforos,32,0,35,3
1739705780738,EDS 139,G00,815583,Choi; Bailey Miyeon,30,0,30,0
1739705780738,EDS 139,H00,815588,Bintliff; Amy S.V.,20,0,20,0
1739705781764,EDS 141,A00,815592,Mamas; Christoforos,34,0,35,1
1739705782790,EDS 145,A01,815629,Choi; Bailey Miyeon,13,0,15,2
1739705782790,EDS 145,A02,815630,Choi; Bailey Miyeon,15,0,15,0
1739705783815,EDS 164R,A01,815632,Staff,37,0,40,3
1739705783815,EDS 164R,B01,872639,Staff,20,0,20,0
1739705784840,EDS 165,A00,815635,Jones; Gabrielle Anastasia,29,0,30,1
1739705785867,EDS 180,A00,815642,Chapman; Thandeka K,24,0,25,1
1739705785867,EDS 180,B00,886111,Eguchi; Emi,30,0,30,0
1739705786893,EDS 190,A00,889678,Bintliff; Amy S.V.,4,0,5,1
1739705787918,EDS 205B,A00,815645,Halter; Christopher P.,48,0,50,2
1739705788943,EDS 253,A00,815646,Staff,14,0,15,1
1739705789971,EDS 266,A00,815647,Phuong; Andrew,11,0,12,1
1739705790999,EDS 282,A00,815649,Daly; Alan J.,15,0,15,0
1739705792025,EDS 287B,A00,815650,Daly; Alan J.,15,0,15,0
1739705793051,EDS 288A,A00,815651,Bjorklund; Peter,15,0,15,0
1739705794079,EDS 288B,A00,815694,Chapman; Thandeka K,19,0,20,1
1739705795103,EDS 288C,A00,815695,Staff,15,0,15,0
1739705796128,EDS 289B,A01,815710,Daly; Alan J.,15,0,15,0
1739705797156,EDS 290,A00,815711,Millstone; Rachel Diana,20,0,20,0
1739705797156,EDS 290,B00,815712,Heinzman; Erica M.,20,0,20,0
1739705797156,EDS 290,C00,815717,Choi; Bailey Miyeon,21,0,21,0
1739705797156,EDS 290,D00,815727,Black; Alison Michelle,20,0,20,0
1739705798181,EDS 293B,A01,815735,Burrell; Sade Renee,15,0,15,0
1739705799207,EDS 294B,A00,815745,Meyerott; Theresa Ann,15,0,15,0
1739705800294,EDS 296,001,814911,Ambo; Theresa Jean,10,0,10,0
1739705800294,EDS 296,002,814917,Aragon; Maria Jose,9,0,10,1
1739705800294,EDS 296,003,814918,Bintliff; Amy S.V.,10,0,10,0
1739705800294,EDS 296,004,814922,Chapman; Thandeka K,10,0,10,0
1739705800294,EDS 296,005,814927,Cohen; Shana R,10,0,10,0
1739705800294,EDS 296,006,814929,Daly; Alan J.,10,0,10,0
1739705800294,EDS 296,007,814930,Eguchi; Emi,10,0,10,0
1739705800294,EDS 296,008,814947,Datnow; Amanda Lee,10,0,10,0
1739705800294,EDS 296,009,814948,Halter; Christopher P.,10,0,10,0
1739705800294,EDS 296,010,814953,Hofstetter; Carolyn,10,0,10,0
1739705800294,EDS 296,011,814954,Hopkins; Megan Beth,10,0,10,0
1739705800294,EDS 296,012,814955,Jones; Gabrielle Anastasia,10,0,10,0
1739705800294,EDS 296,013,814958,Jones; Makeba,10,0,10,0
1739705800294,EDS 296,014,814961,Mamas; Christoforos,10,0,10,0
1739705800294,EDS 296,015,814962,Museus; Samuel David,10,0,10,0
1739705800294,EDS 296,016,814966,Pollock; Mica,10,0,10,0
1739705800294,EDS 296,017,814967,Wishard Guerra; Alison G.,10,0,10,0
1739705800294,EDS 296,018,886234,Clarke; Sherice Nicole,10,0,10,0
1739705800294,EDS 296,019,886235,Cohen; Shana R,10,0,10,0
1739705800294,EDS 296,020,886236,Fine; Sarah,10,0,10,0
1739705801327,EMED 296,001,866359,Daniel; Michelle Marie,4,0,5,1
1739705801327,EMED 296,002,866361,Staff,5,0,5,0
1739705801327,EMED 296,003,866363,Staff,5,0,5,0
1739705802352,ENG 10,A00,813776,Evdokimenko; Ekaterina,60,0,60,0
1739705803382,ENG 30,A01,869879,Schurgers; Curt,30,0,30,0
1739705804408,ENG 100D,A00,813777,Ngo; Anh-Thu T.,43,0,50,7
1739705804408,ENG 100D,B00,887051,Ngo; Anh-Thu T.,48,0,50,2
1739705805435,ENG 100L,A00,813778,Kleissl; Jan,6,0,6,0
1739705805435,ENG 100L,B00,813780,Bratton; Maryann,8,0,8,0
1739705805435,ENG 100L,C00,813781,Yu; Paul K L,8,0,8,0
1739705805435,ENG 100L,D00,813782,Goldberg; Charles G.,6,0,6,0
1739705805435,ENG 100L,E00,813783,de Oliveira; Mauricio,8,0,8,0
1739705805435,ENG 100L,F00,813852,Bratton; Maryann,6,0,6,0
1739705805435,ENG 100L,G00,813856,Boyle; Mary E. T.,15,0,15,0
1739705805435,ENG 100L,H00,813860,Boyle; Mary E. T.,15,0,15,0
1739705806465,ENVR 102,A00,818253,Lin; Cindy Jih-Shing,23,0,25,2
1739705806465,ENVR 102,B00,818254,Montejo; Carolina,25,0,25,0
1739705806465,ENVR 102,C00,818255,Staff,24,0,25,1
1739705806465,ENVR 102,E00,818257,Daly; Heather Marie,18,0,20,2
1739705807509,ENVR 140,A01,818259,Siapno; Jacqueline A,13,0,15,2
1739705807509,ENVR 140,A02,818260,Siapno; Jacqueline A,13,0,15,2
1739705807509,ENVR 140,A03,818261,Siapno; Jacqueline A,13,0,15,2
1739705807509,ENVR 140,A04,818290,Siapno; Jacqueline A,14,0,15,1
1739705808539,ESYS 103,A01,818299,Lerner; Amy M,30,0,34,4
1739705808539,ESYS 103,A02,818300,Lerner; Amy M,33,0,34,1
1739705808539,ESYS 103,A03,818301,Lerner; Amy M,24,0,34,10
1739705808539,ESYS 103,A04,818302,Lerner; Amy M,32,0,34,2
1739705808539,ESYS 103,A05,818322,Lerner; Amy M,31,0,34,3
1739705808539,ESYS 103,A06,818385,Lerner; Amy M,30,0,30,0
1739705809564,ESYS 187C,A01,818387,Hetherington; Elizabeth Dorsey,32,0,40,8
1739705809564,ESYS 187C,A02,818388,Hetherington; Elizabeth Dorsey,39,0,40,1
1739705810596,ETHN 3R,A01,818390,Okonkwo; Holly,21,0,25,4
1739705810596,ETHN 3R,A02,818391,Okonkwo; Holly,24,0,25,1
1739705810596,ETHN 3R,A03,818392,Okonkwo; Holly,23,0,25,2
1739705810596,ETHN 3R,A04,818393,Okonkwo; Holly,23,0,25,2
1739705810596,ETHN 3R,A05,818394,Okonkwo; Holly,22,0,25,3
1739705810596,ETHN 3R,A06,818395,Okonkwo; Holly,22,0,25,3
1739705810596,ETHN 3R,A07,818396,Okonkwo; Holly,23,0,25,2
1739705810596,ETHN 3R,A08,818397,Okonkwo; Holly,25,0,25,0
1739705810596,ETHN 3R,A09,818398,Okonkwo; Holly,25,0,25,0
1739705810596,ETHN 3R,A10,818399,Okonkwo; Holly,23,0,25,2
1739705810596,ETHN 3R,A11,818400,Okonkwo; Holly,24,0,25,1
1739705810596,ETHN 3R,A12,818401,Okonkwo; Holly,24,0,25,1
1739705810596,ETHN 3R,A13,818402,Okonkwo; Holly,24,0,25,1
1739705810596,ETHN 3R,A14,818403,Okonkwo; Holly,23,0,25,2
1739705811622,ETHN 30,A01,818405,Fuste; Jose Ignacio,24,0,25,1
1739705811622,ETHN 30,A02,818406,Fuste; Jose Ignacio,22,0,25,3
1739705811622,ETHN 30,A03,818407,Fuste; Jose Ignacio,25,0,25,0
1739705811622,ETHN 30,A04,818408,Fuste; Jose Ignacio,25,0,25,0
1739705811622,ETHN 30,A05,818409,Fuste; Jose Ignacio,25,0,25,0
1739705811622,ETHN 30,A06,818410,Fuste; Jose Ignacio,25,0,25,0
1739705812650,ETHN 100C,A00,818411,Fuste; Jose Ignacio,32,0,36,4
1739705813675,ETHN 101,A01,818413,Marez; Curtis F.,23,0,25,2
1739705813675,ETHN 101,A02,818414,Marez; Curtis F.,24,0,25,1
1739705813675,ETHN 101,A03,818415,Marez; Curtis F.,25,0,25,0
1739705813675,ETHN 101,A04,818416,Marez; Curtis F.,23,0,25,2
1739705814702,ETHN 108,A00,818418,Hankins; Sarah E.,15,0,20,5
1739705815730,ETHN 110,A00,818419,Klann; Mary Cameron,23,0,30,7
1739705816755,ETHN 112C,A00,818420,Frank; Ross H.,28,0,30,2
1739705817783,ETHN 121R,A00,818422,Choi; Esther Min,35,0,45,10
1739705818811,ETHN 122B,A00,891172,Museus; Samuel David,50,0,50,0
1739705820860,ETHN 127,A00,818424,Cuong; Marisol,27,0,30,3
1739705821884,ETHN 140,A00,818426,Tran; Ly Thi Hai,30,0,30,0
1739705822912,ETHN 142,A00,818429,Wilson; Brenda K,27,0,30,3
1739705823936,ETHN 147,A00,872912,Staff,20,0,20,0
1739705824960,ETHN 171,A00,869845,Gallagher-Geurtsen; Tricia Meghan,29,0,30,1
1739705825985,ETHN 172,A00,818477,Childs; Dennis R.,20,0,20,0
1739705827009,ETHN 174,A00,818481,Childs; Dennis R.,20,0,20,0
1739705828037,ETHN 182,A00,818487,Streeby; Shelley,58,0,60,2
1739705829062,ETHN 183,A00,818489,Cuong; Marisol,21,0,22,1
1739705830089,ETHN 189,A00,818496,Museus; Samuel David,20,0,20,0
1739705831115,ETHN 196H,A00,885505,Fuste; Jose Ignacio,0,0,0,0
1739705831115,ETHN 196H,B00,885506,Klann; Mary Cameron,0,0,0,0
1739705831115,ETHN 196H,C00,885507,Museus; Samuel David,0,0,0,0
1739705831115,ETHN 196H,D00,885524,Taylor-Garcia; Daphne,0,0,0,0
1739705831115,ETHN 196H,E00,885706,Wilson; Brenda K,0,0,0,1
1739705832140,ETHN 200C,A00,818498,Frank; Ross H.,11,0,15,4
1739705833165,ETHN 230,A00,818501,Perreira; Christopher Michael,11,0,15,4
1739705834191,ETHN 291,A00,818504,Streeby; Shelley,15,0,15,0
1739705835216,ETIM 289,A00,818674,Marez; Curtis F.,11,0,15,4
1739705836241,EXPR 100,A00,871385,Staff,9999,0,9999,0
1739705837268,EXPR 105,A00,871455,Staff,9999,0,9999,0
1739705838294,EXPR 201,A00,871548,Staff,9999,0,9999,0
1739705839320,EXPR 205,A00,871602,Staff,9999,0,9999,0
1739705840347,FILM 71,A01,809813,Staff,9,0,10,1
1739705841374,FILM 72,A01,871143,Staff,9,0,10,1
1739705842400,FILM 73,A01,871145,Staff,8,0,10,2
1739705843425,FILM 87,A00,809816,Rahimi; Babak,20,0,20,0
1739705843425,FILM 87,B00,809859,Rahimi; Babak,20,0,20,0
1739705843425,FILM 87,C00,869076,Havis; Allan,19,0,20,1
1739705844455,FMPH 291,A00,818678,Boutelle; Kerri & Eichen; Dawn,13,0,15,2
1739705844455,FMPH 291,B00,818689,Lacroix; Andrea Zauderer,12,0,15,3
1739705844455,FMPH 291,C00,818694,Shadyab; Aladdin Hassan,15,0,15,0
1739705844455,FMPH 291,D00,818695,Salem; Rany Mansour,12,0,15,3
1739705844455,FMPH 291,E00,818704,Shadyab; Aladdin Hassan,14,0,15,1
1739705844455,FMPH 291,F00,872513,Araneta; Maria Rosario Gorrez,12,0,15,3
1739705844455,FMPH 291,G00,876306,Ross; Camille,13,0,15,2
1739705845480,FPM 276,A00,886086,Zhu; Shu-Hong,14,0,15,1
1739705846504,FPM 286,A00,866428,Johnson; Michelle Lee,0,0,0,0
1739705847529,FPM 296,001,866429,Johnson; Michelle Lee,4,0,5,1
1739705847529,FPM 296,002,866430,Araneta; Maria Rosario Gorrez,5,0,5,0
1739705847529,FPM 296,003,866433,Staff,5,0,5,0
1739705848556,FPM 297,001,881032,Strong; David R,9998,0,9999,1
1739705849585,GLBH 20,A00,818752,Elwardani; Nile Regina,143,0,146,3
1739705850613,GLBH 101,A00,818757,Sloane; Julia Kathryn,39,0,40,1
1739705851640,GLBH 107,A00,818758,Wilson; Brenda K,65,0,70,5
1739705852668,GLBH 108,A00,818759,Olivas Hernandez; Olga Lid,68,0,70,2
1739705853694,GLBH 111,A01,818761,Burgos; Jose L.,0,0,0,0
1739705853694,GLBH 111,B01,818763,Burgos; Jose L.,0,0,0,0
1739705854721,GLBH 114W,A00,818764,Walkover; Lillian B,16,0,17,1
1739705856774,GLBH 121,A00,870699,Villarino; Margarita,42,0,44,2
1739705857800,GLBH 130,A00,870701,Schonberg; Jeffrey,38,0,40,2
1739705858824,GLBH 131,A00,870812,Staff,43,0,44,1
1739705859849,GLBH 147,A00,818766,Stewart; Alexander B,38,0,40,2
1739705860875,GLBH 148,A00,818828,Schonberg; Jeffrey,95,0,100,5
1739705861901,GLBH 150B,A00,818838,Kaiser; Bronwyn Nicole,14,0,15,1
1739705862926,GLBH 181,A00,818842,Burgos; Jose L.,207,0,216,9
1739705863951,GLBH 190,A00,870700,Bhavsar; Radhika,44,0,44,0
1739705864979,GLBH 215,A00,818849,Walkover; Lillian B,7,0,16,9
1739705866006,GLBH 260,A00,818858,Elwardani; Nile Regina,16,0,16,0
1739705867033,GSS 20,A00,818859,Siapno; Jacqueline A,27,0,30,3
1739705868058,GSS 21,A00,818860,Gyamfi; Bright,29,0,30,1
1739705869083,HDS 1,A01,819050,Staff,29,0,30,1
1739705869083,HDS 1,A02,819053,Staff,28,0,30,2
1739705869083,HDS 1,A03,819074,Staff,29,0,30,1
1739705869083,HDS 1,A04,819075,Staff,30,0,30,0
1739705869083,HDS 1,A05,819076,Staff,29,0,30,1
1739705869083,HDS 1,A06,819077,Staff,30,0,30,0
1739705869083,HDS 1,A07,819078,Staff,29,0,30,1
1739705870109,HDS 60,A01,819095,Staff,32,0,35,3
1739705870109,HDS 60,A02,819096,Staff,35,0,35,0
1739705871135,HDS 95,A00,819097,Staff,36,0,40,4
1739705872160,HDS 120,A00,819098,Staff,91,0,100,9
1739705873184,HDS 122,A00,819099,Staff,96,0,100,4
1739705874211,HDS 150,A00,819100,Staff,12,0,12,0
1739705874211,HDS 150,B00,819122,Staff,12,0,12,0
1739705874211,HDS 150,C00,819123,Staff,12,0,12,0
1739705875236,HDS 175,A00,819142,Staff,32,0,35,3
1739705876265,HDS 181,A01,819144,Staff,35,0,35,0
1739705877289,HDS 191,A01,819146,Staff,20,0,20,0
1739705877289,HDS 191,B01,819223,Staff,20,0,20,0
1739705878315,HIAF 112,A00,841742,Gyamfi; Bright,45,0,46,1
1739705879339,HIEA 114,A00,841743,Matsumura; Wendy Y,36,0,50,14
1739705880365,HIEA 131,A00,841744,Muscolino; Micah S,41,0,44,3
1739705881395,HIEA 138,A00,841747,Lu; Weijing,30,0,30,0
1739705882421,HIEA 144,A00,870811,Henry; Todd A.,24,0,25,1
1739705883446,HIEU 128,A00,841749,Hansen; Jan Eric,66,0,70,4
1739705884471,HIEU 138,A00,841750,Devereux; Andrew W,53,0,56,3
1739705885498,HIEU 146,A00,841751,Radcliff; Pamela B.,44,0,50,6
1739705886527,HIEU 148,A00,841753,Biess; Frank Peter,116,0,120,4
1739705887552,HIEU 160,A00,841754,Demetriou; Denise,11,0,15,4
1739705888580,HIEU 183,A00,870697,Gallant; Thomas W.,10,0,10,0
1739705889607,HIEU 184,A00,841757,Patterson; Patrick H.,15,0,15,0
1739705890634,HIEU 283,A00,870698,Gallant; Thomas W.,10,0,10,0
1739705891659,HIGL 126,A00,841758,Gerth; Karl G.,34,0,34,0
1739705892683,HIGR 209,A00,841771,Hanna; Mark G.,10,0,10,0
1739705893709,HIGR 210,A00,841772,Gerth; Karl G.,9,0,10,1
1739705894737,HIGR 220,A00,872411,Strasser; Ulrike,9,0,10,1
1739705895762,HIGR 239,A00,841774,Gere; Catherina M.,9,0,10,1
1739705896787,HIGR 240,A00,841777,McKenzie; Kerry V.,9,0,10,1
1739705897815,HIGR 248B,A00,841778,Vitz; Matthew,10,0,10,0
1739705898841,HIGR 280,A00,841779,Devereux; Andrew W,10,0,10,0
1739705899865,HIGR 282,A00,871856,Henry; Todd A.,10,0,10,0
1739705900889,HILA 132,A00,841759,Vitz; Matthew,141,0,146,5
1739705901915,HILA 144P,A00,869962,Murillo; Dana V.,49,0,50,1
1739705902940,HILD 2C,A01,862763,Hendrickson; Gerald M.,30,0,32,2
1739705902940,HILD 2C,A02,862769,Hendrickson; Gerald M.,30,0,32,2
1739705902940,HILD 2C,A03,862772,Hendrickson; Gerald M.,32,0,32,0
1739705902940,HILD 2C,A04,862774,Hendrickson; Gerald M.,32,0,32,0
1739705902940,HILD 2C,A05,862777,Hendrickson; Gerald M.,31,0,32,1
1739705902940,HILD 2C,A06,862778,Hendrickson; Gerald M.,32,0,32,0
1739705904024,HILD 7B,A01,862780,Martinez-Matsuda; Veronica,32,0,32,0
1739705904024,HILD 7B,A02,862781,Martinez-Matsuda; Veronica,32,0,32,0
1739705904024,HILD 7B,A03,862782,Martinez-Matsuda; Veronica,29,0,32,3
1739705904024,HILD 7B,A04,862783,Martinez-Matsuda; Veronica,31,0,32,1
1739705904024,HILD 7B,A05,862784,Martinez-Matsuda; Veronica,28,0,32,4
1739705904024,HILD 7B,A06,862788,Martinez-Matsuda; Veronica,31,0,32,1
1739705904024,HILD 7B,A07,862789,Martinez-Matsuda; Veronica,32,0,32,0
1739705904024,HILD 7B,A08,862797,Martinez-Matsuda; Veronica,32,0,32,0
1739705904024,HILD 7B,A09,862798,Martinez-Matsuda; Veronica,32,0,32,0
1739705904024,HILD 7B,A10,862799,Martinez-Matsuda; Veronica,30,0,32,2
1739705904024,HILD 7B,A11,862801,Martinez-Matsuda; Veronica,32,0,32,0
1739705904024,HILD 7B,A12,862802,Martinez-Matsuda; Veronica,32,0,32,0
1739705905052,HILD 12,A01,862804,Matsumura; Wendy Y,31,0,32,1
1739705905052,HILD 12,A02,862987,Matsumura; Wendy Y,31,0,32,1
1739705905052,HILD 12,A03,862989,Matsumura; Wendy Y,0,0,0,0
1739705905052,HILD 12,A04,862991,Matsumura; Wendy Y,0,0,0,0
1739705905052,HILD 12,A05,863014,Matsumura; Wendy Y,31,0,32,1
1739705905052,HILD 12,A06,863015,Matsumura; Wendy Y,32,0,32,0
1739705906077,HILD 42,A01,863016,Gere; Catherina M.,31,0,32,1
1739705906077,HILD 42,A02,863017,Gere; Catherina M.,32,0,32,0
1739705907103,HINE 115,A00,841762,Balberg; Mira,44,0,56,12
1739705908130,HINE 116,A00,869964,Gokatalay; Semih,35,0,35,0
1739705909156,HINE 120,A00,869963,Gokatalay; Semih,35,0,35,0
1739705910184,HISA 101,A00,871799,De; Aniket,35,0,35,0
1739705911210,HISA 120,A00,871840,De; Aniket,34,0,35,1
1739705912235,HITO 87,A00,841738,Patterson; Patrick H.,15,0,15,0
1739705912235,HITO 87,B00,841740,Patterson; Patrick H.,14,0,15,1
1739705913264,HITO 100,B00,841764,Kwak; Nancy,23,0,25,2
1739705914293,HITO 170,A00,841765,Watts; Edward J.,9,0,10,1
1739705915318,HITO 193,A00,851603,Staff,0,0,0,0
1739705916346,HIUS 104,A00,841766,Hanna; Mark G.,142,0,146,4
1739705917373,HIUS 114A,A00,841767,Lewandoski; Julia Mavis,48,0,50,2
1739705918397,HIUS 144,B00,841769,Daly; Heather Marie,39,0,40,1
1739705919438,HUM 2,A01,832551,Crum; Matthew Stephen,15,0,15,0
1739705919438,HUM 2,A02,832552,Crum; Matthew Stephen,14,0,15,1
1739705919438,HUM 2,A03,832553,Crum; Matthew Stephen,15,0,15,0
1739705919438,HUM 2,A04,832554,Crum; Matthew Stephen,14,0,15,1
1739705919438,HUM 2,A05,832555,Crum; Matthew Stephen,15,0,15,0
1739705919438,HUM 2,A06,832557,Crum; Matthew Stephen,14,0,15,1
1739705919438,HUM 2,A07,832600,Crum; Matthew Stephen,14,0,15,1
1739705919438,HUM 2,A08,832662,Crum; Matthew Stephen,15,0,15,0
1739705919438,HUM 2,A09,832667,Crum; Matthew Stephen,13,0,15,2
1739705919438,HUM 2,A10,832671,Crum; Matthew Stephen,15,0,15,0
1739705919438,HUM 2,A11,832673,Crum; Matthew Stephen,15,0,15,0
1739705919438,HUM 2,A12,832675,Crum; Matthew Stephen,15,0,15,0
1739705919438,HUM 2,A13,832680,Crum; Matthew Stephen,15,0,15,0
1739705919438,HUM 2,A14,832682,Crum; Matthew Stephen,15,0,15,0
1739705919438,HUM 2,B01,832686,Watts; Edward J.,7,0,15,8
1739705919438,HUM 2,B02,832688,Watts; Edward J.,14,0,15,1
1739705919438,HUM 2,B03,832693,Watts; Edward J.,15,0,15,0
1739705919438,HUM 2,B04,832694,Watts; Edward J.,15,0,15,0
1739705919438,HUM 2,B05,832739,Watts; Edward J.,15,0,15,0
1739705919438,HUM 2,B06,832742,Watts; Edward J.,14,0,15,1
1739705919438,HUM 2,B07,832756,Watts; Edward J.,15,0,15,0
1739705919438,HUM 2,B08,832760,Watts; Edward J.,13,0,15,2
1739705919438,HUM 2,B09,832762,Watts; Edward J.,15,0,15,0
1739705919438,HUM 2,B10,832764,Watts; Edward J.,13,0,15,2
1739705919438,HUM 2,B11,832767,Watts; Edward J.,15,0,15,0
1739705919438,HUM 2,B12,832770,Watts; Edward J.,14,0,15,1
1739705919438,HUM 2,B13,832775,Watts; Edward J.,13,0,15,2
1739705919438,HUM 2,B14,832776,Watts; Edward J.,12,0,15,3
1739705919438,HUM 2,C01,832784,Markman; Kristina,15,0,15,0
1739705919438,HUM 2,C02,832785,Markman; Kristina,15,0,15,0
1739705919438,HUM 2,C03,832787,Markman; Kristina,14,0,15,1
1739705919438,HUM 2,C04,832789,Markman; Kristina,6,0,15,9
1739705919438,HUM 2,C05,832790,Markman; Kristina,15,0,15,0
1739705919438,HUM 2,C06,832793,Markman; Kristina,15,0,15,0
1739705919438,HUM 2,C07,832794,Markman; Kristina,15,0,15,0
1739705919438,HUM 2,C08,832804,Markman; Kristina,15,0,15,0
1739705919438,HUM 2,C09,832805,Markman; Kristina,15,0,15,0
1739705919438,HUM 2,C10,832946,Markman; Kristina,14,0,15,1
1739705919438,HUM 2,C11,833014,Markman; Kristina,15,0,15,0
1739705919438,HUM 2,C12,833037,Markman; Kristina,15,0,15,0
1739705919438,HUM 2,C13,833075,Markman; Kristina,15,0,15,0
1739705919438,HUM 2,C14,833078,Markman; Kristina,13,0,15,2
1739705920468,HUM 5,A01,833083,Lyon; Antony J.,21,0,28,7
1739705920468,HUM 5,A02,833086,Lyon; Antony J.,28,0,28,0
1739705920468,HUM 5,A03,833090,Lyon; Antony J.,27,0,28,1
1739705920468,HUM 5,A04,833095,Lyon; Antony J.,26,0,28,2
1739705920468,HUM 5,A05,833096,Lyon; Antony J.,27,0,28,1
1739705920468,HUM 5,A06,833099,Lyon; Antony J.,26,0,28,2
1739705920468,HUM 5,A07,833110,Lyon; Antony J.,26,0,28,2
1739705920468,HUM 5,A08,833112,Lyon; Antony J.,27,0,28,1
1739705920468,HUM 5,B01,833118,Rodriguez; Bretton Sigfred,24,0,28,4
1739705920468,HUM 5,B02,833122,Rodriguez; Bretton Sigfred,25,0,28,3
1739705920468,HUM 5,B03,833128,Rodriguez; Bretton Sigfred,19,0,28,9
1739705920468,HUM 5,B04,833129,Rodriguez; Bretton Sigfred,24,0,28,4
1739705920468,HUM 5,B05,833133,Rodriguez; Bretton Sigfred,27,0,28,1
1739705920468,HUM 5,B06,833138,Rodriguez; Bretton Sigfred,27,0,28,1
1739705920468,HUM 5,B07,833140,Rodriguez; Bretton Sigfred,27,0,28,1
1739705920468,HUM 5,B08,833141,Rodriguez; Bretton Sigfred,28,0,28,0
1739705920468,HUM 5,C01,833158,West; Geoffrey Scott,20,0,28,8
1739705920468,HUM 5,C02,833159,West; Geoffrey Scott,23,0,28,5
1739705920468,HUM 5,C03,833163,West; Geoffrey Scott,28,0,28,0
1739705920468,HUM 5,C04,833165,West; Geoffrey Scott,27,0,28,1
1739705920468,HUM 5,C05,833168,West; Geoffrey Scott,26,0,28,2
1739705920468,HUM 5,C06,833171,West; Geoffrey Scott,23,0,28,5
1739705920468,HUM 5,C07,833172,West; Geoffrey Scott,26,0,28,2
1739705920468,HUM 5,C08,833176,West; Geoffrey Scott,24,0,28,4
1739705921496,HUM 100,A00,833179,Shenoy; Niyati,16,0,16,0
1739705921496,HUM 100,B00,833180,Shenoy; Niyati,16,0,16,0
1739705921496,HUM 100,C00,833187,Zavodny; Tatiana Sophia,15,0,16,1
1739705921496,HUM 100,D00,833190,Zavodny; Tatiana Sophia,15,0,16,1
1739705921496,HUM 100,E00,833196,West; Geoffrey Scott,15,0,16,1
1739705921496,HUM 100,F00,833199,West; Geoffrey Scott,15,0,16,1
1739705922522,INTL 100,A01,819235,Feuer; Anna Stagg,24,0,25,1
1739705922522,INTL 100,A02,819246,Feuer; Anna Stagg,24,0,25,1
1739705922522,INTL 100,A03,819251,Feuer; Anna Stagg,25,0,25,0
1739705922522,INTL 100,A04,819252,Feuer; Anna Stagg,21,0,25,4
1739705922522,INTL 100,A05,819256,Feuer; Anna Stagg,25,0,25,0
1739705922522,INTL 100,A06,819260,Feuer; Anna Stagg,25,0,25,0
1739705923550,INTL 101,A01,819264,McCord; Gordon Carlos,27,0,35,8
1739705923550,INTL 101,A02,819266,McCord; Gordon Carlos,32,0,35,3
1739705924574,INTL 102,A01,819271,Fisk; David Lee,29,0,35,6
1739705924574,INTL 102,A02,819279,Fisk; David Lee,27,0,35,8
1739705925605,INTL 190,A00,819281,Lettieri; Michael Joseph,0,0,0,2
1739705925605,INTL 190,B00,819301,Vos; Stacie N.,0,0,0,0
1739705925605,INTL 190,C00,819303,McIntosh; Justin,0,0,0,2
1739705925605,INTL 190,D00,819389,Segui; Alan S,0,0,0,2
1739705925605,INTL 190,E00,819393,Segui; Alan S,0,0,0,1
1739705925605,INTL 190,F00,819394,Auerbach; Bradford C,0,0,0,0
1739705925605,INTL 190,G00,819395,Samphantharak; Krislert,0,0,0,2
1739705926644,JAPN 10C,A01,819403,Maruyama; Rie,14,0,15,1
1739705926644,JAPN 10C,B01,819406,McKee; Mayumi Mochizuki,13,0,15,2
1739705926644,JAPN 10C,C01,819448,Ross; Kayoko F,14,0,15,1
1739705926644,JAPN 10C,D01,819450,Sato; Kyoko,15,0,15,0
1739705926644,JAPN 10C,E01,819454,Kamioka; Sachiko,13,0,15,2
1739705926644,JAPN 10C,F01,819457,McKee; Mayumi Mochizuki,10,0,15,5
1739705926644,JAPN 10C,G01,819459,Tipton; Yuko,12,0,15,3
1739705926644,JAPN 10C,H01,819466,Sato; Kyoko,15,0,15,0
1739705926644,JAPN 10C,I01,819486,Homma; Kunihiko,14,0,15,1
1739705926644,JAPN 10C,J01,819536,Tipton; Yuko,15,0,15,0
1739705926644,JAPN 10C,K01,819584,Kamioka; Sachiko,14,0,15,1
1739705927674,JAPN 10CR,A01,819684,Inada; Minori,12,0,12,0
1739705927674,JAPN 10CR,B01,819741,McKee; Mayumi Mochizuki,12,0,12,0
1739705928710,JAPN 20C,A01,819791,Iwamoto; Naoki,13,0,13,0
1739705928710,JAPN 20C,B01,819874,Homma; Kunihiko,12,0,13,1
1739705928710,JAPN 20C,C01,819904,Iwamoto; Naoki,12,0,13,1
1739705928710,JAPN 20C,D01,819934,Takeda; Izumi,12,0,13,1
1739705928710,JAPN 20C,E01,819936,Simpson; Junko Tokuda,13,0,13,0
1739705929736,JAPN 130C,A01,819938,Maruyama; Rie,12,0,12,0
1739705929736,JAPN 130C,B01,820148,Kamioka; Sachiko,9,0,12,3
1739705930765,JAPN 135C,A00,820169,Ross; Kayoko F,11,0,12,1
1739705930765,JAPN 135C,B00,820192,Iwamoto; Naoki,10,0,12,2
1739705931792,JAPN 137C,A00,820201,Simpson; Junko Tokuda,17,0,20,3
1739705932820,JAPN 140C,A00,820210,Takeda; Izumi,19,0,20,1
1739705933847,JWSP 3,A01,820218,Shuster; Alana,15,0,15,0
1739705934880,LATI 10,A01,820230,Kennemore; Amy Michelle,28,0,30,2
1739705934880,LATI 10,A02,820286,Kennemore; Amy Michelle,29,0,30,1
1739705934880,LATI 10,A03,820289,Kennemore; Amy Michelle,29,0,30,1
1739705934880,LATI 10,A04,820293,Kennemore; Amy Michelle,29,0,30,1
1739705934880,LATI 10,A05,820380,Kennemore; Amy Michelle,30,0,30,0
1739705934880,LATI 10,A06,820381,Kennemore; Amy Michelle,29,0,30,1
1739705935911,LATI 50,A01,820465,Kokinis; Troy Andreas,29,0,30,1
1739705935911,LATI 50,A02,820466,Kokinis; Troy Andreas,30,0,30,0
1739705935911,LATI 50,A03,820470,Kokinis; Troy Andreas,0,0,0,0
1739705935911,LATI 50,A04,820490,Kokinis; Troy Andreas,0,0,0,0
1739705935911,LATI 50,A05,872455,Kokinis; Troy Andreas,0,0,0,0
1739705936937,LATI 130,A00,820527,Alvarez; Camila Huerta,46,0,46,0
1739705937963,LATI 131,A00,869142,Villafuerte Vazquez; Nadia,30,0,30,0
1739705940013,LATI 166,A00,886084,Kokinis; Troy Andreas,42,0,42,0
1739705941039,LATI 180,A00,820555,Kennemore; Amy Michelle,40,0,44,4
1739705942072,LIAB 1C,B00,820742,Saab; Dima,12,0,14,2
1739705942072,LIAB 1C,C00,820744,Saab; Dima,12,0,14,2
1739705943100,LIAB 1CX,A00,820745,El Cheddadi; Youniss,25,0,28,3
1739705944128,LIAB 1F,A00,872423,El Cheddadi; Youniss,15,0,15,0
1739705945159,LIDS 19,001,886201,Goodall; Grant Todd,9999,0,9999,0
1739705945159,LIDS 19,002,886202,Goodall; Grant Todd,9999,0,9999,0
1739705945159,LIDS 19,003,886204,Goodall; Grant Todd,9999,0,9999,0
1739705945159,LIDS 19,004,886207,Goodall; Grant Todd,9999,0,9999,0
1739705945159,LIDS 19,005,886208,Goodall; Grant Todd,9999,0,9999,0
1739705945159,LIDS 19,006,886209,Goodall; Grant Todd,9999,0,9999,0
1739705945159,LIDS 19,007,886210,Goodall; Grant Todd,9999,0,9999,0
1739705945159,LIDS 19,008,886211,Goodall; Grant Todd,9999,0,9999,0
1739705945159,LIDS 19,009,886213,Goodall; Grant Todd,9999,0,9999,0
1739705945159,LIDS 19,010,886214,Goodall; Grant Todd,9999,0,9999,0
1739705945159,LIDS 19,011,886215,Goodall; Grant Todd,9999,0,9999,0
1739705945159,LIDS 19,012,886216,Goodall; Grant Todd,9999,0,9999,0
1739705946185,LIFR 1A,C00,820857,Van Moer; Vinciane G,12,0,14,2
1739705946185,LIFR 1A,D00,820858,Van Moer; Vinciane G,14,0,14,0
1739705947212,LIFR 1AX,B00,820861,Van Moer; Vinciane G,27,0,28,1
1739705948241,LIFR 1C,A00,820862,Van Moer; Vinciane G,12,0,14,2
1739705948241,LIFR 1C,B00,820916,Van Moer; Vinciane G,12,0,14,2
1739705948241,LIFR 1C,C00,820970,Van Moer; Vinciane G,14,0,14,0
1739705948241,LIFR 1C,D00,820971,Van Moer; Vinciane G,13,0,14,1
1739705949264,LIFR 1CX,A00,820972,Van Moer; Vinciane G,26,0,28,2
1739705949264,LIFR 1CX,B00,820973,Van Moer; Vinciane G,26,0,28,2
1739705950290,LIFR 1D,A00,820974,Van Moer; Vinciane G,13,0,14,1
1739705950290,LIFR 1D,B00,820975,Van Moer; Vinciane G,11,0,14,3
1739705950290,LIFR 1D,C00,820976,Van Moer; Vinciane G,14,0,14,0
1739705950290,LIFR 1D,D00,820977,Van Moer; Vinciane G,14,0,14,0
1739705951315,LIFR 1DX,A00,820978,Van Moer; Vinciane G,25,0,28,3
1739705951315,LIFR 1DX,B00,820979,Van Moer; Vinciane G,28,0,28,0
1739705952340,LIFR 11,001,820980,Goodall; Grant Todd,9999,0,9999,0
1739705953368,LIGM 1C,A00,820981,Fischer-Grunski; Eva K,14,0,14,0
1739705953368,LIGM 1C,B00,820982,Fischer-Grunski; Eva K,11,0,14,3
1739705954401,LIGM 1CX,A00,820985,Fischer-Grunski; Eva K,13,0,14,1
1739705954401,LIGM 1CX,B00,820986,Fischer-Grunski; Eva K,13,0,14,1
1739705955428,LIGM 11,001,820987,Goodall; Grant Todd,9999,0,9999,0
1739705956453,LIGN 8,A00,821976,McIntosh; Justin,238,0,250,12
1739705957479,LIGN 17,A00,821977,Kehler; Andrew Scott,247,0,250,3
1739705958508,LIGN 101,A01,821980,Staff,35,0,35,0
1739705958508,LIGN 101,A02,821982,Staff,35,0,35,0
1739705958508,LIGN 101,A03,821983,Staff,35,0,35,0
1739705958508,LIGN 101,A04,821984,Staff,35,0,35,0
1739705959534,LIGN 113,A00,821985,Styler; William Francis,88,0,90,2
1739705960563,LIGN 117,A00,869927,Kehler; Andrew Scott,42,0,50,8
1739705961589,LIGN 120,A01,821987,Caballero; Gabriela Hernandez,23,0,25,2
1739705961589,LIGN 120,A02,821988,Caballero; Gabriela Hernandez,22,0,25,3
1739705961589,LIGN 120,A03,821990,Caballero; Gabriela Hernandez,20,0,25,5
1739705962614,LIGN 146,A00,821992,Lott; Margaret S.,27,0,30,3
1739705963640,LIGN 165,A00,821993,Bergen; Leon,50,0,70,20
1739705964665,LIGN 180,A00,821994,Kluender; Robert,63,0,70,7
1739705965691,LIGN 188R,A00,821996,Clem; Emily,40,0,40,0
1739705966715,LIGN 200,A00,821997,Warstadt; Alexander Scott,35,0,35,0
1739705967739,LIGN 211,A00,821999,Bakovic; Eric John,20,0,20,0
1739705968768,LIGN 220,A00,822003,Caballero; Gabriela Hernandez,18,0,20,2
1739705969794,LIGN 225,A00,822004,Goodall; Grant Todd,20,0,20,0
1739705970832,LIGN 238,A00,822005,Bergen; Benjamin,20,0,20,0
1739705971862,LIGN 252,A00,822006,Bergen; Leon,14,0,15,1
1739705972889,LIGN 279,A00,822007,Dudley; Rachel,17,0,20,3
1739705973919,LIGN 296,001,821907,Ackerman; Farrell,5,0,5,0
1739705973919,LIGN 296,002,821908,Bakovic; Eric John,5,0,5,0
1739705973919,LIGN 296,003,821909,Bergen; Leon,5,0,5,0
1739705973919,LIGN 296,004,821910,Caballero; Gabriela Hernandez,5,0,5,0
1739705973919,LIGN 296,005,821912,Caponigro; Ivano,5,0,5,0
1739705973919,LIGN 296,006,821913,Clem; Emily,5,0,5,0
1739705973919,LIGN 296,007,821914,Dudley; Rachel,5,0,5,0
1739705973919,LIGN 296,008,821916,Garellek; Marc,5,0,5,0
1739705973919,LIGN 296,009,821917,Goodall; Grant Todd,5,0,5,0
1739705973919,LIGN 296,010,821918,Kehler; Andrew Scott,5,0,5,0
1739705973919,LIGN 296,011,821919,Kluender; Robert,5,0,5,0
1739705973919,LIGN 296,012,821920,Mayberry; Rachel,5,0,5,0
1739705973919,LIGN 296,013,821921,Rose; Sharon,5,0,5,0
1739705973919,LIGN 296,014,821924,Styler; William Francis,5,0,5,0
1739705973919,LIGN 296,015,821925,Warstadt; Alexander Scott,5,0,5,0
1739705974944,LIHL 112P,A00,820733,Pagkalinawan; Leticia Cant,29,0,30,1
1739705975968,LIHL 114P,A00,820734,Nguyen; Hoan Thi,29,0,30,1
1739705976997,LIHL 117P,A00,820735,Sadegholvad; Elham,28,0,28,0
1739705978021,LIHL 118,A00,820736,Chen; Areana Yen,30,0,30,0
1739705979049,LIHL 124P,A00,820737,Nguyen; Hoan Thi,26,0,28,2
1739705980075,LIHL 132P,A00,820738,Pagkalinawan; Leticia Cant,28,0,28,0
1739705981104,LIHL 134P,A00,820739,Nguyen; Hoan Thi,28,0,28,0
1739705982132,LIHL 138,A00,820740,Chen; Areana Yen,15,0,16,1
1739705983160,LIIT 1C,A00,820988,Carnelos; Chiara,13,0,14,1
1739705983160,LIIT 1C,B00,820989,Carnelos; Chiara,9,0,14,5
1739705984187,LIIT 1CX,A00,820990,Carnelos; Chiara,23,0,28,5
1739705985212,LIPO 1C,A00,820991,Paladini; Denise,14,0,14,0
1739705985212,LIPO 1C,B00,820992,Paladini; Denise,14,0,14,0
1739705986238,LIPO 1CX,A00,820993,De Abreu; Cassia,28,0,28,0
1739705987271,LISL 1A,A00,820994,Lott; Margaret S.,13,0,14,1
1739705987271,LISL 1A,B00,820995,Lott; Margaret S.,14,0,14,0
1739705987271,LISL 1A,C00,820996,Lott; Margaret S.,13,0,14,1
1739705987271,LISL 1A,D00,820997,Lott; Margaret S.,14,0,14,0
1739705987271,LISL 1A,E00,820998,Lott; Margaret S.,14,0,14,0
1739705987271,LISL 1A,F00,820999,Lott; Margaret S.,14,0,14,0
1739705988296,LISL 1AR,A00,821000,Lott; Margaret S.,12,0,15,3
1739705988296,LISL 1AR,B00,821001,Lott; Margaret S.,12,0,15,3
1739705988296,LISL 1AR,C00,885716,Lott; Margaret S.,3,0,3,0
1739705988296,LISL 1AR,D00,885778,Lott; Margaret S.,3,0,3,0
1739705989322,LISL 1AX,A00,821002,Lott; Margaret S.,27,0,28,1
1739705989322,LISL 1AX,B00,821003,Lott; Margaret S.,28,0,28,0
1739705989322,LISL 1AX,C00,821004,Lott; Margaret S.,27,0,28,1
1739705990346,LISL 1C,A00,821009,Lott; Margaret S.,12,0,14,2
1739705990346,LISL 1C,B00,821010,Lott; Margaret S.,14,0,14,0
1739705990346,LISL 1C,C00,821011,Lott; Margaret S.,13,0,14,1
1739705990346,LISL 1C,D00,821012,Lott; Margaret S.,14,0,14,0
1739705990346,LISL 1C,E00,821022,Lott; Margaret S.,12,0,14,2
1739705990346,LISL 1C,F00,821023,Lott; Margaret S.,14,0,14,0
1739705991377,LISL 1CX,A00,821024,Lott; Margaret S.,26,0,28,2
1739705991377,LISL 1CX,B00,821027,Lott; Margaret S.,23,0,28,5
1739705991377,LISL 1CX,C00,821029,Lott; Margaret S.,28,0,28,0
1739705992405,LISL 1D,A00,821030,Lott; Margaret S.,13,0,14,1
1739705992405,LISL 1D,B00,821083,Lott; Margaret S.,14,0,14,0
1739705992405,LISL 1D,C00,821084,Lott; Margaret S.,14,0,14,0
1739705992405,LISL 1D,D00,821148,Lott; Margaret S.,8,0,14,6
1739705993434,LISL 1DX,A00,821160,Lott; Margaret S.,23,0,28,5
1739705993434,LISL 1DX,B00,821165,Lott; Margaret S.,27,0,28,1
1739705994462,LISP 1A,001,821174,Munoz Sanchez; Alicia,12,0,14,2
1739705994462,LISP 1A,002,821175,Munoz Sanchez; Alicia,12,0,14,2
1739705994462,LISP 1A,003,821179,Munoz Sanchez; Alicia,12,0,14,2
1739705994462,LISP 1A,004,821180,Munoz Sanchez; Alicia,13,0,14,1
1739705995487,LISP 1AX,001,821196,Munoz Sanchez; Alicia,26,0,28,2
1739705995487,LISP 1AX,002,821204,Munoz Sanchez; Alicia,26,0,28,2
1739705996514,LISP 1C,001,821226,Munoz Sanchez; Alicia,14,0,14,0
1739705996514,LISP 1C,002,821250,Munoz Sanchez; Alicia,13,0,14,1
1739705996514,LISP 1C,003,821251,Munoz Sanchez; Alicia,12,0,14,2
1739705996514,LISP 1C,004,821259,Munoz Sanchez; Alicia,14,0,14,0
1739705996514,LISP 1C,005,821274,Munoz Sanchez; Alicia,12,0,14,2
1739705996514,LISP 1C,006,821280,Munoz Sanchez; Alicia,13,0,14,1
1739705996514,LISP 1C,007,821281,Munoz Sanchez; Alicia,13,0,14,1
1739705996514,LISP 1C,009,821299,Munoz Sanchez; Alicia,13,0,14,1
1739705996514,LISP 1C,010,821300,Munoz Sanchez; Alicia,14,0,14,0
1739705997540,LISP 1CX,001,821305,Munoz Sanchez; Alicia,30,0,32,2
1739705997540,LISP 1CX,002,821312,Munoz Sanchez; Alicia,31,0,32,1
1739705997540,LISP 1CX,004,821314,Munoz Sanchez; Alicia,28,0,32,4
1739705997540,LISP 1CX,005,821343,Munoz Sanchez; Alicia,28,0,32,4
1739705998570,LISP 1D,002,821390,Munoz Sanchez; Alicia,13,0,14,1
1739705998570,LISP 1D,003,821391,Munoz Sanchez; Alicia,14,0,14,0
1739705998570,LISP 1D,004,821392,Munoz Sanchez; Alicia,14,0,14,0
1739705998570,LISP 1D,005,821393,Munoz Sanchez; Alicia,13,0,14,1
1739705998570,LISP 1D,006,821395,Munoz Sanchez; Alicia,13,0,14,1
1739705998570,LISP 1D,007,821396,Munoz Sanchez; Alicia,14,0,14,0
1739705998570,LISP 1D,008,821397,Munoz Sanchez; Alicia,14,0,14,0
1739705998570,LISP 1D,009,821398,Munoz Sanchez; Alicia,14,0,14,0
1739705998570,LISP 1D,011,821400,Munoz Sanchez; Alicia,13,0,14,1
1739705998570,LISP 1D,012,821401,Munoz Sanchez; Alicia,12,0,14,2
1739705998570,LISP 1D,013,821402,Munoz Sanchez; Alicia,14,0,14,0
1739705998570,LISP 1D,014,821403,Munoz Sanchez; Alicia,14,0,14,0
1739705998570,LISP 1D,015,821404,Munoz Sanchez; Alicia,12,0,14,2
1739705998570,LISP 1D,016,821405,Munoz Sanchez; Alicia,11,0,14,3
1739705998570,LISP 1D,017,821406,Munoz Sanchez; Alicia,14,0,14,0
1739705998570,LISP 1D,018,821407,Munoz Sanchez; Alicia,14,0,14,0
1739705998570,LISP 1D,019,821408,Munoz Sanchez; Alicia,14,0,14,0
1739705998570,LISP 1D,020,821409,Munoz Sanchez; Alicia,14,0,14,0
1739705998570,LISP 1D,021,821410,Munoz Sanchez; Alicia,13,0,14,1
1739705998570,LISP 1D,022,821411,Munoz Sanchez; Alicia,14,0,14,0
1739705998570,LISP 1D,023,821412,Munoz Sanchez; Alicia,14,0,14,0
1739705998570,LISP 1D,024,821413,Munoz Sanchez; Alicia,14,0,14,0
1739705999600,LISP 1DX,001,821414,Munoz Sanchez; Alicia,27,0,28,1
1739705999600,LISP 1DX,002,821415,Munoz Sanchez; Alicia,28,0,28,0
1739705999600,LISP 1DX,003,821416,Munoz Sanchez; Alicia,27,0,28,1
1739705999600,LISP 1DX,004,821417,Munoz Sanchez; Alicia,24,0,28,4
1739705999600,LISP 1DX,005,821418,Munoz Sanchez; Alicia,28,0,28,0
1739705999600,LISP 1DX,006,821419,Munoz Sanchez; Alicia,24,0,28,4
1739705999600,LISP 1DX,007,821420,Munoz Sanchez; Alicia,28,0,28,0
1739705999600,LISP 1DX,008,821430,Munoz Sanchez; Alicia,26,0,28,2
1739705999600,LISP 1DX,009,821434,Munoz Sanchez; Alicia,28,0,28,0
1739705999600,LISP 1DX,010,821478,Munoz Sanchez; Alicia,27,0,28,1
1739705999600,LISP 1DX,011,821489,Munoz Sanchez; Alicia,28,0,28,0
1739706000628,LISP 17,001,821599,Munoz Sanchez; Alicia,17,0,20,3
1739706001653,LISP 18,001,821606,Munoz Sanchez; Alicia,18,0,20,2
1739706002679,LTAM 111,A00,822939,Johnson; Sara E.,39,0,40,1
1739706003704,LTCH 101,A00,822940,Liao; Ping H,119,0,120,1
1739706004732,LTCO 287,A00,823141,Vitkus; Daniel J.,14,0,15,1
1739706005758,LTCS 12,A00,822033,Staff,40,0,40,0
1739706006787,LTCS 87,A00,822034,Nguyen; Hoang Tan,19,0,20,1
1739706006787,LTCS 87,B00,822035,Nguyen; Hoang Tan,20,0,20,0
1739706007875,LTCS 111,A00,822941,Bessett; Ryan Matthew,39,0,40,1
1739706008900,LTCS 222,A00,823145,Nguyen; Hoang Tan,12,0,15,3
1739706009926,LTCS 250,A00,823151,Myerston Santana; Jacobo,13,0,15,2
1739706010954,LTEA 100B,A00,822944,Fiss; Geraldine Anna,37,0,40,3
1739706011978,LTEA 110C,A00,822945,Zhu; Ping,39,0,40,1
1739706013006,LTEA 120A,A00,822946,Zhu; Ping,296,0,300,4
1739706014033,LTEN 22,A01,822037,Lu; Lillian,28,0,28,0
1739706014033,LTEN 22,A02,822039,Lu; Lillian,28,0,28,0
1739706014033,LTEN 22,A03,822040,Lu; Lillian,26,0,28,2
1739706014033,LTEN 22,A04,822042,Lu; Lillian,27,0,28,1
1739706015058,LTEN 28,A01,822044,Suzuki; Erin M.,27,0,28,1
1739706015058,LTEN 28,A02,822045,Suzuki; Erin M.,28,0,28,0
1739706015058,LTEN 28,A03,822046,Suzuki; Erin M.,27,0,28,1
1739706015058,LTEN 28,A04,822047,Suzuki; Erin M.,28,0,28,0
1739706015058,LTEN 28,A05,822049,Suzuki; Erin M.,28,0,28,0
1739706015058,LTEN 28,A06,822054,Suzuki; Erin M.,27,0,28,1
1739706015058,LTEN 28,A07,822056,Suzuki; Erin M.,26,0,28,2
1739706015058,LTEN 28,A08,822057,Suzuki; Erin M.,28,0,28,0
1739706016086,LTEN 110,A00,822947,Dhar; Amrita,36,0,40,4
1739706017113,LTEN 127,A00,822948,Garofalo; Devin,36,0,40,4
1739706018138,LTEN 148,A00,822949,Suzuki; Erin M.,35,0,40,5
1739706019164,LTEN 149,A00,872375,Wesling; Megan E.,34,0,40,6
1739706020189,LTEN 181,A00,822950,Mukherjee; Silpa,56,0,60,4
1739706021214,LTEN 183,A00,822951,Childs; Dennis R.,18,0,20,2
1739706022240,LTEN 185,A00,822952,Childs; Dennis R.,19,0,20,1
1739706023266,LTEN 231,A00,823152,Lu; Lillian,13,0,15,2
1739706024291,LTEN 254,A00,823160,Ruiz; Ariana,15,0,15,0
1739706025319,LTEU 110,A00,822953,Kontje; Todd Curtis,38,0,40,2
1739706026348,LTEU 140,A00,872377,De Marchi Gherini; Adriana,38,0,40,2
1739706027376,LTEU 154,A00,872369,Morse; Ainsley,34,0,35,1
1739706028401,LTFR 2A,A01,822059,Ploye; Catherine,28,0,28,0
1739706029431,LTFR 2C,A00,822060,Ploye; Catherine,25,0,25,0
1739706030456,LTFR 141,A00,822955,Zhiri; Oumelbanine,25,0,25,0
1739706031482,LTGK 3,A00,822062,Murray; Kourtney Kristine,31,0,31,0
1739706032509,LTGM 2C,A00,822067,Fischer-Grunski; Eva K,23,0,25,2
1739706033534,LTIT 50,A00,822068,De Marchi Gherini; Adriana,25,0,25,0
1739706034560,LTKO 1C,A01,822071,Jung; Ji Yun,26,0,28,2
1739706034560,LTKO 1C,B01,822075,Jung; Ji Yun,27,0,28,1
1739706034560,LTKO 1C,C01,822078,Lim; Meeyoung,28,0,28,0
1739706034560,LTKO 1C,D01,822098,Yim; Nancy,27,0,28,1
1739706034560,LTKO 1C,E01,822104,Yim; Nancy,28,0,28,0
1739706035590,LTKO 2C,A01,822289,Yim; Nancy,26,0,28,2
1739706036627,LTKO 130P,A00,822956,Lee; Jeyseon,25,0,25,0
1739706037652,LTKO 135,A00,822992,Lee; Jeyseon,25,0,25,0
1739706038686,LTLA 3,A00,822472,Murray; Kourtney Kristine,45,0,45,0
1739706039714,LTRU 1C,A01,822476,Wells; Patricia Rebecca,27,0,28,1
1739706040742,LTRU 104A,A01,823009,Wells; Patricia Rebecca,27,0,28,1
1739706041768,LTRU 150,A00,872370,Morse; Ainsley,5,0,5,0
1739706042794,LTSP 2A,A01,822483,Lampell; Toni,27,0,28,1
1739706043822,LTSP 2B,A01,822508,Mastromartino; Alexandra L,27,0,28,1
1739706044847,LTSP 2C,A01,822534,Lampell; Toni,27,0,28,1
1739706044847,LTSP 2C,B01,822616,Lampell; Toni,28,0,28,0
1739706045873,LTSP 2F,A00,822619,Mastromartino; Alexandra L,25,0,25,0
1739706046899,LTSP 3F,A00,822629,Dominguez; Noelia,25,0,25,0
1739706046899,LTSP 3F,B00,822669,Dominguez; Noelia,25,0,25,0
1739706047925,LTSP 100A,A00,823023,Dominguez; Noelia,24,0,25,1
1739706048950,LTSP 100F,A00,823027,Bessett; Ryan Matthew,25,0,25,0
1739706048950,LTSP 100F,B00,823028,Martin-Cabrera; Luis,24,0,25,1
1739706049977,LTSP 134,A00,823035,Arcos Herrera; Carol,40,0,40,0
1739706051006,LTSP 155,A00,823036,Mendoza; Andrea,39,0,40,1
1739706052033,LTSP 169,A00,823037,Martin-Cabrera; Luis,38,0,40,2
1739706053058,LTSP 175,A00,823038,Arcos Herrera; Carol,39,0,40,1
1739706054085,LTSP 272,A00,823162,Chacon; Gloria Elizabeth,15,0,15,0
1739706055110,LTTH 210C,A00,823163,Glaser; Amelia,15,0,15,0
1739706056144,LTTH 250,A00,823180,Carroll; Amy Sara,12,0,15,3
1739706057171,LTTH 260,A00,823181,Mendoza; Andrea,29,0,30,1
1739706058197,LTWL 12,A00,822679,Villafuerte Vazquez; Nadia,40,0,40,0
1739706059224,LTWL 19C,A00,822710,Kelting; Edward William,37,0,40,3
1739706060250,LTWL 101,A00,823039,Kelting; Edward William,35,0,40,5
1739706061276,LTWL 114,A00,823040,Morse; Ainsley,40,0,40,0
1739706062313,LTWL 128,A00,823041,Cohen; Alain J. J.,39,0,40,1
1739706063342,LTWL 138,A00,823042,Fiss; Geraldine Anna,40,0,40,0
1739706064368,LTWL 180,A00,823045,Mukherjee; Silpa,39,0,40,1
1739706065395,LTWL 184,A00,823046,Cohen; Alain J. J.,40,0,40,0
1739706066429,LTWL 192,A00,823047,Blanco; John D,20,0,20,0
1739706067454,LTWL 194A,A00,823048,Suzuki; Erin M.,27,0,30,3
1739706068481,LTWR 8A,A01,822713,Jemc; Jaclyn,28,0,28,0
1739706068481,LTWR 8A,A02,822863,Jemc; Jaclyn,27,0,28,1
1739706068481,LTWR 8A,A03,822923,Jemc; Jaclyn,28,0,28,0
1739706068481,LTWR 8A,A04,822932,Jemc; Jaclyn,26,0,28,2
1739706069510,LTWR 8C,A01,822935,Wilkinson; Marco,26,0,28,2
1739706069510,LTWR 8C,A02,822936,Wilkinson; Marco,27,0,28,1
1739706069510,LTWR 8C,A03,822937,Wilkinson; Marco,27,0,28,1
1739706069510,LTWR 8C,A04,822938,Wilkinson; Marco,25,0,28,3
1739706070537,LTWR 100W,A00,854460,Terry; Christopher,6,0,15,9
1739706071563,LTWR 102W,A00,823049,Doller; Ben,12,0,15,3
1739706072588,LTWR 106C,A00,823050,Terry; Christopher,27,0,30,3
1739706073612,LTWR 109C,A00,823080,Doller; Ben,28,0,30,2
1739706074640,LTWR 113C,A00,823093,Som; Brandon D,29,0,30,1
1739706075667,LTWR 115W,A00,823096,Springer; Anna Joy,13,0,15,2
1739706076691,LTWR 119C,A00,823099,Copp; Corina,28,0,30,2
1739706077718,LTWR 124W,A00,823102,Copp; Corina,15,0,15,0
1739706078746,LTWR 126C,A00,823108,Terry; Christopher,29,0,30,1
1739706079771,LTWR 140,A00,823133,Carroll; Amy Sara,30,0,30,0
1739706080796,LTWR 148,A00,823136,Wilkinson; Marco,39,0,40,1
1739706081820,LTWR 215,A00,823218,Jemc; Jaclyn,18,0,20,2
1739706082850,MAE 3,A01,825269,Delson; Nathan Joseph,13,0,16,3
1739706082850,MAE 3,A02,825273,Delson; Nathan Joseph,13,0,16,3
1739706082850,MAE 3,A03,825278,Delson; Nathan Joseph,11,0,16,5
1739706082850,MAE 3,A04,825280,Delson; Nathan Joseph,14,0,16,2
1739706082850,MAE 3,B01,825301,Morimoto; Tania,12,0,16,4
1739706082850,MAE 3,B02,825303,Morimoto; Tania,6,0,16,10
1739706082850,MAE 3,B03,825312,Morimoto; Tania,16,0,16,0
1739706082850,MAE 3,B04,825343,Morimoto; Tania,16,0,16,0
1739706083878,MAE 8,A01,825350,Qian; Kai,93,0,100,7
1739706084904,MAE 30B,A00,825352,Lubarda; Marko,96,0,100,4
1739706084904,MAE 30B,B00,825362,Ghazinejad; Maziar,84,0,100,16
1739706085928,MAE 87,A00,872412,Mullin; Jennifer S & Twomey; Robert Daniel,10,0,10,0
1739706086953,MAE 101B,A00,825363,Nomura; Keiko K.,142,0,146,4
1739706087978,MAE 101C,A00,825364,Staff,0,0,0,0
1739706089003,MAE 101D,A00,825378,Coimbra; Carlos F.,16,0,25,9
1739706090031,MAE 104,A00,825379,Pham; Hieu Tan,91,0,100,9
1739706091059,MAE 105,A00,825380,Bandaru; Prabhakar,95,0,100,5
1739706092084,MAE 107,A00,825381,Lindsey; Stephanie,94,0,100,6
1739706093112,MAE 119,A00,825382,Hidalgo-Gonzalez; Patricia,123,0,146,23
1739706094139,MAE 131A,A00,825385,Qi; Huihui,84,0,100,16
1739706094139,MAE 131A,B00,825435,Luan; Haiwen,99,0,100,1
1739706095165,MAE 143B,A00,825498,Diagne; Mamadou Lamine,61,0,80,19
1739706095165,MAE 143B,B00,825499,Kramer; Boris,92,0,96,4
1739706096190,MAE 148,A01,825502,Silberman; Jack,17,0,26,9
1739706097217,MAE 150,A00,825505,Friend; James Robert,114,0,120,6
1739706098246,MAE 152,A00,886080,Llewellyn Smith; Stefan G.,16,0,16,0
1739706098246,MAE 152,B00,886081,Llewellyn Smith; Stefan G.,16,0,16,0
1739706098246,MAE 152,C00,886082,Llewellyn Smith; Stefan G.,14,0,16,2
1739706098246,MAE 152,D00,886083,Llewellyn Smith; Stefan G.,16,0,16,0
1739706099273,MAE 155B,A01,825508,Anderson; Mark Ronald,17,0,50,33
1739706099273,MAE 155B,B01,825515,Hwang; John T,36,0,50,14
1739706100309,MAE 156B,D01,825618,Tustaniwskyj; Jerry I,30,0,35,5
1739706100309,MAE 156B,A01,825549,Delson; Nathan Joseph,34,0,35,1
1739706100309,MAE 156B,B01,825595,Ghazinejad; Maziar,30,0,35,5
1739706100309,MAE 156B,C01,825604,Pawlak; Geno Ronald,32,0,35,3
1739706100309,MAE 156B,F01,825626,Saha; Abhishek,34,0,35,1
1739706100309,MAE 156B,G01,825631,Qi; Huihui,32,0,35,3
1739706101335,MAE 170,A01,825636,Lubarda; Marko,27,0,32,5
1739706101335,MAE 170,A02,825638,Lubarda; Marko,31,0,32,1
1739706101335,MAE 170,A03,825639,Lubarda; Marko,31,0,32,1
1739706101335,MAE 170,B04,825643,Evdokimenko; Ekaterina,28,0,32,4
1739706101335,MAE 170,B05,825645,Evdokimenko; Ekaterina,20,0,32,12
1739706101335,MAE 170,B06,825648,Evdokimenko; Ekaterina,25,0,32,7
1739706102360,MAE 171A,A01,825655,Tynan; George Robert,22,0,30,8
1739706102360,MAE 171A,A02,825657,Tynan; George Robert,29,0,30,1
1739706103389,MAE 175A,A01,825661,de Callafon; Raymond A,20,0,20,0
1739706103389,MAE 175A,A02,825662,de Callafon; Raymond A,14,0,20,6
1739706104414,MAE 184,A00,825714,Anderson; Mark Ronald,23,0,60,37
1739706105443,MAE 185,A00,825715,Schmidt; Oliver,28,0,60,32
1739706106481,MAE 190,A00,825719,Beg; Farhat N.,34,0,40,6
1739706106481,MAE 190,B00,825720,Tynan; George Robert & Mullin; Jennifer S,57,0,60,3
1739706106481,MAE 190,C00,869044,Gerardo; Hortense Flotilde,13,0,14,1
1739706107505,MAE 205,A00,825721,Herbert; Sylvia Lee & Pawlak; Geno Ronald & Mullin; Jennifer S & Lindsey; Stephanie & Cai; Shengqiang & Beg; Farhat N.,9995,0,9999,4
1739706108531,MAE 207,A00,825722,Beg; Farhat N.,7,0,10,3
1739706108531,MAE 207,B00,869156,Gerardo; Hortense Flotilde,24,0,30,6
1739706109559,MAE 209,A00,825723,Scholtes Acevedo; Claire,18,0,30,12
1739706110587,MAE 210C,A00,869158,Sanchez; Antonio Luis,9,0,15,6
1739706111670,MAE 214A,A00,825724,Sarkar; Sutanu,0,0,20,20
1739706112695,MAE 217C,A00,825725,Marinoni; Alessandro,12,0,15,3
1739706113723,MAE 221D,A00,825726,Poulikakos; Lisa Voula,0,0,15,15
1739706114751,MAE 223,A01,825729,Lucas; Andrew J.,0,0,32,32
1739706115774,MAE 224A,A00,825731,Pawlak; Geno Ronald,0,0,10,10
1739706116802,MAE 227,A00,825732,Hidalgo-Gonzalez; Patricia,0,0,15,15
1739706117830,MAE 231B,A00,825733,Boechler; Nicholas Sebastia,28,0,30,2
1739706118858,MAE 240,A00,825734,Rosengren; Aaron,22,0,40,18
1739706119884,MAE 242,A00,825735,Martinez; Sonia,0,0,40,40
1739706120911,MAE 243,A00,869161,Davidson; Michael R,11,0,20,9
1739706121937,MAE 254,A00,825736,Chen; Renkun,0,0,15,15
1739706122966,MAE 256,A00,825740,Coimbra; Carlos F.,7,0,15,8
1739706123992,MAE 266,A00,825741,Evdokimenko; Ekaterina,0,0,20,20
1739706125017,MAE 269,A00,825837,Gravish; Nicholas G,0,0,35,35
1739706126046,MAE 271B,A00,825838,Garay; Javier,5,0,5,0
1739706127073,MAE 272,A00,825839,Meyers; Marc,4,0,15,11
1739706128098,MAE 280B,A00,825840,de Callafon; Raymond A,11,0,40,29
1739706129127,MAE 281B,A00,825842,Cortes; Jorge,7,0,20,13
1739706130155,MAE 289C,A00,825843,McEneaney; William Michael,8,0,10,2
1739706131179,MAE 290C,A00,825846,Schmidt; Oliver,27,0,30,3
1739706132203,MAE 294C,A01,825850,Young; William Roy,10,0,10,0
1739706133232,MATH 2,A01,848213,Cheng; Hsiao-Bing,187,0,190,3
1739706134258,MATH 3B,A01,848358,Ohm; Ko Woon,28,0,30,2
1739706134258,MATH 3B,A02,848359,Ohm; Ko Woon,30,0,30,0
1739706134258,MATH 3B,A03,848368,Ohm; Ko Woon,18,0,30,12
1739706134258,MATH 3B,A04,848369,Ohm; Ko Woon,30,0,30,0
1739706135288,MATH 3C,A01,848397,Anzaldo; Leesa B,20,0,28,8
1739706135288,MATH 3C,A02,848398,Anzaldo; Leesa B,28,0,28,0
1739706135288,MATH 3C,A03,848399,Anzaldo; Leesa B,28,0,28,0
1739706135288,MATH 3C,A04,848400,Anzaldo; Leesa B,28,0,28,0
1739706135288,MATH 3C,B01,848423,Nandi; Achinta Kumar,24,0,30,6
1739706135288,MATH 3C,B02,848439,Nandi; Achinta Kumar,30,0,30,0
1739706135288,MATH 3C,B03,848458,Nandi; Achinta Kumar,29,0,30,1
1739706135288,MATH 3C,B04,848459,Nandi; Achinta Kumar,30,0,30,0
1739706136313,MATH 4C,A01,848474,Briones; Jor-el Thomas Caparas,31,0,35,4
1739706136313,MATH 4C,A02,848476,Briones; Jor-el Thomas Caparas,35,0,36,1
1739706136313,MATH 4C,A03,848479,Briones; Jor-el Thomas Caparas,36,0,36,0
1739706136313,MATH 4C,A04,848481,Briones; Jor-el Thomas Caparas,36,0,36,0
1739706137341,MATH 10A,A01,848484,Briones; Jor-el Thomas Caparas,31,0,33,2
1739706137341,MATH 10A,A02,848490,Briones; Jor-el Thomas Caparas,32,0,33,1
1739706137341,MATH 10A,A03,848495,Briones; Jor-el Thomas Caparas,21,0,33,12
1739706137341,MATH 10A,A04,848508,Briones; Jor-el Thomas Caparas,19,0,33,14
1739706137341,MATH 10A,A05,848517,Briones; Jor-el Thomas Caparas,30,0,33,3
1739706137341,MATH 10A,A06,848518,Briones; Jor-el Thomas Caparas,33,0,33,0
1739706137341,MATH 10A,B01,848521,Bach; Quang Tran,30,0,31,1
1739706137341,MATH 10A,B02,848523,Bach; Quang Tran,31,0,32,1
1739706137341,MATH 10A,B03,848542,Bach; Quang Tran,33,0,33,0
1739706137341,MATH 10A,B04,848543,Bach; Quang Tran,33,0,33,0
1739706137341,MATH 10A,B05,848544,Bach; Quang Tran,28,0,33,5
1739706137341,MATH 10A,B06,848545,Bach; Quang Tran,33,0,33,0
1739706138367,MATH 10B,A01,848547,Zhao; Yizhen,33,0,33,0
1739706138367,MATH 10B,A02,848548,Zhao; Yizhen,33,0,33,0
1739706138367,MATH 10B,A03,848557,Zhao; Yizhen,32,0,33,1
1739706138367,MATH 10B,A04,848558,Zhao; Yizhen,32,0,33,1
1739706138367,MATH 10B,B01,848583,Zhao; Yizhen,55,0,60,5
1739706138367,MATH 10B,B02,848585,Zhao; Yizhen,59,0,60,1
1739706138367,MATH 10B,B03,848586,Zhao; Yizhen,31,0,33,2
1739706138367,MATH 10B,B04,848588,Zhao; Yizhen,32,0,33,1
1739706138367,MATH 10B,C01,848591,Ophir; Amit,30,0,30,0
1739706138367,MATH 10B,C02,848592,Ophir; Amit,29,0,30,1
1739706138367,MATH 10B,C03,848593,Ophir; Amit,30,0,30,0
1739706138367,MATH 10B,C04,848595,Ophir; Amit,30,0,30,0
1739706138367,MATH 10B,D01,848651,Buzaglo; Lucas,8,0,30,22
1739706138367,MATH 10B,D02,848653,Buzaglo; Lucas,26,0,32,6
1739706138367,MATH 10B,D03,848672,Buzaglo; Lucas,31,0,33,2
1739706138367,MATH 10B,D04,848691,Buzaglo; Lucas,33,0,33,0
1739706138367,MATH 10B,D05,848700,Buzaglo; Lucas,28,0,33,5
1739706138367,MATH 10B,D06,848702,Buzaglo; Lucas,27,0,33,6
1739706139393,MATH 10C,A01,848704,Ho; Ching Wei,12,0,27,15
1739706139393,MATH 10C,A02,848706,Ho; Ching Wei,28,0,33,5
1739706139393,MATH 10C,A03,848708,Ho; Ching Wei,29,0,33,4
1739706139393,MATH 10C,A04,848709,Ho; Ching Wei,33,0,33,0
1739706139393,MATH 10C,A05,848711,Ho; Ching Wei,32,0,33,1
1739706139393,MATH 10C,A06,848712,Ho; Ching Wei,32,0,33,1
1739706139393,MATH 10C,B01,848716,Staff,28,0,35,7
1739706139393,MATH 10C,B02,848766,Staff,33,0,35,2
1739706139393,MATH 10C,B03,848767,Staff,33,0,35,2
1739706139393,MATH 10C,B04,848772,Staff,35,0,35,0
1739706139393,MATH 10C,C01,848775,Cheng; Hsiao-Bing,28,0,35,7
1739706139393,MATH 10C,C02,848779,Cheng; Hsiao-Bing,35,0,35,0
1739706139393,MATH 10C,C03,848780,Cheng; Hsiao-Bing,35,0,35,0
1739706139393,MATH 10C,C04,848781,Cheng; Hsiao-Bing,35,0,35,0
1739706140421,MATH 11,A01,848784,Peca-Medlin; John Michael,18,0,28,10
1739706140421,MATH 11,A02,848786,Peca-Medlin; John Michael,28,0,33,5
1739706140421,MATH 11,A03,848788,Peca-Medlin; John Michael,33,0,33,0
1739706140421,MATH 11,A04,848791,Peca-Medlin; John Michael,33,0,33,0
1739706140421,MATH 11,A05,848793,Peca-Medlin; John Michael,55,0,55,0
1739706140421,MATH 11,A06,848794,Peca-Medlin; John Michael,55,0,55,0
1739706140421,MATH 11,B01,848798,Peca-Medlin; John Michael,54,0,55,1
1739706140421,MATH 11,B02,848799,Peca-Medlin; John Michael,55,0,55,0
1739706140421,MATH 11,B03,848800,Peca-Medlin; John Michael,26,0,33,7
1739706140421,MATH 11,B04,848801,Peca-Medlin; John Michael,31,0,33,2
1739706140421,MATH 11,B05,848843,Peca-Medlin; John Michael,33,0,33,0
1739706140421,MATH 11,B06,848844,Peca-Medlin; John Michael,33,0,33,0
1739706141465,MATH 18,A01,848854,Hiatt; Patrick John,32,0,35,3
1739706141465,MATH 18,A02,848859,Hiatt; Patrick John,35,0,35,0
1739706141465,MATH 18,A03,848860,Hiatt; Patrick John,34,0,35,1
1739706141465,MATH 18,A04,848861,Hiatt; Patrick John,35,0,35,0
1739706141465,MATH 18,A05,872522,Hiatt; Patrick John,33,0,35,2
1739706141465,MATH 18,A06,872523,Hiatt; Patrick John,35,0,35,0
1739706141465,MATH 18,B01,848869,Anzaldo; Leesa B,35,0,40,5
1739706141465,MATH 18,B02,848873,Anzaldo; Leesa B,20,0,35,15
1739706141465,MATH 18,B03,848877,Anzaldo; Leesa B,37,0,40,3
1739706141465,MATH 18,B04,848880,Anzaldo; Leesa B,38,0,40,2
1739706141465,MATH 18,B05,848882,Anzaldo; Leesa B,40,0,40,0
1739706141465,MATH 18,B06,848883,Anzaldo; Leesa B,35,0,40,5
1739706141465,MATH 18,B07,848884,Anzaldo; Leesa B,38,0,40,2
1739706141465,MATH 18,B08,848924,Anzaldo; Leesa B,38,0,40,2
1739706141465,MATH 18,C01,849043,Hiatt; Patrick John,34,0,35,1
1739706141465,MATH 18,C02,849044,Hiatt; Patrick John,35,0,35,0
1739706141465,MATH 18,C03,849045,Hiatt; Patrick John,35,0,35,0
1739706141465,MATH 18,C04,849047,Hiatt; Patrick John,33,0,35,2
1739706141465,MATH 18,C05,872524,Hiatt; Patrick John,34,0,35,1
1739706141465,MATH 18,C06,872525,Hiatt; Patrick John,35,0,35,0
1739706141465,MATH 18,D01,849050,Staff,35,0,35,0
1739706141465,MATH 18,D02,849053,Staff,35,0,35,0
1739706141465,MATH 18,D03,849054,Staff,35,0,35,0
1739706141465,MATH 18,D04,849055,Staff,35,0,35,0
1739706141465,MATH 18,D05,872526,Staff,34,0,35,1
1739706141465,MATH 18,D06,872528,Staff,35,0,35,0
1739706142495,MATH 20A,A01,849061,Ho; Ching Wei,28,0,32,4
1739706142495,MATH 20A,A02,849062,Ho; Ching Wei,34,0,35,1
1739706142495,MATH 20A,A03,849064,Ho; Ching Wei,35,0,35,0
1739706142495,MATH 20A,A04,849065,Ho; Ching Wei,35,0,35,0
1739706142495,MATH 20A,B01,849087,Bowers; Adam R.,28,0,35,7
1739706142495,MATH 20A,B02,849100,Bowers; Adam R.,35,0,35,0
1739706142495,MATH 20A,B03,849110,Bowers; Adam R.,34,0,35,1
1739706142495,MATH 20A,B04,849111,Bowers; Adam R.,34,0,35,1
1739706143527,MATH 20B,A01,849131,Staff,58,0,60,2
1739706143527,MATH 20B,A02,849242,Staff,60,0,60,0
1739706143527,MATH 20B,A03,849315,Staff,58,0,60,2
1739706143527,MATH 20B,A04,849319,Staff,60,0,60,0
1739706143527,MATH 20B,B01,849438,Xu; Fengmin,60,0,60,0
1739706143527,MATH 20B,B02,849447,Xu; Fengmin,57,0,60,3
1739706143527,MATH 20B,B03,849463,Xu; Fengmin,14,0,34,20
1739706143527,MATH 20B,B04,849465,Xu; Fengmin,36,0,37,1
1739706144556,MATH 20C,A01,849482,Shakeel; Asif,27,0,32,5
1739706144556,MATH 20C,A02,849484,Shakeel; Asif,31,0,32,1
1739706144556,MATH 20C,A03,849485,Shakeel; Asif,32,0,32,0
1739706144556,MATH 20C,A04,849511,Shakeel; Asif,32,0,32,0
1739706144556,MATH 20C,A05,849512,Shakeel; Asif,32,0,32,0
1739706144556,MATH 20C,A06,849513,Shakeel; Asif,32,0,32,0
1739706144556,MATH 20C,B01,849515,Yin; Wei,28,0,40,12
1739706144556,MATH 20C,B02,849516,Yin; Wei,41,0,45,4
1739706144556,MATH 20C,B03,849628,Yin; Wei,45,0,45,0
1739706144556,MATH 20C,B04,849636,Yin; Wei,43,0,45,2
1739706144556,MATH 20C,C01,849642,Ohm; Ko Woon,51,0,60,9
1739706144556,MATH 20C,C02,849654,Ohm; Ko Woon,60,0,60,0
1739706144556,MATH 20C,C03,849655,Ohm; Ko Woon,59,0,60,1
1739706144556,MATH 20C,C04,849663,Ohm; Ko Woon,60,0,60,0
1739706144556,MATH 20C,D01,849673,Yin; Wei,43,0,45,2
1739706144556,MATH 20C,D02,849677,Yin; Wei,43,0,45,2
1739706144556,MATH 20C,D03,849683,Yin; Wei,45,0,45,0
1739706144556,MATH 20C,D04,849686,Yin; Wei,45,0,45,0
1739706145584,MATH 20D,A01,849688,Hammock; Frances H,22,0,27,5
1739706145584,MATH 20D,A02,849695,Hammock; Frances H,32,0,32,0
1739706145584,MATH 20D,A03,849697,Hammock; Frances H,32,0,32,0
1739706145584,MATH 20D,A04,849734,Hammock; Frances H,31,0,32,1
1739706145584,MATH 20D,A05,849735,Hammock; Frances H,30,0,32,2
1739706145584,MATH 20D,A06,849736,Hammock; Frances H,32,0,32,0
1739706145584,MATH 20D,B01,849829,Hammock; Frances H,34,0,45,11
1739706145584,MATH 20D,B02,849852,Hammock; Frances H,45,0,45,0
1739706145584,MATH 20D,B03,849853,Hammock; Frances H,44,0,45,1
1739706145584,MATH 20D,B04,849857,Hammock; Frances H,45,0,45,0
1739706145584,MATH 20D,C01,849867,Staff,57,0,60,3
1739706145584,MATH 20D,C02,849888,Staff,59,0,60,1
1739706146618,MATH 20E,A01,850038,Sanchez; Anthony,20,0,31,11
1739706146618,MATH 20E,A02,850039,Sanchez; Anthony,33,0,35,2
1739706146618,MATH 20E,A03,850040,Sanchez; Anthony,34,0,35,1
1739706146618,MATH 20E,A04,850041,Sanchez; Anthony,35,0,35,0
1739706146618,MATH 20E,B01,850054,Sheng; Hongyi,27,0,35,8
1739706146618,MATH 20E,B02,850058,Sheng; Hongyi,34,0,35,1
1739706146618,MATH 20E,B03,850060,Sheng; Hongyi,35,0,35,0
1739706146618,MATH 20E,B04,850063,Sheng; Hongyi,35,0,35,0
1739706146618,MATH 20E,B05,872529,Sheng; Hongyi,35,0,35,0
1739706146618,MATH 20E,B06,872530,Sheng; Hongyi,35,0,35,0
1739706146618,MATH 20E,C01,850068,Sheng; Hongyi,29,0,30,1
1739706146618,MATH 20E,C02,850069,Sheng; Hongyi,30,0,30,0
1739706146618,MATH 20E,C03,850072,Sheng; Hongyi,29,0,30,1
1739706146618,MATH 20E,C04,850075,Sheng; Hongyi,29,0,30,1
1739706146618,MATH 20E,C05,850080,Sheng; Hongyi,30,0,30,0
1739706146618,MATH 20E,C06,850083,Sheng; Hongyi,30,0,30,0
1739706147644,MATH 31CH,A01,850090,De Vleming; Kristin Elizab,40,0,40,0
1739706148669,MATH 87,A00,872926,Bowers; Adam R.,20,0,20,0
1739706148669,MATH 87,B00,872927,Bowers; Adam R.,20,0,20,0
1739706149697,MATH 95,A00,850094,Stevens; Laura Jeanne,34,0,35,1
1739706150727,MATH 100B,A01,847038,Aycock; Jon Merrill,33,0,34,1
1739706150727,MATH 100B,A02,847048,Aycock; Jon Merrill,33,0,34,1
1739706151753,MATH 100C,A01,847050,Sorensen; Claus M,30,0,34,4
1739706151753,MATH 100C,A02,847051,Sorensen; Claus M,32,0,34,2
1739706152780,MATH 102,A01,847053,Aliabadi Sr.; Mohsen,25,0,30,5
1739706152780,MATH 102,A02,847101,Aliabadi Sr.; Mohsen,30,0,30,0
1739706152780,MATH 102,A03,847103,Aliabadi Sr.; Mohsen,28,0,30,2
1739706152780,MATH 102,A04,847106,Aliabadi Sr.; Mohsen,30,0,30,0
1739706152780,MATH 102,B01,847119,Aliabadi Sr.; Mohsen,27,0,30,3
1739706152780,MATH 102,B02,847120,Aliabadi Sr.; Mohsen,29,0,30,1
1739706152780,MATH 102,B03,847121,Aliabadi Sr.; Mohsen,29,0,30,1
1739706152780,MATH 102,B04,847123,Aliabadi Sr.; Mohsen,30,0,30,0
1739706153812,MATH 103B,A01,847125,Mohammadi; Amir,34,0,35,1
1739706153812,MATH 103B,A02,847126,Mohammadi; Amir,35,0,35,0
1739706153812,MATH 103B,B01,847128,Wenzl; Hans G,33,0,35,2
1739706153812,MATH 103B,B02,847129,Wenzl; Hans G,35,0,35,0
1739706153812,MATH 103B,C01,847131,Wenzl; Hans G,31,0,35,4
1739706153812,MATH 103B,C02,847132,Wenzl; Hans G,33,0,35,2
1739706154851,MATH 109,A01,847134,Ganesan; Priyanga,10,0,10,0
1739706154851,MATH 109,A02,847135,Ganesan; Priyanga,9,0,10,1
1739706154851,MATH 109,B01,847137,Ganesan; Priyanga,7,0,10,3
1739706154851,MATH 109,B02,847138,Ganesan; Priyanga,9,0,10,1
1739706154851,MATH 109,C01,847140,Upadrashta; Pranav Kumar,7,0,10,3
1739706154851,MATH 109,C02,847141,Upadrashta; Pranav Kumar,10,0,10,0
1739706154851,MATH 109,D01,847143,Sarkar; Pratyush,9,0,10,1
1739706154851,MATH 109,D02,847144,Sarkar; Pratyush,10,0,10,0
1739706154851,MATH 109,E01,847146,Sarkar; Pratyush,10,0,10,0
1739706154851,MATH 109,E02,847148,Sarkar; Pratyush,10,0,10,0
1739706155880,MATH 110,A01,847150,Pillai; Mohandas K,30,0,35,5
1739706155880,MATH 110,A02,847151,Pillai; Mohandas K,34,0,35,1
1739706155880,MATH 110,A03,847152,Pillai; Mohandas K,34,0,35,1
1739706156905,MATH 111A,A01,847154,Shakeel; Asif,23,0,30,7
1739706157933,MATH 112B,A01,847156,Komarova; Natalia,25,0,25,0
1739706158959,MATH 114,A01,847158,Li; Bo,21,0,30,9
1739706158959,MATH 114,A02,847159,Li; Bo,29,0,30,1
1739706159988,MATH 120B,A01,847161,Treuer; John N,32,0,35,3
1739706159988,MATH 120B,A02,847162,Treuer; John N,34,0,35,1
1739706161017,MATH 121B,A01,847164,Stevens; Laura Jeanne,33,0,35,2
1739706162044,MATH 140B,A01,847166,Lu; Yunze,35,0,35,0
1739706162044,MATH 140B,A02,847167,Lu; Yunze,34,0,35,1
1739706163070,MATH 140C,A01,847203,Zlatos; Andrej,33,0,35,2
1739706163070,MATH 140C,A02,847204,Zlatos; Andrej,34,0,35,1
1739706164096,MATH 142B,A01,847207,Parise; Davide,25,0,35,10
1739706164096,MATH 142B,A02,847208,Parise; Davide,31,0,35,4
1739706164096,MATH 142B,B01,847219,Mohammadi; Amir,33,0,35,2
1739706164096,MATH 142B,B02,847222,Mohammadi; Amir,35,0,35,0
1739706164096,MATH 142B,C01,847224,Kunnawalkam Elayavalli; Sr,34,0,35,1
1739706164096,MATH 142B,C02,847331,Kunnawalkam Elayavalli; Sr,34,0,35,1
1739706165125,MATH 146,A01,847333,Pillai; Mohandas K,34,0,35,1
1739706166151,MATH 150B,A01,847335,Chow; Bennett,33,0,35,2
1739706167178,MATH 152,A01,847337,Grier; Daniel T,32,0,50,18
1739706168204,MATH 154,A01,847340,Manners; Frederick,33,0,35,2
1739706168204,MATH 154,A02,847341,Manners; Frederick,35,0,35,0
1739706168204,MATH 154,A03,847342,Manners; Frederick,35,0,35,0
1739706168204,MATH 154,A04,847343,Manners; Frederick,35,0,35,0
1739706168204,MATH 154,B01,847345,Verstraete; Jacques Allan,30,0,35,5
1739706168204,MATH 154,B02,847346,Verstraete; Jacques Allan,35,0,35,0
1739706168204,MATH 154,B03,847347,Verstraete; Jacques Allan,34,0,35,1
1739706168204,MATH 154,B04,847348,Verstraete; Jacques Allan,33,0,35,2
1739706169234,MATH 160B,A01,847460,Manners; Frederick,34,0,35,1
1739706170261,MATH 163,A01,847462,Kunnawalkam Elayavalli; Sr,0,0,25,25
1739706171286,MATH 170A,A01,847464,Nag; Panchali,33,0,35,2
1739706171286,MATH 170A,A02,847465,Nag; Panchali,34,0,35,1
1739706171286,MATH 170A,A03,847466,Nag; Panchali,33,0,35,2
1739706171286,MATH 170A,A04,847467,Nag; Panchali,31,0,35,4
1739706172319,MATH 170B,A01,847530,Dixit; Rishabh,33,0,35,2
1739706172319,MATH 170B,A02,847531,Dixit; Rishabh,35,0,35,0
1739706172319,MATH 170B,A03,847532,Dixit; Rishabh,34,0,35,1
1739706172319,MATH 170B,A04,847533,Dixit; Rishabh,29,0,35,6
1739706173349,MATH 170C,A01,847535,Dixit; Rishabh,35,0,35,0
1739706173349,MATH 170C,A02,847536,Dixit; Rishabh,35,0,35,0
1739706173349,MATH 170C,A03,847537,Dixit; Rishabh,34,0,35,1
1739706173349,MATH 170C,A04,847538,Dixit; Rishabh,35,0,35,0
1739706174379,MATH 171B,A01,847557,Huang; Lei,32,0,35,3
1739706174379,MATH 171B,A02,847560,Huang; Lei,34,0,35,1
1739706174379,MATH 171B,A03,847596,Huang; Lei,31,0,35,4
1739706174379,MATH 171B,A04,847597,Huang; Lei,32,0,35,3
1739706175408,MATH 179,A01,847599,Cheng; Li-Tien,25,0,25,0
1739706176434,MATH 180A,A01,847601,Webber; Robert Jacobs,31,0,35,4
1739706176434,MATH 180A,A02,847602,Webber; Robert Jacobs,35,0,35,0
1739706176434,MATH 180A,A03,847603,Webber; Robert Jacobs,34,0,35,1
1739706176434,MATH 180A,A04,847604,Webber; Robert Jacobs,32,0,35,3
1739706176434,MATH 180A,B01,847606,Hardiman; Liam,35,0,35,0
1739706176434,MATH 180A,B02,847680,Hardiman; Liam,31,0,35,4
1739706176434,MATH 180A,B03,847682,Hardiman; Liam,35,0,35,0
1739706176434,MATH 180A,B04,847683,Hardiman; Liam,35,0,35,0
1739706177464,MATH 180B,A01,847686,Warnke; Lutz Peter,32,0,32,0
1739706177464,MATH 180B,A02,847688,Warnke; Lutz Peter,31,0,32,1
1739706177464,MATH 180B,A03,847689,Warnke; Lutz Peter,31,0,32,1
1739706177464,MATH 180B,A04,847691,Warnke; Lutz Peter,31,0,32,1
1739706177464,MATH 180B,A05,847693,Warnke; Lutz Peter,32,0,32,0
1739706177464,MATH 180B,A06,847694,Warnke; Lutz Peter,30,0,32,2
1739706178492,MATH 180C,A01,847701,Ang; Jie Jun,34,0,35,1
1739706178492,MATH 180C,A02,847707,Ang; Jie Jun,35,0,35,0
1739706178492,MATH 180C,A03,847708,Ang; Jie Jun,32,0,35,3
1739706178492,MATH 180C,A04,847711,Ang; Jie Jun,31,0,35,4
1739706179517,MATH 181A,A01,847753,Zhang; Danna,15,0,35,20
1739706179517,MATH 181A,A02,847756,Zhang; Danna,32,0,35,3
1739706179517,MATH 181A,A03,847757,Zhang; Danna,32,0,35,3
1739706179517,MATH 181A,A04,847758,Zhang; Danna,33,0,35,2
1739706180546,MATH 181B,A01,847760,Rava; Denise,30,0,35,5
1739706180546,MATH 181B,A02,847761,Rava; Denise,34,0,35,1
1739706180546,MATH 181B,A03,847764,Rava; Denise,34,0,35,1
1739706180546,MATH 181B,A04,847765,Rava; Denise,35,0,35,0
1739706181571,MATH 183,A01,847768,Vishwanath; Siddharth,21,0,32,11
1739706181571,MATH 183,A02,847769,Vishwanath; Siddharth,30,0,32,2
1739706181571,MATH 183,A03,847770,Vishwanath; Siddharth,31,0,32,1
1739706181571,MATH 183,A04,847772,Vishwanath; Siddharth,29,0,32,3
1739706181571,MATH 183,A05,847774,Vishwanath; Siddharth,32,0,32,0
1739706181571,MATH 183,A06,847864,Vishwanath; Siddharth,31,0,32,1
1739706182597,MATH 184,A01,847866,Wesley; William J,35,0,35,0
1739706182597,MATH 184,A02,847874,Wesley; William J,33,0,35,2
1739706182597,MATH 184,A03,847875,Wesley; William J,35,0,35,0
1739706182597,MATH 184,A04,847876,Wesley; William J,33,0,35,2
1739706183626,MATH 185,A01,847880,Rava; Denise,31,0,35,4
1739706183626,MATH 185,A02,847881,Rava; Denise,35,0,35,0
1739706184651,MATH 187A,A01,847883,Klevdal; Christian Sleek,14,0,32,18
1739706184651,MATH 187A,A02,847886,Klevdal; Christian Sleek,29,0,32,3
1739706184651,MATH 187A,A03,847892,Klevdal; Christian Sleek,27,0,32,5
1739706184651,MATH 187A,A04,847893,Klevdal; Christian Sleek,32,0,32,0
1739706184651,MATH 187A,A05,847894,Klevdal; Christian Sleek,31,0,32,1
1739706184651,MATH 187A,A06,847903,Klevdal; Christian Sleek,31,0,32,1
1739706185679,MATH 187B,A01,847905,Bucur; Alina Ioana,28,0,35,7
1739706185679,MATH 187B,A02,847906,Bucur; Alina Ioana,34,0,35,1
1739706186708,MATH 189,A01,847908,Lou; Zhipeng,0,0,10,10
1739706186708,MATH 189,A02,847909,Lou; Zhipeng,0,0,10,10
1739706186708,MATH 189,A03,847910,Lou; Zhipeng,0,0,10,10
1739706186708,MATH 189,A04,847911,Lou; Zhipeng,0,0,10,10
1739706186708,MATH 189,A05,847912,Lou; Zhipeng,0,0,10,10
1739706186708,MATH 189,A06,847917,Lou; Zhipeng,0,0,10,10
1739706187734,MATH 190B,A01,848005,McKernan; James,30,0,35,5
1739706188761,MATH 194,A01,848012,Fitzsimmons; Patrick J,12,0,32,20
1739706188761,MATH 194,A02,848080,Fitzsimmons; Patrick J,31,0,32,1
1739706188761,MATH 194,A03,848081,Fitzsimmons; Patrick J,26,0,32,6
1739706188761,MATH 194,A04,848107,Fitzsimmons; Patrick J,32,0,32,0
1739706188761,MATH 194,A05,848108,Fitzsimmons; Patrick J,31,0,32,1
1739706188761,MATH 194,A06,848147,Fitzsimmons; Patrick J,30,0,32,2
1739706189790,MATH 197,001,872928,Kedlaya; Kiran S.,9999,0,9999,0
1739706190815,MATH 200C,A00,846124,Salehi Golsefidy; Alireza,18,0,20,2
1739706191839,MATH 202C,A00,846125,Rhoades; Brendon Patrick,18,0,20,2
1739706192867,MATH 203C,A00,846128,Izadi; Elham,20,0,20,0
1739706193892,MATH 204C,A00,846131,Pollack; Aaron,20,0,20,0
1739706194919,MATH 205,A00,846132,Popescu; Cristian D.,18,0,20,2
1739706195947,MATH 208,A00,846133,Oprea; Dragos N.,10,0,10,0
1739706196974,MATH 209,A00,846173,Bucur; Alina Ioana,10,0,10,0
1739706198001,MATH 211A,A00,846174,Salehi Golsefidy; Alireza,10,0,10,0
1739706199026,MATH 211B,A00,846175,Sanchez; Anthony,9,0,10,1
1739706200053,MATH 212B,A01,846177,Komarova; Natalia,10,0,10,0
1739706201078,MATH 214,A01,846179,Li; Bo,2,0,5,3
1739706201078,MATH 214,A02,846181,Li; Bo,5,0,5,0
1739706202103,MATH 216C,A00,846182,Cloninger; Alexander,17,0,20,3
1739706203128,MATH 218,A00,846183,Komarova; Natalia,9,0,10,1
1739706204153,MATH 220C,A00,846184,Oprea; Dragos N.,20,0,20,0
1739706205181,MATH 231C,A00,846185,Li; Bo,20,0,20,0
1739706206207,MATH 240C,A00,846187,Ioana; Adrian,18,0,20,2
1739706207234,MATH 243,A00,846188,Kunnawalkam Elayavalli; Sr,9,0,10,1
1739706208259,MATH 248,A00,846189,Bejenaru; Ioan,9,0,10,1
1739706209287,MATH 250C,A00,846190,Chow; Bennett,18,0,20,2
1739706210316,MATH 258,A00,846191,Ni; Lei,10,0,10,0
1739706211341,MATH 262A,A00,846192,Suk; Andrew Hoon,17,0,20,3
1739706212367,MATH 264C,A00,846193,Rhoades; Brendon Patrick,18,0,20,2
1739706213395,MATH 269,A00,846194,Warnke; Lutz Peter,9,0,10,1
1739706214423,MATH 270C,A00,846195,Leok; Melvin,14,0,20,6
1739706215503,MATH 271C,A00,846197,Nie; Jiawang,16,0,20,4
1739706216529,MATH 272C,A00,846198,Miller; Pearson,20,0,20,0
1739706217555,MATH 276,A00,846199,Mc Culloch; Andrew Douglas,0,0,0,0
1739706218584,MATH 278A,A00,846283,Cheng; Li-Tien,10,0,10,0
1739706219611,MATH 278B,A00,846322,Cloninger; Alexander,10,0,10,0
1739706220637,MATH 278C,A00,846333,Nie; Jiawang,10,0,10,0
1739706221662,MATH 279,A01,846359,Cheng; Li-Tien,10,0,10,0
1739706222686,MATH 280C,A00,846360,Kemp; Todd Aahron,18,0,20,2
1739706223714,MATH 281C,A00,846363,Zhang; Danna,8,0,20,12
1739706224742,MATH 285,A00,846378,Schweinsberg; Jason,7,0,20,13
1739706225767,MATH 288,A00,846382,Ang; Jie Jun,9,0,10,1
1739706226798,MATH 289A,A00,846386,Novak; Jonathan I,15,0,20,5
1739706226798,MATH 289A,B00,846413,Lou; Zhipeng,13,0,20,7
1739706226798,MATH 289A,C00,876133,Xu; Ronghui,2,0,10,8
1739706227822,MATH 290C,A00,846451,Roberts; Justin Deritter,18,0,20,2
1739706228846,MATH 292,A00,846481,Lu; Yunze,9,0,10,1
1739706229874,MATH 295,A00,846486,Bejenaru; Ioan,50,0,50,0
1739706230899,MATH 296,A00,846492,Warnke; Lutz Peter,20,0,20,0
1739706231929,MATH 297,001,889670,Gamst; Anthony Collins,0,0,0,0
1739706232956,MATS 200,A00,825196,Graeve; Olivia A,9988,0,9999,11
1739706233982,MATS 201B,A00,825197,Garay; Javier,44,0,55,11
1739706235007,MATS 205A,A00,825200,Meyers; Marc,15,0,20,5
1739706236036,MATS 252,A00,825203,Evdokimenko; Ekaterina,16,0,30,14
1739706237061,MATS 256,A00,825204,Chen; Renkun,24,0,30,6
1739706238089,MATS 261B,A00,825205,Qiao; Yu,20,0,25,5
1739706239114,MBC 296,001,887235,Staff,9999,0,9999,0
1739706240140,MCWP 40,001,858225,Wastal; Carrie King,14,0,15,1
1739706240140,MCWP 40,003,858230,Wastal; Carrie King,12,0,15,3
1739706240140,MCWP 40,004,858231,Wastal; Carrie King,12,0,15,3
1739706240140,MCWP 40,006,858235,Montejo; Carolina,20,0,20,0
1739706240140,MCWP 40,007,858240,Wastal; Carrie King,15,0,15,0
1739706240140,MCWP 40,008,858241,Wastal; Carrie King,11,0,15,4
1739706241171,MCWP 50,001,826425,Bartulis; Jason Michael,19,0,20,1
1739706241171,MCWP 50,002,826426,Bartulis; Jason Michael,19,0,20,1
1739706241171,MCWP 50,003,826427,Bartulis; Jason Michael,20,0,20,0
1739706241171,MCWP 50,004,826429,Compas; Sean Matthew,17,0,20,3
1739706241171,MCWP 50,005,826431,Compas; Sean Matthew,20,0,20,0
1739706241171,MCWP 50,006,826432,Krone; Jarret,19,0,20,1
1739706241171,MCWP 50,007,826433,Krone; Jarret,19,0,20,1
1739706241171,MCWP 50,008,826434,Redela; Pamela Morgan,20,0,20,0
1739706241171,MCWP 50,009,826435,Redela; Pamela Morgan,20,0,20,0
1739706241171,MCWP 50,010,826436,Carter; Andrea L,17,0,20,3
1739706241171,MCWP 50,011,826437,Carter; Andrea L,20,0,20,0
1739706241171,MCWP 50,012,826439,Nies; Laurie Elizabeth,20,0,20,0
1739706241171,MCWP 50,013,826474,Nies; Laurie Elizabeth,19,0,20,1
1739706241171,MCWP 50,014,826483,Duru; Nur,17,0,20,3
1739706241171,MCWP 50,015,826484,Duru; Nur,20,0,20,0
1739706241171,MCWP 50,016,826486,Silva; Kelly B,20,0,20,0
1739706241171,MCWP 50,017,826488,Silva; Kelly B,20,0,20,0
1739706241171,MCWP 50,018,826489,Silva; Kelly B,20,0,20,0
1739706241171,MCWP 50,019,826490,Carter; Jennifer A,20,0,20,0
1739706241171,MCWP 50,020,826491,Carter; Jennifer A,20,0,20,0
1739706241171,MCWP 50,021,826492,Smith; Haydee Marie,20,0,20,0
1739706241171,MCWP 50,022,826493,Smith; Haydee Marie,19,0,20,1
1739706241171,MCWP 50,023,826543,Morshed; Michael James,16,0,20,4
1739706241171,MCWP 50,024,826579,Morshed; Michael James,16,0,20,4
1739706241171,MCWP 50,025,826582,Pham; Vincent Minhduc,20,0,20,0
1739706241171,MCWP 50,026,826609,Pham; Vincent Minhduc,20,0,20,0
1739706242197,MCWP 50R,A00,826669,Miller; Elizabeth Deen,17,0,20,3
1739706242197,MCWP 50R,B00,826714,Miller; Elizabeth Deen,19,0,20,1
1739706243223,MCWP 125,A00,826719,Guillen; Melinda,20,0,20,0
1739706243223,MCWP 125,B00,826720,Guillen; Melinda,18,0,20,2
1739706243223,MCWP 125,C00,826721,Guillen; Melinda,15,0,20,5
1739706244252,MED 225,A00,872558,Esko; Jeffrey D.,6,0,6,0
1739706245277,MED 246,A00,872562,Gordts; Philip & Lewis; Amanda Lark & Godula; Kamil & Gagneux; Pascal & Esko; Jeffrey D. & Bode; Lars,10,0,10,0
1739706246308,MED 262,A00,883267,Singh; Karandeep,31,0,35,4
1739706247340,MED 265,A00,884437,El-Kareh; Robert E & Sitapati; Amy,27,0,30,3
1739706248368,MED 267,A01,883697,Hogarth; Michael Andrew,23,0,30,7
1739706249391,MED 275,A00,872551,Liu; George Yenhsi,7,0,10,3
1739706250415,MED 278,A00,884420,Carter; Hannah Kathryn & Mesirov; Jill P. & Curtius; Kathleen Mary,14,0,16,2
1739706251443,MED 296,001,866575,Chi; Neil C.,4,0,5,1
1739706251443,MED 296,002,866576,Castellanos; Luis R.,4,0,5,1
1739706251443,MED 296,003,866585,Jeong; Ah-Reum,4,0,5,1
1739706251443,MED 296,004,866590,Staff,5,0,5,0
1739706251443,MED 296,005,866627,Staff,5,0,5,0
1739706252470,MGT 3,A00,839898,Wagner; Timothy Ryan,96,0,98,2
1739706253495,MGT 4,A01,839906,Levkoff; Steven B.,5,0,6,1
1739706253495,MGT 4,A02,839911,Levkoff; Steven B.,5,0,6,1
1739706253495,MGT 4,A03,839913,Levkoff; Steven B.,5,0,6,1
1739706253495,MGT 4,B01,839919,Brooks; Marcus Raymond,30,0,32,2
1739706254520,MGT 5,A00,839921,Molloie Jr.; William H,184,0,186,2
1739706255547,MGT 12,A00,839922,Lindenberger; Wade Douglas,88,0,98,10
1739706255547,MGT 12,B00,839926,Lindenberger; Wade Douglas,75,0,100,25
1739706255547,MGT 12,C00,840027,Pecore; Joseph P.,87,0,100,13
1739706256574,MGT 16,A00,840029,Buchanan; Harold G,95,0,100,5
1739706256574,MGT 16,B00,840031,Buchanan; Harold G,95,0,100,5
1739706256574,MGT 16,C00,840033,Campbell; Robert Harold,119,0,120,1
1739706256574,MGT 16,D00,840034,Campbell; Robert Harold,118,0,120,2
1739706256574,MGT 16,E00,840049,Demill; Burritt,98,0,98,0
1739706256574,MGT 16,F00,840056,Demill; Burritt,97,0,98,1
1739706257611,MGT 18,A00,840060,McKay; Michael J,97,0,98,1
1739706257611,MGT 18,B00,840063,McKay; Michael J,96,0,98,2
1739706257611,MGT 18,C00,840074,McKay; Michael J,94,0,98,4
1739706257611,MGT 18,D00,840076,Chamberlain; Travis Dean,98,0,98,0
1739706258638,MGT 45,A00,840097,Pecore; Joseph P.,128,0,150,22
1739706258638,MGT 45,B00,840098,Pecore; Joseph P.,141,0,150,9
1739706259664,MGT 71,A00,840099,Park; Kun Soo,94,0,98,4
1739706260692,MGT 71R,A00,840101,Phiroz; Zal Navroze,117,0,150,33
1739706261719,MGT 100,A00,840102,Wilbur; Kenneth C,78,0,98,20
1739706261719,MGT 100,B00,840103,Wilbur; Kenneth C,87,0,98,11
1739706261719,MGT 100,C00,840104,Wilbur; Kenneth C,95,0,98,3
1739706262745,MGT 103,A00,840105,Bates; Kenneth Walter,93,0,98,5
1739706262745,MGT 103,B00,840106,Demill; Burritt,97,0,98,1
1739706262745,MGT 103,C00,840107,Eberhard; Craig A,98,0,98,0
1739706262745,MGT 103,D00,840225,Eberhard; Craig A,97,0,98,1
1739706262745,MGT 103,E00,840226,Ehrich; Kristine R,93,0,98,5
1739706262745,MGT 103,F00,840227,Ehrich; Kristine R,95,0,98,3
1739706262745,MGT 103,G00,840228,Ehrich; Kristine R,96,0,98,2
1739706263770,MGT 105,A00,840229,Bates; Kenneth Walter,87,0,98,11
1739706264798,MGT 106,A00,840230,Eberhard; Craig A,96,0,98,2
1739706265825,MGT 107,A00,881472,Yorkston; Eric A,94,0,98,4
1739706266850,MGT 109,A00,840231,Jasko; Katarzyna Beata,85,0,98,13
1739706266850,MGT 109,B00,840232,Liu; Wei,87,0,98,11
1739706267874,MGT 112,A00,840233,Somasundaram; Tyagarajan,91,0,98,7
1739706267874,MGT 112,B00,840234,Somasundaram; Tyagarajan,76,0,98,22
1739706268909,MGT 119,A00,840235,Anderson; Jon Marcus,140,0,140,0
1739706268909,MGT 119,B00,840236,Davis; Kathleen Ann,98,0,98,0
1739706268909,MGT 119,C00,840237,Mc Kenzie; Craig R.M.,97,0,98,1
1739706268909,MGT 119,D00,840238,Etingue Kum; Menes,40,0,40,0
1739706269934,MGT 121B,A00,840239,Klaas; Jeffrey David,91,0,98,7
1739706270962,MGT 128R,A00,840240,Krishnan; Viswanathan,83,0,98,15
1739706271986,MGT 131A,A00,840242,Houskeeper; Robert,147,0,150,3
1739706273011,MGT 131B,A00,840243,Houskeeper; Robert,98,0,98,0
1739706274035,MGT 132,A00,840244,Blakley; Bruce,95,0,98,3
1739706275061,MGT 137,A00,840245,Lindenberger; Wade Douglas,84,0,98,14
1739706276086,MGT 146,A00,881478,Brooks; Marcus Raymond,97,0,98,1
1739706277112,MGT 147,A00,840246,Anderson; John Charles,74,0,75,1
1739706278142,MGT 151R,A00,840253,Phiroz; Zal Navroze,84,0,98,14
1739706279167,MGT 153,A00,840254,Perols; Johan Lars,67,0,90,23
1739706280196,MGT 155,A00,881481,Shin; Hyo Duk,95,0,98,3
1739706281221,MGT 160,A00,840265,Johnson; Erik Barry,90,0,90,0
1739706281221,MGT 160,B00,840266,Staff,87,0,90,3
1739706281221,MGT 160,C00,840267,Staff,82,0,90,8
1739706282247,MGT 162,A00,840269,Levin; Joel,93,0,98,5
1739706282247,MGT 162,B00,840270,Levin; Joel,98,0,98,0
1739706283275,MGT 162R,A00,840271,Gneezy; Uri,173,0,199,26
1739706284304,MGT 164,A00,840272,McKay; Mary A,98,0,98,0
1739706284304,MGT 164,B00,840273,McKay; Mary A,97,0,98,1
1739706284304,MGT 164,C00,840274,McKay; Mary A,97,0,98,1
1739706284304,MGT 164,D00,840275,Meyer; Alison Bloomfield,92,0,98,6
1739706285329,MGT 166,A00,840365,Moran; Cathleen L.,98,0,98,0
1739706285329,MGT 166,B00,840429,Moran; Cathleen L.,96,0,98,2
1739706285329,MGT 166,C00,840430,Moran; Cathleen L.,97,0,98,1
1739706286355,MGT 167,A00,840431,Klaas; Jeffrey David,96,0,98,2
1739706287380,MGT 171R,A00,840478,Phiroz; Zal Navroze,73,0,98,25
1739706288406,MGT 172,A00,840536,Hedges; Kathleen & Royal; Rebecca,114,0,120,6
1739706288406,MGT 172,B00,840580,Hedges; Kathleen,92,0,98,6
1739706288406,MGT 172,C00,840581,Zimmermann; Carsten,96,0,98,2
1739706288406,MGT 172,D00,881483,Zimmermann; Carsten,97,0,98,1
1739706289431,MGT 173,A00,840604,Hayes; Sherry Lorine,91,0,98,7
1739706290456,MGT 175,A00,840636,Gopal; Christopher S.,94,0,98,4
1739706291479,MGT 180,A00,840641,Bliss; Barbara Ann,145,0,150,5
1739706291479,MGT 180,B00,840642,Bliss; Barbara Ann,143,0,150,7
1739706292505,MGT 181,A00,840643,Buchanan; Harold G,117,0,120,3
1739706293529,MGT 184,A00,886143,Parashar; Sat P,89,0,98,9
1739706294557,MGT 185,A00,840648,Dunn; Louis Jean,88,0,98,10
1739706295583,MGT 187,A00,840649,Dunn; Louis Jean,68,0,75,7
1739706296608,MGT 189,A00,840650,Avenancio-Leon; Carlos,88,0,98,10
1739706297635,MGT 255,A00,840651,Rottenstreich; Yuval S,15,0,20,5
1739706298661,MGT 259,A00,872537,Staff,16,0,20,4
1739706299689,MGT 285,A00,840652,Liu; Jun,20,0,20,0
1739706300718,MGT 296,001,870424,Gneezy; Ayelet,3,0,3,0
1739706300718,MGT 296,002,870453,Amir; On,3,0,3,0
1739706300718,MGT 296,003,870454,Amir; On & Karmarkar; Uma R,3,0,3,0
1739706300718,MGT 296,004,870455,Liu; Jun,2,0,3,1
1739706300718,MGT 296,005,870456,Hansen; Karsten T.,3,0,3,0
1739706300718,MGT 296,006,870471,Erat; Sanjiv,3,0,3,0
1739706300718,MGT 296,007,870472,Timmermann; Allan,3,0,3,0
1739706300718,MGT 296,008,870501,Smith; Pamela Karen,3,0,3,0
1739706300718,MGT 296,009,870502,Zhang; Zhe,3,0,3,0
1739706300718,MGT 296,010,870508,Oveis; Christopher S,3,0,3,0
1739706300718,MGT 296,011,870523,Amir; On & Gneezy; Ayelet,2,0,3,1
1739706300718,MGT 296,012,870537,Luo; Danqi,3,0,3,0
1739706301756,MMW 13,A01,823232,Chang; Edmond Yi-Teh,16,0,16,0
1739706301756,MMW 13,A02,823239,Chang; Edmond Yi-Teh,16,0,16,0
1739706301756,MMW 13,A03,823242,Chang; Edmond Yi-Teh,16,0,16,0
1739706301756,MMW 13,A04,823251,Chang; Edmond Yi-Teh,16,0,16,0
1739706301756,MMW 13,A05,823252,Chang; Edmond Yi-Teh,16,0,16,0
1739706301756,MMW 13,A06,823253,Chang; Edmond Yi-Teh,15,0,16,1
1739706301756,MMW 13,A07,823255,Chang; Edmond Yi-Teh,16,0,16,0
1739706301756,MMW 13,A08,823257,Chang; Edmond Yi-Teh,16,0,16,0
1739706301756,MMW 13,A09,823263,Chang; Edmond Yi-Teh,16,0,16,0
1739706301756,MMW 13,A10,823291,Chang; Edmond Yi-Teh,16,0,16,0
1739706301756,MMW 13,A11,823292,Chang; Edmond Yi-Teh,16,0,16,0
1739706301756,MMW 13,A12,823293,Chang; Edmond Yi-Teh,16,0,16,0
1739706301756,MMW 13,A13,823370,Chang; Edmond Yi-Teh,0,0,0,0
1739706301756,MMW 13,A14,823480,Chang; Edmond Yi-Teh,0,0,0,0
1739706301756,MMW 13,A15,823481,Chang; Edmond Yi-Teh,16,0,16,0
1739706301756,MMW 13,A16,823482,Chang; Edmond Yi-Teh,15,0,16,1
1739706301756,MMW 13,A17,823483,Chang; Edmond Yi-Teh,16,0,16,0
1739706301756,MMW 13,A18,823484,Chang; Edmond Yi-Teh,16,0,16,0
1739706301756,MMW 13,A19,823485,Chang; Edmond Yi-Teh,0,0,0,0
1739706301756,MMW 13,A20,823486,Chang; Edmond Yi-Teh,0,0,0,0
1739706301756,MMW 13,B01,823488,Zhiri; Oumelbanine,15,0,16,1
1739706301756,MMW 13,B02,823490,Zhiri; Oumelbanine,15,0,16,1
1739706301756,MMW 13,B03,823491,Zhiri; Oumelbanine,14,0,16,2
1739706301756,MMW 13,B04,823492,Zhiri; Oumelbanine,15,0,16,1
1739706301756,MMW 13,B05,823493,Zhiri; Oumelbanine,16,0,16,0
1739706301756,MMW 13,B06,823494,Zhiri; Oumelbanine,13,0,16,3
1739706301756,MMW 13,B07,823495,Zhiri; Oumelbanine,15,0,16,1
1739706301756,MMW 13,B08,823496,Zhiri; Oumelbanine,15,0,16,1
1739706301756,MMW 13,B09,823522,Zhiri; Oumelbanine,16,0,16,0
1739706301756,MMW 13,B10,823528,Zhiri; Oumelbanine,16,0,16,0
1739706301756,MMW 13,B11,823604,Zhiri; Oumelbanine,16,0,16,0
1739706301756,MMW 13,B12,823613,Zhiri; Oumelbanine,16,0,16,0
1739706301756,MMW 13,B13,823624,Zhiri; Oumelbanine,16,0,16,0
1739706301756,MMW 13,B14,823627,Zhiri; Oumelbanine,15,0,16,1
1739706301756,MMW 13,B15,823631,Zhiri; Oumelbanine,16,0,16,0
1739706301756,MMW 13,B16,823642,Zhiri; Oumelbanine,15,0,16,1
1739706301756,MMW 13,C01,823773,Murillo; Dana V.,16,0,16,0
1739706301756,MMW 13,C02,823774,Murillo; Dana V.,16,0,16,0
1739706301756,MMW 13,C03,823793,Murillo; Dana V.,16,0,16,0
1739706301756,MMW 13,C04,823794,Murillo; Dana V.,16,0,16,0
1739706301756,MMW 13,C05,823801,Murillo; Dana V.,16,0,16,0
1739706301756,MMW 13,C06,823856,Murillo; Dana V.,16,0,16,0
1739706301756,MMW 13,C07,823876,Murillo; Dana V.,16,0,16,0
1739706301756,MMW 13,C08,823878,Murillo; Dana V.,16,0,16,0
1739706301756,MMW 13,C09,823956,Murillo; Dana V.,0,0,0,0
1739706301756,MMW 13,C10,823978,Murillo; Dana V.,0,0,0,0
1739706301756,MMW 13,C11,824009,Murillo; Dana V.,0,0,0,0
1739706301756,MMW 13,C12,824022,Murillo; Dana V.,0,0,0,0
1739706301756,MMW 13,C13,824023,Murillo; Dana V.,16,0,16,0
1739706301756,MMW 13,C14,824027,Murillo; Dana V.,15,0,16,1
1739706301756,MMW 13,C15,824029,Murillo; Dana V.,0,0,0,0
1739706301756,MMW 13,C16,824036,Murillo; Dana V.,0,0,0,0
1739706301756,MMW 13,D01,824044,Vitkus; Daniel J.,16,0,16,0
1739706301756,MMW 13,D02,824045,Vitkus; Daniel J.,16,0,16,0
1739706301756,MMW 13,D03,824050,Vitkus; Daniel J.,16,0,16,0
1739706301756,MMW 13,D04,824066,Vitkus; Daniel J.,16,0,16,0
1739706301756,MMW 13,D05,824070,Vitkus; Daniel J.,16,0,16,0
1739706301756,MMW 13,D06,824080,Vitkus; Daniel J.,16,0,16,0
1739706301756,MMW 13,D07,824081,Vitkus; Daniel J.,16,0,16,0
1739706301756,MMW 13,D08,824092,Vitkus; Daniel J.,16,0,16,0
1739706301756,MMW 13,D09,824112,Vitkus; Daniel J.,0,0,0,0
1739706301756,MMW 13,D10,824248,Vitkus; Daniel J.,0,0,0,0
1739706301756,MMW 13,D11,824303,Vitkus; Daniel J.,0,0,0,0
1739706301756,MMW 13,D12,824311,Vitkus; Daniel J.,0,0,0,0
1739706301756,MMW 13,D13,824312,Vitkus; Daniel J.,16,0,16,0
1739706301756,MMW 13,D14,824317,Vitkus; Daniel J.,16,0,16,0
1739706301756,MMW 13,D15,824377,Vitkus; Daniel J.,0,0,0,0
1739706301756,MMW 13,D16,824378,Vitkus; Daniel J.,0,0,0,0
1739706302783,MMW 15,A01,824426,Chang; Edmond Yi-Teh,27,0,28,1
1739706302783,MMW 15,A02,824586,Chang; Edmond Yi-Teh,26,0,28,2
1739706302783,MMW 15,A03,824617,Chang; Edmond Yi-Teh,24,0,28,4
1739706302783,MMW 15,A04,824641,Chang; Edmond Yi-Teh,26,0,28,2
1739706302783,MMW 15,A05,824653,Chang; Edmond Yi-Teh,25,0,28,3
1739706302783,MMW 15,A06,824689,Chang; Edmond Yi-Teh,28,0,28,0
1739706302783,MMW 15,A07,824735,Chang; Edmond Yi-Teh,28,0,28,0
1739706302783,MMW 15,A08,824804,Chang; Edmond Yi-Teh,27,0,28,1
1739706302783,MMW 15,A09,824805,Chang; Edmond Yi-Teh,0,0,0,0
1739706302783,MMW 15,A10,824963,Chang; Edmond Yi-Teh,0,0,0,0
1739706302783,MMW 15,B01,824999,Peterson; Johanna L,0,0,0,0
1739706302783,MMW 15,B02,825015,Peterson; Johanna L,0,0,0,0
1739706302783,MMW 15,B03,825050,Peterson; Johanna L,18,0,28,10
1739706302783,MMW 15,B04,825079,Peterson; Johanna L,24,0,28,4
1739706302783,MMW 15,B05,825109,Peterson; Johanna L,27,0,28,1
1739706302783,MMW 15,B06,825114,Peterson; Johanna L,24,0,28,4
1739706302783,MMW 15,B07,825151,Peterson; Johanna L,23,0,28,5
1739706302783,MMW 15,B08,825183,Peterson; Johanna L,19,0,28,9
1739706302783,MMW 15,B09,825190,Peterson; Johanna L,28,0,28,0
1739706302783,MMW 15,B10,825191,Peterson; Johanna L,26,0,28,2
1739706302783,MMW 15,B11,825192,Peterson; Johanna L,0,0,0,0
1739706302783,MMW 15,B12,825193,Peterson; Johanna L,0,0,0,0
1739706303811,MSED 295,A00,825207,Staff,5,0,5,0
1739706304837,MUS 1C,A01,826943,Staff,24,0,25,1
1739706304837,MUS 1C,A02,826944,Staff,23,0,25,2
1739706304837,MUS 1C,A03,826945,Staff,25,0,25,0
1739706305862,MUS 2C,A01,826955,Obermueller; Karola,29,0,30,1
1739706306886,MUS 2CK,A00,826957,Ohnishi; Takae,14,0,15,1
1739706306886,MUS 2CK,B00,826960,Ohnishi; Takae,15,0,15,0
1739706307911,MUS 2JK,A00,826963,Kenyatta; Kamau,13,0,15,2
1739706308937,MUS 4,A01,826968,Day; Kevin Alexander,24,0,25,1
1739706308937,MUS 4,A02,826969,Day; Kevin Alexander,24,0,25,1
1739706308937,MUS 4,A03,826970,Day; Kevin Alexander,25,0,25,0
1739706308937,MUS 4,A04,826972,Day; Kevin Alexander,25,0,25,0
1739706308937,MUS 4,A05,826973,Day; Kevin Alexander,25,0,25,0
1739706308937,MUS 4,A06,826986,Day; Kevin Alexander,25,0,25,0
1739706308937,MUS 4,A07,826987,Day; Kevin Alexander,25,0,25,0
1739706308937,MUS 4,A08,826988,Day; Kevin Alexander,25,0,25,0
1739706308937,MUS 4,A09,826989,Day; Kevin Alexander,25,0,25,0
1739706308937,MUS 4,A10,826990,Day; Kevin Alexander,24,0,25,1
1739706309966,MUS 6,A01,826992,Hankins; Sarah E.,24,0,25,1
1739706309966,MUS 6,A02,826993,Hankins; Sarah E.,23,0,25,2
1739706309966,MUS 6,A03,826994,Hankins; Sarah E.,25,0,25,0
1739706309966,MUS 6,A04,826995,Hankins; Sarah E.,22,0,25,3
1739706310992,MUS 8,A01,826997,Smythe; Cory Benjamin,23,0,25,2
1739706310992,MUS 8,A02,826998,Smythe; Cory Benjamin,25,0,25,0
1739706310992,MUS 8,A03,827002,Smythe; Cory Benjamin,25,0,25,0
1739706310992,MUS 8,A04,827003,Smythe; Cory Benjamin,22,0,25,3
1739706310992,MUS 8,A05,827004,Smythe; Cory Benjamin,25,0,25,0
1739706310992,MUS 8,A06,827005,Smythe; Cory Benjamin,25,0,25,0
1739706310992,MUS 8,A07,827006,Smythe; Cory Benjamin,24,0,25,1
1739706310992,MUS 8,A08,827007,Smythe; Cory Benjamin,23,0,25,2
1739706312021,MUS 11,A01,827011,Terrazas Perez; Wilfrido D,23,0,25,2
1739706312021,MUS 11,A02,827012,Terrazas Perez; Wilfrido D,23,0,25,2
1739706312021,MUS 11,A03,827013,Terrazas Perez; Wilfrido D,25,0,25,0
1739706312021,MUS 11,A04,827014,Terrazas Perez; Wilfrido D,24,0,25,1
1739706312021,MUS 11,A05,827015,Terrazas Perez; Wilfrido D,25,0,25,0
1739706312021,MUS 11,A06,827016,Terrazas Perez; Wilfrido D,25,0,25,0
1739706312021,MUS 11,A07,827017,Terrazas Perez; Wilfrido D,25,0,25,0
1739706312021,MUS 11,A08,827018,Terrazas Perez; Wilfrido D,22,0,25,3
1739706313052,MUS 12,A01,827020,Guy; Nancy,24,0,25,1
1739706313052,MUS 12,A02,827021,Guy; Nancy,25,0,25,0
1739706313052,MUS 12,A03,827022,Guy; Nancy,25,0,25,0
1739706313052,MUS 12,A04,827023,Guy; Nancy,24,0,25,1
1739706314080,MUS 14,A01,827025,McCormack; Timothy Matthew,25,0,25,0
1739706314080,MUS 14,A02,827026,McCormack; Timothy Matthew,25,0,25,0
1739706314080,MUS 14,A03,827027,McCormack; Timothy Matthew,24,0,25,1
1739706314080,MUS 14,A04,827028,McCormack; Timothy Matthew,25,0,25,0
1739706315107,MUS 15,A01,827031,Staff,22,0,25,3
1739706315107,MUS 15,A02,827032,Staff,23,0,25,2
1739706315107,MUS 15,A03,827033,Staff,24,0,25,1
1739706315107,MUS 15,A04,827034,Staff,25,0,25,0
1739706315107,MUS 15,A05,827035,Staff,25,0,25,0
1739706315107,MUS 15,A06,827036,Staff,23,0,25,2
1739706315107,MUS 15,A07,827037,Staff,25,0,25,0
1739706315107,MUS 15,A08,827038,Staff,24,0,25,1
1739706315107,MUS 15,A09,827039,Staff,25,0,25,0
1739706315107,MUS 15,A10,827049,Staff,23,0,25,2
1739706316133,MUS 17,A01,827051,Staff,23,0,25,2
1739706316133,MUS 17,A02,827052,Staff,25,0,25,0
1739706316133,MUS 17,A03,827053,Staff,25,0,25,0
1739706316133,MUS 17,A04,827054,Staff,24,0,25,1
1739706316133,MUS 17,A05,827055,Staff,25,0,25,0
1739706316133,MUS 17,A06,827056,Staff,24,0,25,1
1739706316133,MUS 17,A07,827057,Staff,24,0,25,1
1739706316133,MUS 17,A08,827060,Staff,23,0,25,2
1739706316133,MUS 17,A09,827061,Staff,25,0,25,0
1739706316133,MUS 17,A10,827062,Staff,25,0,25,0
1739706316133,MUS 17,A11,827063,Staff,25,0,25,0
1739706316133,MUS 17,A12,827064,Staff,24,0,25,1
1739706317165,MUS 19R,A01,827066,Britt; King James,23,0,25,2
1739706317165,MUS 19R,A02,827067,Britt; King James,15,0,25,10
1739706317165,MUS 19R,A03,827068,Britt; King James,25,0,25,0
1739706317165,MUS 19R,A04,827069,Britt; King James,22,0,25,3
1739706317165,MUS 19R,A05,827070,Britt; King James,25,0,25,0
1739706317165,MUS 19R,A06,827071,Britt; King James,21,0,25,4
1739706317165,MUS 19R,A07,827072,Britt; King James,24,0,25,1
1739706317165,MUS 19R,A08,827083,Britt; King James,23,0,25,2
1739706317165,MUS 19R,B01,827121,Britt; King James,5,0,5,0
1739706317165,MUS 19R,B02,827122,Britt; King James,5,0,5,0
1739706317165,MUS 19R,B03,827123,Britt; King James,5,0,5,0
1739706317165,MUS 19R,B04,827128,Britt; King James,5,0,5,0
1739706317165,MUS 19R,B05,827129,Britt; King James,5,0,5,0
1739706317165,MUS 19R,B06,827130,Britt; King James,5,0,5,0
1739706317165,MUS 19R,B07,827198,Britt; King James,5,0,5,0
1739706317165,MUS 19R,B08,827199,Britt; King James,5,0,5,0
1739706318192,MUS 32,001,855621,Dresser; Mark Stuart,10,0,10,0
1739706318192,MUS 32,002,855622,Kenyatta; Kamau,10,0,10,0
1739706318192,MUS 32,003,855623,Curtis; Charles Rector,10,0,10,0
1739706318192,MUS 32,004,855624,Carlstrom; Mitchell Kraig,10,0,10,0
1739706318192,MUS 32,005,855625,Terrazas Perez; Wilfrido D,10,0,10,0
1739706318192,MUS 32,006,855628,Ohnishi; Takae,10,0,10,0
1739706318192,MUS 32,007,855629,Burr; Anthony I,10,0,10,0
1739706318192,MUS 32,008,855630,Carlson; Erik,10,0,10,0
1739706318192,MUS 32,009,855631,Staff,10,0,10,0
1739706319270,MUS 32V,A00,827206,Narucki; Susan M,10,0,10,0
1739706319270,MUS 32V,B00,827209,Flores Bucio; Mariana,10,0,10,0
1739706319270,MUS 32V,C00,827210,Zazueta Cervera; Miguel Angel,10,0,10,0
1739706320295,MUS 32VM,A00,827211,Zazueta Cervera; Miguel Angel,19,0,19,0
1739706321319,MUS 43,A00,827216,Yadegari; Shahrokh D,91,0,96,5
1739706322348,MUS 95C,A00,827217,Flores Bucio; Mariana,34,0,40,6
1739706323376,MUS 95D,A00,827219,Yadegari; Shahrokh D,40,0,40,0
1739706324407,MUS 95E,A00,827229,Henson; Matthew Alexander,40,0,40,0
1739706325434,MUS 95F,A00,827332,Carlstrom; Mitchell Kraig,40,0,40,0
1739706326458,MUS 95G,A00,827371,Anderson; Kenneth,386,0,395,9
1739706326458,MUS 95G,B00,827384,Anderson; Kenneth,391,0,395,4
1739706327485,MUS 95JC,A00,827385,Kenyatta; Kamau,25,0,25,0
1739706328512,MUS 95L,A00,827386,Pittman; Katherine Sue,65,0,65,0
1739706329538,MUS 95P,A00,827387,Nourai; Keyavash,17,0,20,3
1739706330563,MUS 95W,A00,827388,Seshadri; Kartik,21,0,25,4
1739706330563,MUS 95W,B00,827389,Seshadri; Kartik,25,0,25,0
1739706331589,MUS 101C,A01,827517,Day; Kevin Alexander,34,0,35,1
1739706332616,MUS 103C,A00,827518,Steiger; Rand,14,0,15,1
1739706333642,MUS 103F,A00,827546,Steiger; Rand,1,0,1,0
1739706334669,MUS 107,A00,827547,Guy; Nancy,15,0,15,0
1739706335698,MUS 111,A00,827548,Liang; Lei,118,0,120,2
1739706336728,MUS 113,A00,827549,Narucki; Susan M,30,0,30,0
1739706337755,MUS 114,A00,827550,Schick; Steven,138,0,140,2
1739706338781,MUS 120C,A01,827563,Leslie Santana; Myrta,24,0,25,1
1739706339810,MUS 130,A00,827567,Ohnishi; Takae,35,0,35,0
1739706340836,MUS 132,001,855633,Dresser; Mark Stuart,10,0,10,0
1739706340836,MUS 132,002,855635,Kenyatta; Kamau,10,0,10,0
1739706340836,MUS 132,003,855637,Curtis; Charles Rector,10,0,10,0
1739706340836,MUS 132,004,855639,Carlstrom; Mitchell Kraig,10,0,10,0
1739706340836,MUS 132,006,855641,Terrazas Perez; Wilfrido D,10,0,10,0
1739706340836,MUS 132,007,855642,Ohnishi; Takae,10,0,10,0
1739706340836,MUS 132,008,855643,Burr; Anthony I,10,0,10,0
1739706340836,MUS 132,009,855646,Carlson; Erik,10,0,10,0
1739706340836,MUS 132,010,855647,Smythe; Cory Benjamin,10,0,10,0
1739706340836,MUS 132,011,855648,Richards; Stephanie F,10,0,10,0
1739706340836,MUS 132,012,855649,Nourai; Keyavash,10,0,10,0
1739706341866,MUS 132R,A00,827568,Narucki; Susan M,2,0,2,0
1739706342893,MUS 132V,A00,827569,Narucki; Susan M,15,0,15,0
1739706342893,MUS 132V,B00,827570,Zazueta Cervera; Miguel Angel,15,0,15,0
1739706342893,MUS 132V,C00,827572,Flores Bucio; Mariana,15,0,15,0
1739706343918,MUS 134,A00,827573,Yadegari; Shahrokh D,30,0,30,0
1739706344947,MUS 137C,A00,827574,Kenyatta; Kamau,35,0,35,0
1739706345974,MUS 143,A00,827575,Yadegari; Shahrokh D,28,0,30,2
1739706347002,MUS 150,A00,872496,Roberts; Matana,28,0,30,2
1739706348029,MUS 151,A00,827577,Hankins; Sarah E.,9,0,20,11
1739706349055,MUS 160B,A00,827579,Dubnov; Shlomo,14,0,15,1
1739706349055,MUS 160B,B00,827581,Freitas Caetano; Marcelo,15,0,15,0
1739706350080,MUS 172,A01,827584,Staff,37,0,45,8
1739706351106,MUS 174C,A00,827585,Erbe; Tom,21,0,27,6
1739706352134,MUS 175,A00,827586,Smyth; Tamara R.,27,0,30,3
1739706353158,MUS 176,A00,827587,Britt; King James,30,0,30,0
1739706354183,MUS 201A,A00,827590,Narucki; Susan M,15,0,15,0
1739706354183,MUS 201A,B00,827592,Dresser; Mark Stuart,15,0,15,0
1739706355208,MUS 201C,A00,827593,Schick; Steven,15,0,15,0
1739706356234,MUS 202,A00,827596,Schick; Steven,40,0,40,0
1739706357259,MUS 203C,A00,827597,McCormack; Timothy Matthew,13,0,15,2
1739706358288,MUS 203D,A00,827598,Davis; Anthony Curtis,10,0,10,0
1739706358288,MUS 203D,B00,827599,Obermueller; Karola,10,0,10,0
1739706358288,MUS 203D,C00,827600,Liang; Lei,10,0,10,0
1739706358288,MUS 203D,D00,827601,Lou; Michelle Siulai,10,0,10,0
1739706358288,MUS 203D,E00,827602,Steiger; Rand,10,0,10,0
1739706358288,MUS 203D,F00,827605,McCormack; Timothy Matthew,10,0,10,0
1739706359319,MUS 204,A00,827607,Obermueller; Karola,24,0,25,1
1739706360344,MUS 205,A00,827608,Hankins; Sarah E.,14,0,15,1
1739706361369,MUS 206,A00,827609,Lou; Michelle Siulai,0,0,0,0
1739706361369,MUS 206,B00,827610,Dresser; Mark Stuart,15,0,15,0
1739706361369,MUS 206,C00,872457,Roberts; Matana,14,0,15,1
1739706362393,MUS 207,A00,827611,Leslie Santana; Myrta,13,0,15,2
1739706362393,MUS 207,B00,872458,Guy; Nancy,15,0,15,0
1739706363418,MUS 210,A00,827612,Davis; Anthony Curtis,15,0,15,0
1739706364443,MUS 229,A00,872460,Liang; Lei,15,0,15,0
1739706365468,MUS 232,001,855654,Dresser; Mark Stuart,10,0,10,0
1739706365468,MUS 232,002,855655,Kenyatta; Kamau,10,0,10,0
1739706365468,MUS 232,003,855656,Curtis; Charles Rector,10,0,10,0
1739706365468,MUS 232,004,855659,Terrazas Perez; Wilfrido D,10,0,10,0
1739706365468,MUS 232,005,855660,Ohnishi; Takae,10,0,10,0
1739706365468,MUS 232,006,855661,Burr; Anthony I,10,0,10,0
1739706365468,MUS 232,007,855662,Carlson; Erik,10,0,10,0
1739706365468,MUS 232,008,855663,Schick; Steven,10,0,10,0
1739706365468,MUS 232,009,855664,Narucki; Susan M,10,0,10,0
1739706366492,MUS 234,A00,827614,Yadegari; Shahrokh D,20,0,20,0
1739706367519,MUS 245,A00,827616,Carlson; Erik,15,0,15,0
1739706368544,MUS 267,A00,827617,Erbe; Tom,13,0,15,2
1739706369569,MUS 270C,A00,827618,Dubnov; Shlomo,18,0,20,2
1739706370602,NANO 100L,A00,808557,Vecchio; Kenneth S,17,0,20,3
1739706371625,NANO 103,A00,808560,Jahed Motlagh; Zeinab,49,0,50,1
1739706372655,NANO 108,A00,808561,Lubarda; Vlado,100,0,100,0
1739706373680,NANO 112,A01,808563,Vazquez Mena; Oscar,69,0,70,1
1739706374705,NANO 115L,A01,808567,Xu; Sheng,32,0,38,6
1739706374705,NANO 115L,B01,808569,Yang; Kesong,38,0,38,0
1739706375731,NANO 120B,A01,808575,Pokorski; Jonathan Kyle,32,0,35,3
1739706375731,NANO 120B,B01,808577,Ong; Shyue Ping,34,0,35,1
1739706376760,NANO 158,A00,808580,Luo; Jian,50,0,50,0
1739706377787,NANO 174,A00,808582,Meyers; Marc,49,0,50,1
1739706378811,NANO 181R,A00,869155,Ong; Shyue Ping,38,0,40,2
1739706379836,NANO 200,A00,808584,Jahed Motlagh; Zeinab,108,0,120,12
1739706380861,NANO 273,A00,808614,Shah; Nisarg,24,0,30,6
1739706381887,NANO 279,A00,808619,Liu; Ping,44,0,50,6
1739706382912,NANO 281R,A00,808633,Ong; Shyue Ping,37,0,60,23
1739706383939,NANO 282,A00,808661,Steinmetz; Nicole F,49,0,50,1
1739706384969,NEU 200C,A00,827621,Miller; Cory T.,15,0,18,3
1739706385995,NEU 276,A01,827623,Castle; Michael James,26,0,28,2
1739706387032,NEU 296,001,866729,Evans; Sean Jeffrey,6,0,10,4
1739706387032,NEU 296,002,866730,Staff,5,0,5,0
1739706387032,NEU 296,003,866731,Staff,5,0,5,0
1739706388059,NEUG 221,A00,827624,Zou; Yimin,8,0,12,4
1739706389084,NEUG 280,A00,827625,Chen; Xu,12,0,12,0
1739706390112,NEUG 296,A00,827626,Bloodgood; Brenda Laurie,9999,0,9999,0
1739706390112,NEUG 296,B00,827627,Allen; Nicola J,9999,0,9999,0
1739706391137,OPTH 296,001,866835,Afshari; Natalie,4,0,5,1
1739706391137,OPTH 296,002,866836,Staff,5,0,5,0
1739706391137,OPTH 296,003,866838,Staff,5,0,5,0
1739706392162,ORTH 296,A00,866851,Staff,5,0,5,0
1739706392162,ORTH 296,001,866849,Schwartz; Alexandra K.,4,0,5,1
1739706392162,ORTH 296,002,866850,Staff,5,0,5,0
1739706393190,PAE 240,A00,866068,Villarreal Jr.; Elias,30,0,30,0
1739706394213,PAE 241,A01,866073,Villarreal Jr.; Elias,30,0,30,0
1739706395243,PAE 242,A00,866077,Villarreal Jr.; Elias,30,0,30,0
1739706396269,PAE 243,A00,866078,Villarreal Jr.; Elias,30,0,30,0
1739706397293,PAE 244,A00,866119,Villarreal Jr.; Elias,30,0,30,0
1739706398320,PAE 245,A01,866083,Villarreal Jr.; Elias,30,0,30,0
1739706399343,PAE 246,A00,866085,Villarreal Jr.; Elias,30,0,30,0
1739706400369,PATH 296,001,866942,Staff,5,0,5,0
1739706400369,PATH 296,002,866945,Staff,5,0,5,0
1739706400369,PATH 296,003,866947,Staff,5,0,5,0
1739706401397,PEDS 296,001,866976,Staff,5,0,5,0
1739706401397,PEDS 296,002,866982,Staff,5,0,5,0
1739706401397,PEDS 296,003,866985,Staff,5,0,5,0
1739706402423,PH 45,A01,818863,Stone; Matthew David,28,0,30,2
1739706402423,PH 45,A02,818864,Stone; Matthew David,26,0,30,4
1739706403451,PH 50,A00,818865,Glockner; Susan Mariscal,291,0,300,9
1739706404478,PH 95,A00,885315,Larsen; Britta Ann,39,0,40,1
1739706405505,PH 101,A00,818868,Tan; Gene Brian,43,0,50,7
1739706406535,PH 102,A01,818870,Rana; Brinda Kanti,17,0,25,8
1739706406535,PH 102,A02,818871,Rana; Brinda Kanti,22,0,25,3
1739706406535,PH 102,B01,818963,Rana; Brinda Kanti,21,0,25,4
1739706406535,PH 102,B02,818965,Rana; Brinda Kanti,24,0,25,1
1739706407561,PH 110,A00,818966,Campbell; Chadwick Karl,58,0,60,2
1739706407561,PH 110,B00,818968,Zoumas-Morse; Christine E.,46,0,50,4
1739706408587,PH 120,A00,818972,Wynn; Adriane Michelle,50,0,60,10
1739706409612,PH 130,A00,818976,Gould; Carlos Francisco,36,0,50,14
1739706410638,PH 155,A00,818977,Fielding-Miller; Rebecca,68,0,70,2
1739706411662,PH 162,A00,872363,Eikey; Elizabeth Victoria,23,0,30,7
1739706412688,PH 194,A00,818984,Zoumas-Morse; Christine E.,0,0,0,0
1739706412688,PH 194,B00,819006,Zoumas-Morse; Christine E.,0,0,0,0
1739706412688,PH 194,C00,819010,Nguyen-Grozavu; France T.,0,0,0,0
1739706412688,PH 194,D00,819013,Nguyen-Grozavu; France T.,0,0,0,0
1739706412688,PH 194,E00,819017,White; Anne Elizabeth Clar,0,0,0,0
1739706412688,PH 194,F00,819024,Marquez; Becky,0,0,0,0
1739706413714,PH 196BH,A01,819028,Binkin; Nancy Jeanne,20,0,20,0
1739706414742,PHAR 219,A00,828488,Ross; Camille,0,0,0,0
1739706415768,PHAR 227,A00,872418,Zhang; Jin,19,0,20,1
1739706416792,PHAR 231,A00,881484,Daneman; Richard & Newton; Alexandra C.,20,0,20,0
1739706416792,PHAR 231,B00,881486,Staff,20,0,20,0
1739706416792,PHAR 231,C00,881489,Schoeneberg; Johannes,20,0,20,0
1739706417822,PHAR 234,A00,881479,Newton; Alexandra C.,20,0,20,0
1739706418846,PHAR 276,A00,828494,Mc Culloch; Andrew Douglas,0,0,0,0
1739706419872,PHAR 295,A00,828499,Joiner; William J.,14,0,15,1
1739706420897,PHB 223,A00,819029,Vaida; Florin,17,0,36,19
1739706421922,PHB 228,A00,819036,Thomas; Ronald G,26,0,36,10
1739706423003,PHB 248,A00,819043,Xu; Ronghui,10,0,25,15
1739706424035,PHB 281,A00,872569,Staff,55,0,65,10
1739706425061,PHIL 1,A00,829682,Grush; Rick Scott,57,0,60,3
1739706426088,PHIL 10,A01,829896,Grush; Rick Scott,44,0,44,0
1739706426088,PHIL 10,A02,829897,Grush; Rick Scott,43,0,44,1
1739706426088,PHIL 10,A03,829898,Grush; Rick Scott,43,0,44,1
1739706426088,PHIL 10,A04,829899,Grush; Rick Scott,42,0,44,2
1739706426088,PHIL 10,A05,829900,Grush; Rick Scott,42,0,44,2
1739706426088,PHIL 10,A06,829901,Grush; Rick Scott,42,0,44,2
1739706427115,PHIL 13,A01,829909,Brandt; Reuven A,0,0,0,0
1739706427115,PHIL 13,A02,829910,Brandt; Reuven A,21,0,25,4
1739706427115,PHIL 13,A03,829911,Brandt; Reuven A,0,0,0,0
1739706427115,PHIL 13,A04,829912,Brandt; Reuven A,25,0,25,0
1739706427115,PHIL 13,A05,829913,Brandt; Reuven A,23,0,25,2
1739706427115,PHIL 13,A06,829914,Brandt; Reuven A,24,0,25,1
1739706428143,PHIL 27,A01,829916,Harrell; Maralee Mae,20,0,25,5
1739706428143,PHIL 27,A02,829917,Harrell; Maralee Mae,21,0,25,4
1739706428143,PHIL 27,A03,829918,Harrell; Maralee Mae,17,0,25,8
1739706428143,PHIL 27,A04,829919,Harrell; Maralee Mae,23,0,25,2
1739706429170,PHIL 28,A01,829921,Lamey; Andy M.,24,0,25,1
1739706429170,PHIL 28,A02,829922,Lamey; Andy M.,24,0,25,1
1739706429170,PHIL 28,A03,829923,Lamey; Andy M.,15,0,25,10
1739706429170,PHIL 28,A04,829924,Lamey; Andy M.,24,0,25,1
1739706429170,PHIL 28,A05,829925,Lamey; Andy M.,23,0,25,2
1739706429170,PHIL 28,A06,829926,Lamey; Andy M.,24,0,25,1
1739706430199,PHIL 33,A01,829928,Tolley; Clinton,23,0,25,2
1739706430199,PHIL 33,A02,829929,Tolley; Clinton,24,0,25,1
1739706431227,PHIL 50,A00,829930,Yuan; Yuan,111,0,120,9
1739706432256,PHIL 60,A00,829989,Marechal; Patricia,33,0,33,0
1739706433282,PHIL 101,A00,829994,Marechal; Patricia,58,0,60,2
1739706434306,PHIL 102,A00,830057,Johnson; Monte,30,0,33,3
1739706435330,PHIL 108,A00,830058,Hardimon; Michael O.,31,0,33,2
1739706436354,PHIL 112,A00,830059,Hardimon; Michael O.,35,0,40,5
1739706437379,PHIL 120,A00,830060,Carr; Jennifer Rose,50,0,55,5
1739706438408,PHIL 125,A00,830063,Carr; Jennifer Rose,32,0,33,1
1739706439432,PHIL 131,A00,830065,Watkins; Eric,32,0,33,1
1739706440460,PHIL 134,A00,830066,Rudolph; Rachel Etta,31,0,33,2
1739706441486,PHIL 145,A00,830069,McKenzie; Kerry V.,54,0,60,6
1739706442511,PHIL 155,A00,830070,Tolley; Clinton,115,0,120,5
1739706443539,PHIL 160,A00,830071,Yuan; Yuan,32,0,33,1
1739706444565,PHIL 162,A00,830072,Lamey; Andy M.,41,0,42,1
1739706445591,PHIL 173,A00,830076,Brandt; Reuven A,108,0,120,12
1739706446618,PHIL 174,A01,830079,Danks; David J,27,0,27,0
1739706446618,PHIL 174,A02,830080,Danks; David J,27,0,27,0
1739706446618,PHIL 174,A03,830081,Danks; David J,27,0,27,0
1739706446618,PHIL 174,A04,830083,Danks; David J,27,0,27,0
1739706446618,PHIL 174,A05,830084,Danks; David J,26,0,27,1
1739706446618,PHIL 174,A06,830089,Danks; David J,27,0,27,0
1739706446618,PHIL 174,A07,830090,Danks; David J,27,0,27,0
1739706446618,PHIL 174,A08,830093,Danks; David J,27,0,27,0
1739706447643,PHIL 201A,A00,830095,Watkins; Eric,17,0,20,3
1739706448667,PHIL 202,A00,830097,Brink; David O.,16,0,20,4
1739706449694,PHIL 209B,A00,830098,Gere; Catherina M.,9,0,10,1
1739706450719,PHIL 209C,A00,830108,McKenzie; Kerry V.,10,0,10,0
1739706451745,PHIL 232,A00,830138,Sher; Gila,18,0,20,2
1739706452770,PHIL 234,A00,830139,Rudolph; Rachel Etta,18,0,20,2
1739706453794,PHIL 271,A00,830142,Vargas; Manuel Rogelio & Fulkerson; Matthew Todd,10,0,10,0
1739706454818,PHIL 275,A00,830179,Watkins; Eric,9,0,10,1
1739706455846,PHIL 277,A00,830185,Tolley; Clinton,9,0,10,1
1739706456871,PHIL 278,A00,830186,Fulkerson; Matthew Todd & Cohen; Jonathan David,10,0,10,0
1739706457895,PHIL 280,A00,830192,Kovaka; Karenc,10,0,10,0
1739706458919,PHIL 281,A00,830207,Tolley; Clinton,10,0,10,0
1739706459943,PHIL 283,A00,830214,Tolley; Clinton & Vargas; Manuel Rogelio,9,0,10,1
1739706460968,PHIL 284,A00,830244,Kovaka; Karenc,10,0,10,0
1739706461991,PHIL 285,A00,830255,Fulkerson; Matthew Todd & Cohen; Jonathan David,18,0,20,2
1739706463016,PHIL 286,A00,830259,Callender; Craig Adam & Chen; Keming,10,0,10,0
1739706464041,PHIL 287,A00,830262,Johnson; Monte,10,0,10,0
1739706465068,PHIL 290,001,828857,Nelkin; Dana Kay,9999,0,9999,0
1739706465068,PHIL 290,002,828858,Bazargan-Forward; Saba,9999,0,9999,0
1739706465068,PHIL 290,003,828861,Brandt; Reuven A,9999,0,9999,0
1739706465068,PHIL 290,004,828864,Brink; David O.,9999,0,9999,0
1739706465068,PHIL 290,005,828868,Callender; Craig Adam,9999,0,9999,0
1739706465068,PHIL 290,006,828869,Carr; Jennifer Rose,9999,0,9999,0
1739706465068,PHIL 290,007,828875,Cartwright; Nancy D.,9999,0,9999,0
1739706465068,PHIL 290,008,828878,Cohen; Jonathan David,9999,0,9999,0
1739706465068,PHIL 290,009,828880,Danks; David J,9999,0,9999,0
1739706465068,PHIL 290,010,828896,Fulkerson; Matthew Todd,9999,0,9999,0
1739706465068,PHIL 290,011,828897,Grush; Rick Scott,9999,0,9999,0
1739706465068,PHIL 290,012,828934,Hardimon; Michael O.,9999,0,9999,0
1739706465068,PHIL 290,013,828950,Harrell; Maralee Mae,9999,0,9999,0
1739706465068,PHIL 290,014,828951,Johnson; Monte,9999,0,9999,0
1739706465068,PHIL 290,015,828956,Kovaka; Karenc,9999,0,9999,0
1739706465068,PHIL 290,016,828959,Lamey; Andy M.,9999,0,9999,0
1739706465068,PHIL 290,017,828963,Marechal; Patricia,9999,0,9999,0
1739706465068,PHIL 290,018,828969,McKenzie; Kerry V.,9999,0,9999,0
1739706465068,PHIL 290,019,828970,Rickless; Samuel Charles,9999,0,9999,0
1739706465068,PHIL 290,020,828971,Sher; Gila,9999,0,9999,0
1739706465068,PHIL 290,021,828983,Shields; Christopher John,9999,0,9999,0
1739706465068,PHIL 290,022,829062,Tolley; Clinton,9999,0,9999,0
1739706465068,PHIL 290,023,829063,Vargas; Manuel Rogelio,9999,0,9999,0
1739706465068,PHIL 290,024,829065,Watkins; Eric,9999,0,9999,0
1739706465068,PHIL 290,025,829067,Chen; Keming,9999,0,9999,0
1739706465068,PHIL 290,026,829069,Yuan; Yuan,9999,0,9999,0
1739706465068,PHIL 290,027,829070,Kocurek; Alexander William,9999,0,9999,0
1739706465068,PHIL 290,028,829073,Rudolph; Rachel Etta,9999,0,9999,0
1739706466094,PHIL 295,001,829074,Bazargan-Forward; Saba,9999,0,9999,0
1739706466094,PHIL 295,002,829076,Brandt; Reuven A,9999,0,9999,0
1739706466094,PHIL 295,003,829080,Brink; David O.,9999,0,9999,0
1739706466094,PHIL 295,004,829081,Callender; Craig Adam,9999,0,9999,0
1739706466094,PHIL 295,005,829082,Carr; Jennifer Rose,9999,0,9999,0
1739706466094,PHIL 295,006,829135,Cartwright; Nancy D.,9999,0,9999,0
1739706466094,PHIL 295,007,829136,Chen; Keming,9999,0,9999,0
1739706466094,PHIL 295,008,829137,Cohen; Jonathan David,9999,0,9999,0
1739706466094,PHIL 295,009,829138,Danks; David J,9999,0,9999,0
1739706466094,PHIL 295,010,829139,Fulkerson; Matthew Todd,9999,0,9999,0
1739706466094,PHIL 295,011,829143,Grush; Rick Scott,9999,0,9999,0
1739706466094,PHIL 295,012,829144,Hardimon; Michael O.,9999,0,9999,0
1739706466094,PHIL 295,013,829145,Harrell; Maralee Mae,9999,0,9999,0
1739706466094,PHIL 295,014,829146,Johnson; Monte,9999,0,9999,0
1739706466094,PHIL 295,015,829147,Kovaka; Karenc,9999,0,9999,0
1739706466094,PHIL 295,016,829148,Lamey; Andy M.,9999,0,9999,0
1739706466094,PHIL 295,017,829149,Marechal; Patricia,9999,0,9999,0
1739706466094,PHIL 295,018,829150,McKenzie; Kerry V.,9999,0,9999,0
1739706466094,PHIL 295,019,829151,Nelkin; Dana Kay,9999,0,9999,0
1739706466094,PHIL 295,020,829152,Rickless; Samuel Charles,9999,0,9999,0
1739706466094,PHIL 295,021,829153,Sher; Gila,9999,0,9999,0
1739706466094,PHIL 295,022,829154,Shields; Christopher John,9999,0,9999,0
1739706466094,PHIL 295,023,829156,Tolley; Clinton,9999,0,9999,0
1739706466094,PHIL 295,024,829157,Vargas; Manuel Rogelio,9999,0,9999,0
1739706466094,PHIL 295,025,829158,Watkins; Eric,9999,0,9999,0
1739706466094,PHIL 295,026,829159,Kocurek; Alexander William,9999,0,9999,0
1739706466094,PHIL 295,027,829160,Rudolph; Rachel Etta,9999,0,9999,0
1739706466094,PHIL 295,028,829161,Yuan; Yuan,9999,0,9999,0
1739706467118,PHYS 1A,A00,830264,Tsai; Philbert S,350,0,360,10
1739706468144,PHYS 1AL,001,830274,Yagil; Avi & Tsai; Philbert S,25,0,30,5
1739706468144,PHYS 1AL,002,830320,Yagil; Avi & Tsai; Philbert S,28,0,30,2
1739706468144,PHYS 1AL,003,830324,Yagil; Avi & Tsai; Philbert S,29,0,30,1
1739706468144,PHYS 1AL,004,830352,Yagil; Avi & Tsai; Philbert S,30,0,30,0
1739706468144,PHYS 1AL,005,830364,Yagil; Avi & Tsai; Philbert S,27,0,30,3
1739706468144,PHYS 1AL,006,830365,Yagil; Avi & Tsai; Philbert S,25,0,30,5
1739706468144,PHYS 1AL,007,830366,Yagil; Avi & Tsai; Philbert S,30,0,30,0
1739706468144,PHYS 1AL,008,830378,Yagil; Avi & Tsai; Philbert S,29,0,30,1
1739706468144,PHYS 1AL,009,830485,Yagil; Avi & Tsai; Philbert S,29,0,30,1
1739706468144,PHYS 1AL,010,830486,Yagil; Avi & Tsai; Philbert S,30,0,30,0
1739706468144,PHYS 1AL,011,830496,Yagil; Avi & Tsai; Philbert S,30,0,30,0
1739706469170,PHYS 1B,A00,830497,Groisman; Alexander,344,0,360,16
1739706470202,PHYS 1BL,001,830498,Yagil; Avi & Tsai; Philbert S,29,0,30,1
1739706470202,PHYS 1BL,002,830499,Yagil; Avi & Tsai; Philbert S,29,0,30,1
1739706470202,PHYS 1BL,003,830500,Yagil; Avi & Tsai; Philbert S,29,0,30,1
1739706470202,PHYS 1BL,004,830501,Yagil; Avi & Tsai; Philbert S,28,0,30,2
1739706470202,PHYS 1BL,005,830502,Yagil; Avi & Tsai; Philbert S,29,0,30,1
1739706470202,PHYS 1BL,006,830503,Yagil; Avi & Tsai; Philbert S,28,0,30,2
1739706470202,PHYS 1BL,007,830504,Yagil; Avi & Tsai; Philbert S,26,0,30,4
1739706470202,PHYS 1BL,008,830505,Yagil; Avi & Tsai; Philbert S,29,0,30,1
1739706470202,PHYS 1BL,009,830507,Yagil; Avi & Tsai; Philbert S,29,0,30,1
1739706470202,PHYS 1BL,010,830508,Yagil; Avi & Tsai; Philbert S,26,0,30,4
1739706470202,PHYS 1BL,011,830509,Yagil; Avi & Tsai; Philbert S,29,0,30,1
1739706470202,PHYS 1BL,012,830510,Yagil; Avi & Tsai; Philbert S,29,0,30,1
1739706471227,PHYS 1C,A00,830511,Popmintchev; Tenio,591,0,600,9
1739706471227,PHYS 1C,B00,830512,Popmintchev; Tenio,562,0,600,38
1739706472257,PHYS 1CL,001,830513,Yagil; Avi & Tsai; Philbert S,29,0,30,1
1739706472257,PHYS 1CL,002,830514,Yagil; Avi & Tsai; Philbert S,30,0,30,0
1739706472257,PHYS 1CL,003,830515,Yagil; Avi & Tsai; Philbert S,24,0,30,6
1739706472257,PHYS 1CL,004,830516,Yagil; Avi & Tsai; Philbert S,26,0,30,4
1739706472257,PHYS 1CL,005,830517,Yagil; Avi & Tsai; Philbert S,24,0,30,6
1739706472257,PHYS 1CL,006,830518,Yagil; Avi & Tsai; Philbert S,30,0,30,0
1739706472257,PHYS 1CL,007,830519,Yagil; Avi & Tsai; Philbert S,26,0,30,4
1739706472257,PHYS 1CL,008,830520,Yagil; Avi & Tsai; Philbert S,25,0,30,5
1739706472257,PHYS 1CL,009,830521,Yagil; Avi & Tsai; Philbert S,28,0,30,2
1739706472257,PHYS 1CL,010,830522,Yagil; Avi & Tsai; Philbert S,29,0,30,1
1739706472257,PHYS 1CL,011,872498,Yagil; Avi & Tsai; Philbert S,30,0,30,0
1739706472257,PHYS 1CL,012,872499,Yagil; Avi & Tsai; Philbert S,30,0,30,0
1739706472257,PHYS 1CL,013,830584,Yagil; Avi & Tsai; Philbert S,18,0,30,12
1739706472257,PHYS 1CL,014,830586,Yagil; Avi & Tsai; Philbert S,27,0,30,3
1739706472257,PHYS 1CL,015,830588,Yagil; Avi & Tsai; Philbert S,26,0,30,4
1739706472257,PHYS 1CL,016,830591,Yagil; Avi & Tsai; Philbert S,24,0,30,6
1739706472257,PHYS 1CL,017,830592,Yagil; Avi & Tsai; Philbert S,29,0,30,1
1739706472257,PHYS 1CL,018,830598,Yagil; Avi & Tsai; Philbert S,27,0,30,3
1739706472257,PHYS 1CL,019,830604,Yagil; Avi & Tsai; Philbert S,29,0,30,1
1739706472257,PHYS 1CL,020,830605,Yagil; Avi & Tsai; Philbert S,28,0,30,2
1739706472257,PHYS 1CL,021,830607,Yagil; Avi & Tsai; Philbert S,27,0,30,3
1739706472257,PHYS 1CL,022,830609,Yagil; Avi & Tsai; Philbert S,28,0,30,2
1739706472257,PHYS 1CL,023,872500,Yagil; Avi & Tsai; Philbert S,28,0,30,2
1739706472257,PHYS 1CL,024,872501,Yagil; Avi & Tsai; Philbert S,30,0,30,0
1739706472257,PHYS 1CL,025,830613,Yagil; Avi & Tsai; Philbert S,29,0,30,1
1739706472257,PHYS 1CL,026,830617,Yagil; Avi & Tsai; Philbert S,30,0,30,0
1739706472257,PHYS 1CL,027,830658,Yagil; Avi & Tsai; Philbert S,30,0,30,0
1739706472257,PHYS 1CL,028,830661,Yagil; Avi & Tsai; Philbert S,29,0,30,1
1739706472257,PHYS 1CL,029,830669,Yagil; Avi & Tsai; Philbert S,25,0,30,5
1739706472257,PHYS 1CL,030,830676,Yagil; Avi & Tsai; Philbert S,30,0,30,0
1739706472257,PHYS 1CL,031,830679,Yagil; Avi & Tsai; Philbert S,24,0,30,6
1739706472257,PHYS 1CL,032,830680,Yagil; Avi & Tsai; Philbert S,28,0,30,2
1739706472257,PHYS 1CL,033,872502,Yagil; Avi & Tsai; Philbert S,30,0,30,0
1739706472257,PHYS 1CL,034,872503,Yagil; Avi & Tsai; Philbert S,27,0,30,3
1739706473292,PHYS 2A,A01,830828,Shotwell; Brian,19,0,30,11
1739706473292,PHYS 2A,A02,830829,Shotwell; Brian,29,0,30,1
1739706473292,PHYS 2A,A03,830830,Shotwell; Brian,30,0,30,0
1739706473292,PHYS 2A,A04,830831,Shotwell; Brian,30,0,30,0
1739706473292,PHYS 2A,A05,830832,Shotwell; Brian,28,0,30,2
1739706473292,PHYS 2A,A06,830849,Shotwell; Brian,27,0,30,3
1739706473292,PHYS 2A,A07,830887,Shotwell; Brian,28,0,30,2
1739706473292,PHYS 2A,A08,830888,Shotwell; Brian,30,0,30,0
1739706473292,PHYS 2A,A09,830889,Shotwell; Brian,30,0,30,0
1739706473292,PHYS 2A,A10,830890,Shotwell; Brian,30,0,30,0
1739706473292,PHYS 2A,A11,830934,Shotwell; Brian,0,0,0,0
1739706473292,PHYS 2A,A12,830938,Shotwell; Brian,0,0,0,0
1739706474318,PHYS 2B,A01,830950,Meyertholen; Andrew D.,29,0,30,1
1739706474318,PHYS 2B,A02,830982,Meyertholen; Andrew D.,30,0,30,0
1739706474318,PHYS 2B,A03,830983,Meyertholen; Andrew D.,30,0,30,0
1739706474318,PHYS 2B,A04,830984,Meyertholen; Andrew D.,30,0,30,0
1739706474318,PHYS 2B,A05,830985,Meyertholen; Andrew D.,25,0,30,5
1739706474318,PHYS 2B,A06,830986,Meyertholen; Andrew D.,30,0,30,0
1739706474318,PHYS 2B,A07,830987,Meyertholen; Andrew D.,28,0,30,2
1739706474318,PHYS 2B,A08,830988,Meyertholen; Andrew D.,29,0,30,1
1739706474318,PHYS 2B,A09,830989,Meyertholen; Andrew D.,30,0,30,0
1739706474318,PHYS 2B,A10,831009,Meyertholen; Andrew D.,29,0,30,1
1739706474318,PHYS 2B,A11,831010,Meyertholen; Andrew D.,24,0,30,6
1739706474318,PHYS 2B,A12,831018,Meyertholen; Andrew D.,30,0,30,0
1739706474318,PHYS 2B,B01,831020,Meyertholen; Andrew D.,21,0,30,9
1739706474318,PHYS 2B,B02,831021,Meyertholen; Andrew D.,30,0,30,0
1739706474318,PHYS 2B,B03,831022,Meyertholen; Andrew D.,29,0,30,1
1739706474318,PHYS 2B,B04,831036,Meyertholen; Andrew D.,28,0,30,2
1739706474318,PHYS 2B,B05,831037,Meyertholen; Andrew D.,29,0,30,1
1739706474318,PHYS 2B,B06,831043,Meyertholen; Andrew D.,30,0,30,0
1739706474318,PHYS 2B,B07,831046,Meyertholen; Andrew D.,30,0,30,0
1739706474318,PHYS 2B,B08,831047,Meyertholen; Andrew D.,30,0,30,0
1739706474318,PHYS 2B,B09,831061,Meyertholen; Andrew D.,29,0,30,1
1739706474318,PHYS 2B,B10,831062,Meyertholen; Andrew D.,29,0,30,1
1739706474318,PHYS 2B,B11,831069,Meyertholen; Andrew D.,30,0,30,0
1739706474318,PHYS 2B,B12,831070,Meyertholen; Andrew D.,30,0,30,0
1739706475349,PHYS 2BL,A01,831108,Sharma; Vivek A.,24,0,24,0
1739706475349,PHYS 2BL,A02,831109,Sharma; Vivek A.,12,0,24,12
1739706475349,PHYS 2BL,A03,831112,Sharma; Vivek A.,22,0,24,2
1739706475349,PHYS 2BL,A04,831113,Sharma; Vivek A.,21,0,24,3
1739706475349,PHYS 2BL,A05,831127,Sharma; Vivek A.,24,0,24,0
1739706475349,PHYS 2BL,A06,831150,Sharma; Vivek A.,17,0,24,7
1739706475349,PHYS 2BL,A07,831327,Sharma; Vivek A.,21,0,24,3
1739706475349,PHYS 2BL,A08,831329,Sharma; Vivek A.,23,0,24,1
1739706475349,PHYS 2BL,A09,831338,Sharma; Vivek A.,24,0,24,0
1739706475349,PHYS 2BL,A10,831345,Sharma; Vivek A.,23,0,24,1
1739706475349,PHYS 2BL,A11,831355,Sharma; Vivek A.,21,0,24,3
1739706475349,PHYS 2BL,A12,831357,Sharma; Vivek A.,24,0,24,0
1739706475349,PHYS 2BL,A13,831428,Sharma; Vivek A.,24,0,24,0
1739706475349,PHYS 2BL,A14,831433,Sharma; Vivek A.,21,0,24,3
1739706475349,PHYS 2BL,A15,831434,Sharma; Vivek A.,21,0,24,3
1739706476376,PHYS 2C,A01,831436,Shotwell; Brian,29,0,30,1
1739706476376,PHYS 2C,A02,831440,Shotwell; Brian,30,0,30,0
1739706476376,PHYS 2C,A03,831441,Shotwell; Brian,27,0,30,3
1739706476376,PHYS 2C,A04,831444,Shotwell; Brian,29,0,30,1
1739706476376,PHYS 2C,A05,831445,Shotwell; Brian,27,0,30,3
1739706476376,PHYS 2C,A06,831446,Shotwell; Brian,30,0,30,0
1739706476376,PHYS 2C,A07,831453,Shotwell; Brian,28,0,30,2
1739706476376,PHYS 2C,A08,831454,Shotwell; Brian,29,0,30,1
1739706476376,PHYS 2C,A09,831469,Shotwell; Brian,25,0,30,5
1739706476376,PHYS 2C,A10,831470,Shotwell; Brian,27,0,30,3
1739706476376,PHYS 2C,A11,831471,Shotwell; Brian,30,0,30,0
1739706476376,PHYS 2C,A12,831481,Shotwell; Brian,27,0,30,3
1739706477402,PHYS 2CL,A01,831597,Ni; Kaixuan,25,0,28,3
1739706477402,PHYS 2CL,A02,831598,Ni; Kaixuan,23,0,28,5
1739706477402,PHYS 2CL,A03,831599,Ni; Kaixuan,27,0,28,1
1739706477402,PHYS 2CL,A04,831601,Ni; Kaixuan,26,0,28,2
1739706477402,PHYS 2CL,A05,831602,Ni; Kaixuan,26,0,28,2
1739706477402,PHYS 2CL,A06,831603,Ni; Kaixuan,26,0,28,2
1739706478428,PHYS 2D,A01,831605,Branson; James G,26,0,30,4
1739706478428,PHYS 2D,A02,831606,Branson; James G,30,0,30,0
1739706478428,PHYS 2D,A03,831607,Branson; James G,30,0,30,0
1739706479453,PHYS 4B,A01,831609,Grinstein; Benjamin,30,0,30,0
1739706479453,PHYS 4B,A02,831610,Grinstein; Benjamin,29,0,30,1
1739706479453,PHYS 4B,A03,831611,Grinstein; Benjamin,29,0,30,1
1739706479453,PHYS 4B,A04,831612,Grinstein; Benjamin,28,0,30,2
1739706480478,PHYS 4E,A01,831622,Intriligator; Kenneth Arthur,39,0,40,1
1739706480478,PHYS 4E,A02,831630,Intriligator; Kenneth Arthur,40,0,40,0
1739706480478,PHYS 4E,A03,831631,Intriligator; Kenneth Arthur,39,0,40,1
1739706481502,PHYS 87,A00,869095,Grinstein; Benjamin,20,0,20,0
1739706482529,PHYS 100C,A01,831698,Barreiro Guerrero; Julio,57,0,60,3
1739706483554,PHYS 105B,A01,831700,Green; Daniel Richard,24,0,24,0
1739706484578,PHYS 120,A01,831702,Yang; Liang,30,0,32,2
1739706484578,PHYS 120,A02,831916,Yang; Liang,30,0,32,2
1739706485608,PHYS 130A,A01,831918,You; Yizhuang,90,0,90,0
1739706486636,PHYS 130B,A01,831921,You; Yizhuang,49,0,50,1
1739706487661,PHYS 137,A01,831924,Intriligator; Kenneth Arthur,33,0,36,3
1739706488686,PHYS 140A,A01,831928,Frano Pereira; Alex M,44,0,50,6
1739706489710,PHYS 141,A00,831929,Zhao; Hongbo,57,0,60,3
1739706490739,PHYS 152B,A01,831932,Hirsch; Jorge Eduardo,17,0,20,3
1739706491766,PHYS 154,A01,872509,Grinstein; Benjamin,20,0,23,3
1739706492791,PHYS 162,A01,831935,Keating; Brian,43,0,46,3
1739706493818,PHYS 170,A01,831938,Oh; Seungeun,23,0,25,2
1739706494844,PHYS 177,A00,831940,Dudko; Olga,18,0,20,2
1739706495871,PHYS 202,A00,831941,Vergassola; Massimo & Diamond; Patrick H,19,0,20,1
1739706496902,PHYS 203B,A01,831943,Fogler; Michael M.,17,0,20,3
1739706497930,PHYS 210A,A01,831946,Arovas; Daniel P,19,0,20,1
1739706498957,PHYS 212C,A01,831948,Grover; Tarun,18,0,20,2
1739706499986,PHYS 215C,A00,831949,McGreevy; John A.,10,0,10,0
1739706501012,PHYS 221A,A00,831953,Tan; Tzer Han,20,0,20,0
1739706502038,PHYS 222A,A00,831954,Ni; Kaixuan,10,0,10,0
1739706503063,PHYS 227,A00,831958,Fuller; George Michael,22,0,25,3
1739706504091,PHYS 228,A00,831961,Flauger; Raphael M,24,0,25,1
1739706505115,PHYS 232,A00,831962,Hirsch; Jorge Eduardo,5,0,5,0
1739706506139,PHYS 239,A00,831963,Goldenfeld; Nigel,7,0,10,3
1739706506139,PHYS 239,B00,831964,Serra; Mattia,8,0,10,2
1739706507164,PHYS 241,A00,831965,Zhao; Hongbo,4,0,5,1
1739706508194,PHYS 250,A00,831969,Di Ventra; Massimiliano,50,0,50,0
1739706509219,PHYS 251,A00,831970,Grinstein; Benjamin,20,0,20,0
1739706510246,PHYS 252,A00,831971,Diamond; Patrick H,10,0,10,0
1739706511270,PHYS 253,A00,831972,Fuller; George Michael,30,0,30,0
1739706512295,PHYS 254,A00,831973,Serra; Mattia,29,0,30,1
1739706513322,PHYS 255,A00,831974,Hwa; Terence T.,30,0,30,0
1739706514347,PHYS 260,A00,831975,Fuller; George Michael,50,0,50,0
1739706515371,PHYS 277,A00,831976,Dudko; Olga,14,0,20,6
1739706516403,POLI 5D,A01,832046,Arnold; David Hall,7,0,8,1
1739706516403,POLI 5D,A02,832047,Arnold; David Hall,8,0,8,0
1739706516403,POLI 5D,A03,832049,Arnold; David Hall,8,0,8,0
1739706516403,POLI 5D,A04,832050,Arnold; David Hall,7,0,8,1
1739706516403,POLI 5D,A05,832051,Arnold; David Hall,8,0,8,0
1739706516403,POLI 5D,B01,832055,Dai; Yinlin,5,0,5,0
1739706516403,POLI 5D,B02,832056,Dai; Yinlin,4,0,5,1
1739706517432,POLI 10D,A01,832058,Noble; Benjamin S,33,0,34,1
1739706517432,POLI 10D,A02,832059,Noble; Benjamin S,33,0,34,1
1739706517432,POLI 10D,A03,832060,Noble; Benjamin S,34,0,34,0
1739706517432,POLI 10D,A04,832061,Noble; Benjamin S,33,0,34,1
1739706517432,POLI 10D,A05,832062,Noble; Benjamin S,33,0,34,1
1739706517432,POLI 10D,A06,832064,Noble; Benjamin S,34,0,34,0
1739706518460,POLI 12D,A01,832067,Thai; Eric,30,0,34,4
1739706518460,POLI 12D,A02,832068,Thai; Eric,32,0,34,2
1739706518460,POLI 12D,A03,832069,Thai; Eric,34,0,34,0
1739706518460,POLI 12D,A04,832070,Thai; Eric,34,0,34,0
1739706518460,POLI 12D,A05,832072,Thai; Eric,33,0,34,1
1739706518460,POLI 12D,A06,832074,Thai; Eric,34,0,34,0
1739706519485,POLI 27,A01,832079,Elgin; Samuel Zincke,27,0,34,7
1739706519485,POLI 27,A02,832081,Elgin; Samuel Zincke,31,0,34,3
1739706519485,POLI 27,A03,832082,Elgin; Samuel Zincke,34,0,34,0
1739706519485,POLI 27,A04,832083,Elgin; Samuel Zincke,32,0,34,2
1739706520511,POLI 28,A01,832085,Elgin; Samuel Zincke,29,0,34,5
1739706520511,POLI 28,A02,832087,Elgin; Samuel Zincke,30,0,34,4
1739706520511,POLI 28,A03,832092,Elgin; Samuel Zincke,32,0,34,2
1739706520511,POLI 28,A04,832093,Elgin; Samuel Zincke,33,0,34,1
1739706521538,POLI 30D,A01,832096,Anderson; Anthony Michael,19,0,28,9
1739706521538,POLI 30D,A02,832098,Anderson; Anthony Michael,23,0,28,5
1739706521538,POLI 30D,A03,832100,Anderson; Anthony Michael,27,0,28,1
1739706521538,POLI 30D,A04,832102,Anderson; Anthony Michael,27,0,28,1
1739706521538,POLI 30D,A05,832103,Anderson; Anthony Michael,20,0,28,8
1739706521538,POLI 30D,A06,832252,Anderson; Anthony Michael,28,0,28,0
1739706522563,POLI 87,A00,881663,Mignozzetti; Umberto,20,0,20,0
1739706523591,POLI 100O,A00,832254,Boehmer; Alison Paige,106,0,115,9
1739706524615,POLI 104Q,A00,832257,Nichter; Maysa,100,0,120,20
1739706525643,POLI 104U,A00,869584,Nichter; Maysa,55,0,75,20
1739706526723,POLI 104V,A00,832258,Staff,43,0,50,7
1739706527748,POLI 110C,A00,832259,Soon; Valerie,49,0,50,1
1739706528779,POLI 119A,A00,832260,Staff,45,0,50,5
1739706529807,POLI 120D,A00,832261,Hansen; Jan Eric,45,0,50,5
1739706530831,POLI 121D,A00,832262,Roberts; Margaret Earling,113,0,115,2
1739706531855,POLI 126AB,A00,832263,Fisk; David Lee,154,0,156,2
1739706532881,POLI 131CR,A00,832264,Hoston; Germaine,131,0,135,4
1739706532881,POLI 131CR,B00,877489,Hoston; Germaine,30,0,30,0
1739706533905,POLI 140D,A00,832265,Wong; Tak Kei,191,0,200,9
1739706534933,POLI 145C,A00,832267,Fisk; David Lee,191,0,196,5
1739706535961,POLI 149,A00,832268,Joseph; Michael F,192,0,196,4
1739706536987,POLI 150A,A00,832269,Wong; Tak Kei,235,0,245,10
1739706538012,POLI 170,A00,872371,Staff,110,0,115,5
1739706539037,POLI 176,A00,832337,Roberts; Margaret Earling,73,0,80,7
1739706540062,POLI 194,A00,832339,Staff,9999,0,9999,0
1739706541087,POLI 194SD,A00,832431,Nichter; Maysa,25,0,25,0
1739706542115,POLI 197SD,001,832432,Nichter; Maysa,25,0,25,0
1739706543143,POLI 198RA,001,832499,Broz; James Lawrence,25,0,25,0
1739706544167,POLI 203B,A00,832500,Slantchev; Branislav,23,0,25,2
1739706545194,POLI 218R,A00,832535,Hoston; Germaine,24,0,25,1
1739706546221,POLI 219,A00,832536,Soon; Valerie,10,0,10,0
1739706547246,POLI 220A,A00,832537,Ferree; Karen E,21,0,25,4
1739706548273,POLI 243,A00,832538,Joseph; Michael F,24,0,25,1
1739706549296,POLI 250,A00,832539,Stout; Christopher Timothy,22,0,25,3
1739706551349,POLI 273,A00,832541,Mignozzetti; Umberto,8,0,25,17
1739706552374,POLI 281,A00,832542,Ban; Pamela M,11,0,12,1
1739706553401,POLI 282,A00,832543,Ferree; Karen E,24,0,25,1
1739706554428,POLI 283,A00,832544,Slantchev; Branislav,23,0,25,2
1739706555453,POLI 285,A00,832545,Ingham; Sean,12,0,12,0
1739706556478,POLI 286,A00,832546,Mignozzetti; Umberto,25,0,25,0
1739706557505,PSY 296,001,867611,Eyler; Lisa T.,4,0,5,1
1739706557505,PSY 296,002,867612,Fettes; Danielle Lynn,4,0,5,1
1739706557505,PSY 296,003,867613,Staff,5,0,5,0
1739706558531,PSYC 1,A00,841780,Hurwitz; Ethan Scott,292,0,300,8
1739706559557,PSYC 3R,A00,841782,Pilegard; Celeste Cristine,297,0,310,13
1739706560583,PSYC 60,A01,862444,Lowe; Angela Beth,34,0,35,1
1739706560583,PSYC 60,A02,862476,Lowe; Angela Beth,33,0,35,2
1739706560583,PSYC 60,A03,862477,Lowe; Angela Beth,34,0,35,1
1739706560583,PSYC 60,A04,862499,Lowe; Angela Beth,32,0,35,3
1739706560583,PSYC 60,A05,862516,Lowe; Angela Beth,35,0,35,0
1739706560583,PSYC 60,A06,862578,Lowe; Angela Beth,34,0,35,1
1739706560583,PSYC 60,A07,862603,Lowe; Angela Beth,34,0,35,1
1739706560583,PSYC 60,B01,862605,Rose; Fred E.,32,0,35,3
1739706560583,PSYC 60,B02,862622,Rose; Fred E.,34,0,35,1
1739706560583,PSYC 60,B03,862658,Rose; Fred E.,33,0,35,2
1739706560583,PSYC 60,B04,862659,Rose; Fred E.,32,0,35,3
1739706560583,PSYC 60,B05,862669,Rose; Fred E.,35,0,35,0
1739706560583,PSYC 60,B06,862680,Rose; Fred E.,33,0,35,2
1739706560583,PSYC 60,B07,862682,Rose; Fred E.,34,0,35,1
1739706561611,PSYC 70,A01,862683,Pilegard; Celeste Cristine,29,0,35,6
1739706561611,PSYC 70,A02,862684,Pilegard; Celeste Cristine,33,0,35,2
1739706561611,PSYC 70,A03,862688,Pilegard; Celeste Cristine,35,0,35,0
1739706561611,PSYC 70,A04,862697,Pilegard; Celeste Cristine,35,0,35,0
1739706561611,PSYC 70,A05,862698,Pilegard; Celeste Cristine,35,0,35,0
1739706561611,PSYC 70,A06,862738,Pilegard; Celeste Cristine,35,0,35,0
1739706562639,PSYC 71,A01,841792,Geller; Emma Harlan,21,0,25,4
1739706562639,PSYC 71,A02,841793,Geller; Emma Harlan,25,0,26,1
1739706562639,PSYC 71,B01,841795,Steiner; Eric Tomas,16,0,21,5
1739706562639,PSYC 71,B02,841797,Steiner; Eric Tomas,20,0,21,1
1739706563664,PSYC 88,A00,841802,Dobkins; Karen R.,52,0,65,13
1739706564693,PSYC 100,A00,841803,Chapman; Eddie Nathaniel,299,0,348,49
1739706565718,PSYC 101,A00,841804,Schachner; Adena,264,0,295,31
1739706566745,PSYC 102,A00,841807,Moranton; Nirelia Melbina-,294,0,295,1
1739706567770,PSYC 104,A00,841810,McCullough; Michael E,193,0,265,72
1739706568795,PSYC 105,A00,841812,Lau; Aubrey,294,0,295,1
1739706569819,PSYC 108,A00,841813,Adrian; Julia Anna,291,0,295,4
1739706570847,PSYC 111B,A01,841865,Geller; Emma Harlan,35,0,35,0
1739706571873,PSYC 116C,A01,841922,Lang; Ariel,25,0,25,0
1739706572898,PSYC 117,A01,872925,Bajic; Daniel Andrew,25,0,25,0
1739706573926,PSYC 118,A01,841931,Miller; Cory T.,39,0,45,6
1739706574954,PSYC 124,A00,841932,Chapman; Eddie Nathaniel,336,0,348,12
1739706575978,PSYC 125,A00,841933,Rose; Fred E.,140,0,146,6
1739706577001,PSYC 127,A00,841934,Dickenson; Janna Alene,17,0,20,3
1739706578028,PSYC 131,A00,841936,Anagnostaras; Stephan,47,0,65,18
1739706579054,PSYC 132,A00,841937,Steiner; Eric Tomas,90,0,120,30
1739706580079,PSYC 137,A00,841939,Winkielman; Piotr,212,0,216,4
1739706581104,PSYC 144,A00,841941,Wixted; John T,293,0,295,2
1739706582128,PSYC 164,A00,841943,Kaplan; Paul,276,0,295,19
1739706583163,PSYC 169,A00,841944,Tallman; Catherine Walsh,271,0,295,24
1739706584188,PSYC 178,A00,841945,Glaser; Dale,132,0,146,14
1739706585214,PSYC 179,A00,841980,Lacefield; Katharine I,290,0,350,60
1739706586240,PSYC 188,A00,842062,Lacefield; Katharine I,233,0,300,67
1739706587265,PSYC 190,A00,842063,Barner; David A.,273,0,300,27
1739706588289,PSYC 193,A00,842067,Brashier; Nadia Marie,214,0,216,2
1739706588289,PSYC 193,B00,842068,Gremel; Christina M,33,0,35,2
1739706588289,PSYC 193,C00,842095,Harris; Christine Renee,20,0,20,0
1739706588289,PSYC 193,D00,842096,Lin; Chujun,59,0,60,1
1739706588289,PSYC 193,E00,842154,Long; Bria,24,0,25,1
1739706588289,PSYC 193,F00,872477,Mukku; Dhananjaya,35,0,35,0
1739706589319,PSYC 193L,A01,842159,Aron; Adam,18,0,21,3
1739706589319,PSYC 193L,B01,842163,Barner; David A.,22,0,24,2
1739706589319,PSYC 193L,C01,842167,Brown; Sandra A,65,0,65,0
1739706590345,PSYC 194C,A01,842196,Heyman; Gail D.,1,0,1,0
1739706591372,PSYC 210,A00,842202,Powell; Lindsey Jane,17,0,20,3
1739706592405,PSYC 222,A00,842339,Gorman; Michael R.,20,0,20,0
1739706593428,PSYC 224,A00,842402,Miller; Cory T.,29,0,30,1
1739706594451,PSYC 242,A00,842579,Walker; Caren Michelle,28,0,30,2
1739706595475,PSYC 270C,A00,842580,Dobkins; Karen R.,19,0,20,1
1739706596502,PSYC 271,A00,842581,Anagnostaras; Stephan,19,0,20,1
1739706597532,PSYC 272,A00,842582,Gentner; Tim,18,0,20,2
1739706597532,PSYC 272,B00,872469,Mukku; Dhananjaya,20,0,20,0
1739706598556,PSYC 274,A00,842583,McCullough; Michael E,30,0,30,0
1739706599581,PSYC 275,A00,842600,Brady; Timothy Francis,29,0,30,1
1739706600608,PSYC 276,A00,842601,McCullough; Michael E,15,0,20,5
1739706601633,PSYC 280,A00,842760,Serences; John Thomas,76,0,80,4
1739706602671,PSYC 296,001,851620,Anagnostaras; Stephan,9999,0,9999,0
1739706602671,PSYC 296,002,851621,Aron; Adam,9999,0,9999,0
1739706602671,PSYC 296,003,851622,Mukku; Dhananjaya,9999,0,9999,0
1739706602671,PSYC 296,004,851623,Barner; David A.,9998,0,9999,1
1739706602671,PSYC 296,005,851624,Schachner; Adena,9999,0,9999,0
1739706602671,PSYC 296,006,851625,Brady; Timothy Francis,9999,0,9999,0
1739706602671,PSYC 296,007,851627,Brashier; Nadia Marie,9999,0,9999,0
1739706602671,PSYC 296,008,851628,Brown; Sandra A,9999,0,9999,0
1739706602671,PSYC 296,009,851629,Carver; Leslie J.,9999,0,9999,0
1739706602671,PSYC 296,010,851630,Chapman; Eddie Nathaniel,9999,0,9999,0
1739706602671,PSYC 296,011,851631,Dickenson; Janna Alene,9999,0,9999,0
1739706602671,PSYC 296,012,851632,Dobkins; Karen R.,9999,0,9999,0
1739706602671,PSYC 296,014,851635,Ferreira; Victor,9999,0,9999,0
1739706602671,PSYC 296,015,851636,Geller; Emma Harlan,9999,0,9999,0
1739706602671,PSYC 296,016,851637,Gentner; Tim,9998,0,9999,1
1739706602671,PSYC 296,017,851642,Gorman; Michael R.,9999,0,9999,0
1739706602671,PSYC 296,018,851644,Gremel; Christina M,9999,0,9999,0
1739706602671,PSYC 296,019,851645,Harris; Christine Renee,9999,0,9999,0
1739706602671,PSYC 296,020,851646,Heyman; Gail D.,9999,0,9999,0
1739706602671,PSYC 296,021,851647,Lin; Chujun,9999,0,9999,0
1739706602671,PSYC 296,022,851648,Long; Bria,9999,0,9999,0
1739706602671,PSYC 296,023,851650,McCullough; Michael E,9999,0,9999,0
1739706602671,PSYC 296,024,851655,Mc Kenzie; Craig R.M.,9999,0,9999,0
1739706602671,PSYC 296,025,851656,Miller; Cory T.,9999,0,9999,0
1739706602671,PSYC 296,026,851657,Oesch; Nicholas W,9999,0,9999,0
1739706602671,PSYC 296,028,851662,Pilegard; Celeste Cristine,9999,0,9999,0
1739706602671,PSYC 296,029,851664,Powell; Lindsey Jane,9999,0,9999,0
1739706602671,PSYC 296,030,851665,Rickard; Timothy C.,9999,0,9999,0
1739706602671,PSYC 296,031,851672,Serences; John Thomas,9999,0,9999,0
1739706602671,PSYC 296,032,851774,Walker; Caren Michelle,9999,0,9999,0
1739706602671,PSYC 296,033,851778,Winkielman; Piotr,9999,0,9999,0
1739706602671,PSYC 296,034,851808,Wixted; John T,9999,0,9999,0
1739706603698,RAD 296,001,867654,Staff,5,0,5,0
1739706603698,RAD 296,002,867659,Staff,5,0,5,0
1739706603698,RAD 296,003,867666,Staff,5,0,5,0
1739706604724,RELI 150,A00,832548,Rahimi; Babak,37,0,40,3
1739706605752,RELI 189,A00,832549,Rahimi; Babak,40,0,40,0
1739706606776,REV 12,A00,869164,Yu; Paul K L,40,0,40,0
1739706607803,REV 20,A00,869165,Yu; Paul K L,40,0,40,0
1739706608828,REV 87,A00,869166,Rodriguez; Bretton Sigfred,19,0,20,1
1739706609854,RMAS 296,001,867895,Murphy; James D,5,0,5,0
1739706609854,RMAS 296,002,867896,Staff,5,0,5,0
1739706609854,RMAS 296,003,867897,Staff,5,0,5,0
1739706610879,RMED 296,001,867854,Duleba; Antoni,4,0,5,1
1739706610879,RMED 296,002,867860,Staff,5,0,5,0
1739706610879,RMED 296,003,867882,Staff,5,0,5,0
1739706611903,SE 3,A01,838151,Van Den Einde; Yael Dahlia,42,0,52,10
1739706611903,SE 3,A02,838152,Van Den Einde; Yael Dahlia,50,0,52,2
1739706611903,SE 3,A03,838153,Van Den Einde; Yael Dahlia,50,0,53,3
1739706611903,SE 3,A04,838154,Van Den Einde; Yael Dahlia,51,0,53,2
1739706611903,SE 3,A05,838155,Van Den Einde; Yael Dahlia,49,0,50,1
1739706612927,SE 101B,A01,838160,Van Den Einde; Yael Dahlia,53,0,56,3
1739706613954,SE 105,A01,838162,Qiao; Yu,85,0,88,3
1739706614977,SE 110A,A01,838164,Staff,53,0,56,3
1739706616006,SE 110B,A00,838166,Zhu; Qiang,123,0,125,2
1739706617032,SE 130B,A01,838174,Krysl; Petr,93,0,100,7
1739706618056,SE 131A,A01,838499,Krysl; Petr,103,0,110,7
1739706619083,SE 140B,A01,838504,Palermo; Alessandro,22,0,24,2
1739706619083,SE 140B,A02,838505,Palermo; Alessandro,21,0,24,3
1739706619083,SE 140B,A03,838507,Palermo; Alessandro,23,0,24,1
1739706619083,SE 140B,A04,871139,Palermo; Alessandro,13,0,24,11
1739706619083,SE 140B,A05,871140,Palermo; Alessandro,0,0,24,24
1739706619083,SE 140B,A06,871141,Palermo; Alessandro,23,0,24,1
1739706620108,SE 143B,A01,838512,Kosmatka; John B,4,0,15,11
1739706620108,SE 143B,A02,838513,Kosmatka; John B,9,0,15,6
1739706621131,SE 150A,A01,838526,Uang; Chia-Ming,94,0,100,6
1739706622156,SE 150B,A01,838538,Morrison; Machel Leigh,36,0,50,14
1739706623183,SE 151B,A00,838540,Tsampras; Georgios,62,0,75,13
1739706624216,SE 160B,A01,838543,Kim; Hyunsun Alicia,96,0,100,4
1739706625240,SE 165,A00,838544,Todd; Michael,0,0,10,10
1739706626264,SE 183,A00,872450,Tomac; Ingrid,0,0,0,3
1739706627290,SE 202,A00,838832,Kosmatka; John B,28,0,30,2
1739706628317,SE 203B,A00,838855,Tsampras; Georgios,49,0,65,16
1739706629341,SE 213,A00,838859,Palermo; Alessandro,21,0,30,9
1739706630421,SE 214,A00,870032,Shing; P. Benson,19,0,40,21
1739706631449,SE 215,A00,838876,Zhu; Qiang,34,0,45,11
1739706632474,SE 224,A00,838921,Conte; Joel P,36,0,50,14
1739706633501,SE 246,A00,838926,McCartney; John Scott,25,0,30,5
1739706634529,SE 249,A01,839605,Tomac; Ingrid,15,0,20,5
1739706635558,SE 251B,A00,838934,Qiao; Yu,17,0,25,8
1739706636583,SE 253B,A00,838942,Kim; Hyonny,30,0,30,0
1739706637610,SE 260B,A00,838947,Kim; Hyunsun Alicia,10,0,10,0
1739706638635,SE 265,A00,838954,Todd; Michael,10,0,20,10
1739706639660,SE 279,A00,838959,Chen; Jiun-Shyan,24,0,30,6
1739706640688,SE 290,A00,838962,Loh; Kenneth J. H.,74,0,100,26
1739706641727,SE 296,001,838963,Asaro; Robert J,9999,0,9999,0
1739706641727,SE 296,002,838980,Chen; Jiun-Shyan,9999,0,9999,0
1739706641727,SE 296,003,838992,Conte; Joel P,9999,0,9999,0
1739706641727,SE 296,004,839039,Elgamal; Ahmed,9999,0,9999,0
1739706641727,SE 296,005,839040,Hutchinson; Tara,9999,0,9999,0
1739706641727,SE 296,006,839041,Jandaghi Semnani; Shabnam,9999,0,9999,0
1739706641727,SE 296,007,839042,Kim; Hyonny,9999,0,9999,0
1739706641727,SE 296,008,839055,Kim; Hyunsun Alicia,9999,0,9999,0
1739706641727,SE 296,009,839059,Kosmatka; John B,9999,0,9999,0
1739706641727,SE 296,010,839087,Krysl; Petr,9999,0,9999,0
1739706641727,SE 296,011,839094,Kuester; Falko,9999,0,9999,0
1739706641727,SE 296,012,839115,Lanza Di Scalea; Francesco,9999,0,9999,0
1739706641727,SE 296,013,839173,Loh; Kenneth J. H.,9999,0,9999,0
1739706641727,SE 296,014,839174,McCartney; John Scott,9999,0,9999,0
1739706641727,SE 296,015,839198,Morrison; Machel Leigh,9999,0,9999,0
1739706641727,SE 296,016,839229,Mosqueda; Gilberto,9999,0,9999,0
1739706641727,SE 296,017,839230,Qiao; Yu,9999,0,9999,0
1739706641727,SE 296,018,839234,Restrepo; Jose,9999,0,9999,0
1739706641727,SE 296,019,839243,Shing; P. Benson,9999,0,9999,0
1739706641727,SE 296,020,839323,Todd; Michael,9999,0,9999,0
1739706641727,SE 296,021,839326,Tomac; Ingrid,9999,0,9999,0
1739706641727,SE 296,022,839327,Tsampras; Georgios,9999,0,9999,0
1739706641727,SE 296,023,839329,Uang; Chia-Ming,9999,0,9999,0
1739706641727,SE 296,024,839340,Van Den Einde; Yael Dahlia,9999,0,9999,0
1739706641727,SE 296,025,839342,Zhu; Qiang,9999,0,9999,0
1739706641727,SE 296,026,839351,Tehrani; Mehran,9999,0,9999,0
1739706641727,SE 296,027,839356,Palermo; Alessandro,9999,0,9999,0
1739706642754,SEV 20,A00,838033,Antonovics; Kate L.,30,0,30,0
1739706643781,SIO 10,A00,839607,Borsa; Adrian Antal,591,0,600,9
1739706644809,SIO 16,A00,839615,Stegman; David,146,0,150,4
1739706645834,SIO 35,A00,839616,Driscoll; Neal W.,189,0,210,21
1739706646861,SIO 50,A01,839691,Cook; Geoffrey W,20,0,22,2
1739706646861,SIO 50,A02,839692,Cook; Geoffrey W,20,0,22,2
1739706647886,SIO 60,A01,839695,Ricke; Katharine L & Lucas; Andrew J.,29,0,34,5
1739706648911,SIO 75,A00,839696,Norris; Richard D.,28,0,30,2
1739706649937,SIO 87,A00,839697,Cook; Geoffrey W,20,0,20,0
1739706649937,SIO 87,B00,839698,Cook; Geoffrey W,20,0,20,0
1739706649937,SIO 87,C00,872480,Feddersen; Falk & Morzfeld; Matthias,15,0,15,0
1739706649937,SIO 87,D00,876215,Jensen; Paul R.,19,0,20,1
1739706650964,SIO 90,A00,839699,Shipp; Lauren Elizabeth,60,0,65,5
1739706651989,SIO 111,A01,839895,Feddersen; Falk,27,0,30,3
1739706653019,SIO 112,A01,839701,Morzfeld; Matthias,38,0,40,2
1739706654045,SIO 113,A01,839703,May; David Alexander,33,0,40,7
1739706655073,SIO 115,A01,872479,Fricker; Helen A.,61,0,65,4
1739706656100,SIO 121,A00,839704,Bowman; Jeff Shovlowsky,25,0,30,5
1739706657125,SIO 135,A01,839706,Fricker; Helen A. & Sandwell; David T,20,0,20,0
1739706657125,SIO 135,A02,872452,Fricker; Helen A. & Sandwell; David T,20,0,20,0
1739706658151,SIO 136,A01,839708,Kacev; David & Shipp; Lauren Elizabeth,29,0,34,5
1739706658151,SIO 136,A02,839709,Kacev; David & Shipp; Lauren Elizabeth,32,0,34,2
1739706659175,SIO 139,A00,839713,Kacev; David,89,0,95,6
1739706660203,SIO 141,A01,839715,Pomeroy; Robert S.,14,0,14,0
1739706661232,SIO 143,A01,839717,Andersson; Andreas Jerry,30,0,35,5
1739706662257,SIO 145,A01,872421,Choy; Carolyn Anela,9,0,18,9
1739706663284,SIO 152,A01,839719,Van Allen; Emily Joyce,17,0,20,3
1739706664312,SIO 153,A01,839722,Capaldi; Tomas,29,0,30,1
1739706665338,SIO 160,A00,839723,Fialko; Yuri A.,26,0,30,4
1739706666363,SIO 173,A00,839724,Xie; Shang-Ping,26,0,30,4
1739706667391,SIO 174,A00,839725,Aluwihare; Lihini & Russell; Lynn M.,26,0,30,4
1739706668416,SIO 176,A00,839726,Merrifield; Sophia T,27,0,30,3
1739706669441,SIO 181,A01,839728,Tresguerres; Martin,20,0,25,5
1739706669441,SIO 181,A02,839729,Tresguerres; Martin,23,0,25,2
1739706669441,SIO 181,A03,839730,Tresguerres; Martin,25,0,25,0
1739706669441,SIO 181,A04,839731,Tresguerres; Martin,23,0,25,2
1739706669441,SIO 181,A05,839732,Tresguerres; Martin,25,0,25,0
1739706669441,SIO 181,A06,839733,Tresguerres; Martin,24,0,25,1
1739706670469,SIO 184,A01,839735,Rouse; Gregory W.,17,0,24,7
1739706670469,SIO 184,A02,839736,Rouse; Gregory W.,20,0,24,4
1739706671495,SIO 190,A01,839738,Lin; Ying-Tsong,18,0,20,2
1739706671495,SIO 190,B01,839740,Kacev; David,26,0,30,4
1739706671495,SIO 190,D01,839742,Gaasterland; Theresa,20,0,20,0
1739706672520,SIO 190L,A00,886144,Staff,28,0,30,2
1739706672520,SIO 190L,A01,886145,Staff,30,0,30,0
1739706673544,SIO 194,A00,851602,Staff,0,0,0,0
1739706674569,SIOB 242C,A01,839746,Gaasterland; Theresa,25,0,25,0
1739706675593,SIOB 243,A00,839748,Gerwick; William Henry,17,0,20,3
1739706676620,SIOB 262,A00,839749,Gerwick; William Henry,25,0,25,0
1739706677644,SIOB 270A,A01,839751,Petrik; Colleen Mary,11,0,15,4
1739706678669,SIOB 278,A00,839752,Jensen; Paul R.,13,0,15,2
1739706678669,SIOB 278,B00,872373,Hechinger; Ryan F.,11,0,15,4
1739706678669,SIOB 278,C00,874430,Allen; Andrew Ellis,13,0,15,2
1739706679696,SIOB 279,A00,871153,Barton; Andrew David,43,0,50,7
1739706680723,SIOB 282,A00,839753,Palenik; Brian,18,0,20,2
1739706681749,SIOB 284,A01,839755,Rouse; Gregory W.,1,0,3,2
1739706681749,SIOB 284,A02,839756,Rouse; Gregory W.,2,0,3,1
1739706682774,SIOB 286,A01,839758,Aburto Oropeza; Marco Octavio,20,0,25,5
1739706683800,SIOB 291,A00,839759,Staff,0,0,0,0
1739706684825,SIOB 297,A00,839760,Allen; Eric,19,0,25,6
1739706685853,SIOC 202B,A00,839761,Stramski; Dariusz & Gabriel; Anne Alice-Agnes,16,0,20,4
1739706686880,SIOC 203C,A01,839763,Young; William Roy,18,0,20,2
1739706687903,SIOC 207C,A00,872521,Vasconcelos; Manuela,5,0,5,0
1739706688927,SIOC 208,A00,839764,Lucas; Andrew J.,45,0,50,5
1739706689951,SIOC 209,A00,872379,Werner; Bradley T.,10,0,10,0
1739706689951,SIOC 209,B00,874420,Watson-Parris; Duncan & Hao; Xuanting,17,0,20,3
1739706690979,SIOC 211B,A00,839779,Feddersen; Falk,5,0,8,3
1739706692003,SIOC 212B,A01,839861,Cessi; Paola,11,0,15,4
1739706693028,SIOC 217C,A00,839862,Lutsko; Nicholas J.,23,0,25,2
1739706694052,SIOC 218A,A00,839863,Send; Uwe,3,0,10,7
1739706695076,SIOC 228,A00,839865,Shi; Yuanyuan,1,0,10,9
1739706696102,SIOC 235,A00,839866,Xie; Shang-Ping,7,0,10,3
1739706697129,SIOC 250,A00,839871,Norris; Joel Roland,20,0,20,0
1739706698154,SIOC 296,A00,871155,Gabriel; Corey John,9,0,20,11
1739706699180,SIOG 200B,A00,839873,Gabriel; Anne Alice-Agnes,19,0,20,1
1739706700203,SIOG 224,A00,839876,Laske; Gabi & Stegman; David,20,0,20,0
1739706701233,SIOG 227C,A00,839879,Fan; Wenyuan & Gabriel; Anne Alice-Agnes,20,0,20,0
1739706702259,SIOG 228,A00,839880,Van Allen; Emily Joyce,13,0,20,7
1739706703283,SIOG 230,A00,839882,Constable; Catherine G,25,0,25,0
1739706704307,SIOG 232,A00,839885,Constable; Steven C & Constable; Catherine G,49,0,50,1
1739706705332,SIOG 236,A01,839890,Fricker; Helen A. & Sandwell; David T,5,0,5,0
1739706705332,SIOG 236,A02,872451,Fricker; Helen A. & Sandwell; David T,5,0,5,0
1739706706359,SIOG 239,A00,839891,Fan; Wenyuan,19,0,20,1
1739706707386,SIOG 268,A00,872652,Martz; Todd R.,9,0,10,1
1739706708411,SOCE 194,A00,851601,Staff,0,0,0,0
1739706709443,SOCG 204,A00,838022,Ng; Kwai,0,0,10,10
1739706710470,SOCG 206,A00,838023,Alvarez; Camila Huerta,6,0,10,4
1739706711495,SOCG 246,A00,838024,Kenworthy; Lane A.,4,0,10,6
1739706712520,SOCG 255B,A00,838025,Gere; Catherina M.,7,0,10,3
1739706713546,SOCG 255C,A00,838026,McKenzie; Kerry V.,7,0,10,3
1739706714570,SOCG 263,A00,838027,Jules-Rosette; Bennetta W.,9,0,10,1
1739706715597,SOCG 278,A00,838030,Watson; Tobias,4,0,10,6
1739706716622,SOCG 280,A00,838031,Fitzgerald; David S,4,0,10,6
1739706717646,SOCG 290,A00,838032,Goldman; Harvey Stern,7,0,10,3
1739706718671,SOCI 2,A01,837726,Payne; Christine Anna,27,0,30,3
1739706718671,SOCI 2,A02,837727,Payne; Christine Anna,30,0,30,0
1739706718671,SOCI 2,A03,837728,Payne; Christine Anna,29,0,30,1
1739706718671,SOCI 2,A04,837729,Payne; Christine Anna,29,0,30,1
1739706718671,SOCI 2,A05,837730,Payne; Christine Anna,30,0,30,0
1739706718671,SOCI 2,A06,837766,Payne; Christine Anna,0,0,0,0
1739706718671,SOCI 2,A07,837769,Payne; Christine Anna,0,0,0,0
1739706718671,SOCI 2,A08,837770,Payne; Christine Anna,0,0,0,0
1739706719697,SOCI 10,A01,869965,Kenworthy; Lane A.,27,0,30,3
1739706719697,SOCI 10,A02,869977,Kenworthy; Lane A.,28,0,30,2
1739706719697,SOCI 10,A03,869985,Kenworthy; Lane A.,30,0,30,0
1739706719697,SOCI 10,A04,869986,Kenworthy; Lane A.,28,0,30,2
1739706720725,SOCI 20,A01,837783,Calderon-Zaks; Michael Aar,35,0,35,0
1739706720725,SOCI 20,A02,837807,Calderon-Zaks; Michael Aar,34,0,35,1
1739706721750,SOCI 60,A01,837816,Sutton; April Marie,28,0,32,4
1739706721750,SOCI 60,A02,837817,Sutton; April Marie,32,0,32,0
1739706721750,SOCI 60,A03,837818,Sutton; April Marie,29,0,32,3
1739706721750,SOCI 60,A04,837819,Sutton; April Marie,31,0,32,1
1739706722775,SOCI 100,A01,837840,Medvetz; Thomas Matthew,29,0,30,1
1739706722775,SOCI 100,A02,837848,Medvetz; Thomas Matthew,30,0,30,0
1739706722775,SOCI 100,A03,837849,Medvetz; Thomas Matthew,30,0,30,0
1739706722775,SOCI 100,A04,837850,Medvetz; Thomas Matthew,28,0,30,2
1739706723803,SOCI 103M,A00,837862,Kilpatrick; Kevin,29,0,30,1
1739706724830,SOCI 104,A00,837863,Arnal; Maud Marie Leonie,28,0,30,2
1739706725854,SOCI 106,A00,837869,Payne; Christine Anna,27,0,30,3
1739706726882,SOCI 109,A00,837870,Kilpatrick; Kevin,29,0,30,1
1739706727906,SOCI 111,A00,837871,Ribas Norris; Janet Vanesa,56,0,56,0
1739706728934,SOCI 111T,A00,837872,Thorpe; Charles Robert,65,0,65,0
1739706729959,SOCI 112,A00,837885,Pitt; Richard Norris,58,0,65,7
1739706730986,SOCI 113,A00,837886,Rogers; Julia Ellen,73,0,75,2
1739706732011,SOCI 115,A00,837889,Sutton; April Marie,63,0,65,2
1739706733036,SOCI 117,A01,851612,Jones; Makeba,9,0,13,4
1739706733036,SOCI 117,A02,851613,Jones; Makeba,13,0,13,0
1739706733036,SOCI 117,A03,851614,Jones; Makeba,12,0,12,0
1739706733036,SOCI 117,A04,851616,Jones; Makeba,12,0,12,0
1739706733036,SOCI 117,B01,870980,Staff,10,0,10,0
1739706733036,SOCI 117,B02,870985,Staff,10,0,10,0
1739706733036,SOCI 117,B03,870987,Staff,10,0,10,0
1739706733036,SOCI 117,B04,871055,Staff,10,0,10,0
1739706734114,SOCI 119,A00,837925,Victoria Torres; Pablo,87,0,90,3
1739706735139,SOCI 125C,A00,872640,Watson; Tobias,55,0,56,1
1739706736164,SOCI 125M,A00,837948,Fitzgerald; David S,45,0,45,0
1739706737189,SOCI 126,A01,851618,Jones; Makeba,18,0,20,2
1739706737189,SOCI 126,A02,837966,Jones; Makeba,20,0,20,0
1739706737189,SOCI 126,A03,837969,Jones; Makeba,20,0,20,0
1739706738213,SOCI 129,A00,837973,Pitt; Richard Norris,72,0,75,3
1739706739238,SOCI 132,A00,837974,Blair-Loy; Mary,74,0,75,1
1739706740263,SOCI 133,A00,837983,Calderon-Zaks; Michael Aar,55,0,56,1
1739706741289,SOCI 134,A00,837989,Rogers; Julia Ellen,45,0,45,0
1739706742329,SOCI 135,A00,838005,Ruiz; Jonathan Joseph,54,0,56,2
1739706743356,SOCI 138,A00,838006,Ruiz; Jonathan Joseph,55,0,56,1
1739706744380,SOCI 139,A00,838007,Ribas Norris; Janet Vanesa,41,0,46,5
1739706745403,SOCI 139A,A00,838008,Estefan; Michel,52,0,56,4
1739706746430,SOCI 140A,A00,838009,Gong; Neil M,66,0,70,4
1739706747455,SOCI 140J,A00,838010,Estefan; Michel,92,0,100,8
1739706748479,SOCI 148,A00,838011,Maron; Asa,34,0,35,1
1739706749507,SOCI 150,A00,838012,Victoria Torres; Pablo,68,0,75,7
1739706750537,SOCI 151,A00,838013,Goldman; Harvey Stern,64,0,65,1
1739706751562,SOCI 156,A00,838014,Ostovany; Khashayar,40,0,40,0
1739706752591,SOCI 157,A00,838015,Crofts; Christine,45,0,56,11
1739706753618,SOCI 158,A00,838016,Ostovany; Khashayar,39,0,40,1
1739706754644,SOCI 160,A00,838017,Medvetz; Thomas Matthew,70,0,70,0
1739706755668,SOCI 161,A00,838018,Arnal; Maud Marie Leonie,49,0,50,1
1739706756696,SOCI 168,A00,838019,Thorpe; Charles Robert,40,0,40,0
1739706757721,SOCI 168E,A00,838021,Crofts; Christine,19,0,35,16
1739706758746,SOCI 174,A00,872915,Shafir; Gershon,28,0,30,2
1739706759774,SOMC 229,A00,867907,Hoang; Mai Phuong,160,0,160,0
1739706760801,SOMC 240,A00,867911,Coyne; Christopher John,160,0,160,0
1739706761826,SOMC 242,A00,867913,Kline; Ahnika Sarah,160,0,160,0
1739706762851,SOMC 244,A00,867940,Evans; Sean Jeffrey,160,0,160,0
1739706763875,SOMC 245C,A01,867952,Noel; Geoffroy Pierre Jean,160,0,160,0
1739706764904,SOMC 246C,A00,867953,Eyler; Lisa T.,160,0,160,0
1739706765929,SOMC 247C,A50,867992,Calcutt; Nigel A,160,0,160,0
1739706766953,SOMC 248C,A00,867993,Joshi; Weena Erin,160,0,160,0
1739706767980,SOMC 249,A00,867994,Bui; Jack D,160,0,160,0
1739706769007,SOMC 250,A00,867997,Reid; Erin G.,160,0,160,0
1739706770032,SOMC 255C,A00,868050,Allison; Matthew,160,0,160,0
1739706771057,SOMI 296,A00,868065,Staff,5,0,5,0
1739706772086,SPPH 161R,A01,864775,Chambers; Christina D,29,0,30,1
1739706772086,SPPH 161R,C01,886226,Chambers; Christina D,20,0,20,0
1739706773110,SPPH 263B,A01,884929,Hook; Vivian Yuan-Ho,98,0,99,1
1739706774134,SPPS 200A,A00,864810,Luli; Alex J,100,0,100,0
1739706775159,SPPS 200B,A00,864827,Luli; Alex J,99,0,99,0
1739706776184,SPPS 200C,A00,864829,Luli; Alex J,99,0,99,0
1739706777208,SPPS 203,A00,864831,Painter; Nathan A.,92,0,99,7
1739706778234,SPPS 205,A01,864838,Bandeira; Nuno Filipe Cabrita,92,0,99,7
1739706779261,SPPS 209,A00,864842,Bounthavong; Mark,93,0,99,6
1739706780285,SPPS 211A,A00,864862,Ferguson; Fleur,92,0,99,7
1739706781310,SPPS 211B,A00,864920,Ferguson; Fleur,96,0,99,3
1739706782335,SPPS 211C,A00,864924,Ferguson; Fleur,93,0,99,6
1739706783362,SPPS 211D,A00,864925,Tsunoda; Shirley M.,99,0,99,0
1739706784386,SPPS 212C,A01,864927,Saunders; Ila Maewal,93,0,99,6
1739706785412,SPPS 213C,A00,864928,Namba; Jennifer Mariko,93,0,99,6
1739706786438,SPPS 218B,A00,864929,Vijapurkar; Ulka,93,0,99,6
1739706787462,SPPS 225,A01,864932,Reed; Chantal,92,0,99,7
1739706788489,SPPS 229,A01,864934,Reid; Erin G.,96,0,99,3
1739706789513,SPPS 237,A00,864935,Mimoto; Mizuho Stacy,96,0,99,3
1739706790537,SPPS 238,A00,864937,Beyhan; Sinem,96,0,99,3
1739706791561,SPPS 239,A01,864942,Bui; Jack D,96,0,99,3
1739706792586,SPPS 241,A01,864944,Tsunoda; Shirley M.,92,0,99,7
1739706793626,SPPS 249,A00,864945,Brandl; Katharina,96,0,99,3
1739706794652,SPPS 250,A00,864946,Tsunoda; Shirley M.,97,0,99,2
1739706795676,SPPS 251,A00,864953,Chen; Timothy,20,0,20,0
1739706796700,SPPS 252,A00,865004,Abdul-Mutakabbir; Jacinda,96,0,99,3
1739706797724,SPPS 253,A00,865006,Tsunoda; Shirley M.,99,0,99,0
1739706798748,SPPS 255,A00,865010,Bounthavong; Mark,98,0,99,1
1739706799775,SPPS 261,A00,865011,Chambers; Christina D,97,0,99,2
1739706800817,SPPS 278,A00,865012,Fricovsky; Eduardo Santiago,98,0,99,1
1739706801842,SPPS 280,A00,865013,Fricovsky; Eduardo Santiago,23,0,23,0
1739706802869,SPPS 281,A00,865014,Gerwick; William Henry,95,0,99,4
1739706803896,SPPS 283,A00,865015,Tsunoda; Shirley M.,98,0,99,1
1739706804920,SURG 296,001,868067,Harris; Jeffrey Paul,4,0,5,1
1739706804920,SURG 296,002,868068,Coffey; Charles Stuart,4,0,5,1
1739706804920,SURG 296,003,868069,Malas; Mahmoud,4,0,5,1
1739706805955,SYN 1,001,836580,Rock; Martin,20,0,20,0
1739706805955,SYN 1,002,836582,Birberick; Brittany Celest,17,0,20,3
1739706805955,SYN 1,003,836583,Meyer; Leslie Rose,20,0,20,0
1739706805955,SYN 1,004,836584,Fish; Gwendolyn Anne,19,0,20,1
1739706805955,SYN 1,005,836585,Fish; Gwendolyn Anne,20,0,20,0
1739706805955,SYN 1,006,836586,Tawater; Hanna Jean,20,0,20,0
1739706805955,SYN 1,007,836590,Fish; Gwendolyn Anne,20,0,20,0
1739706805955,SYN 1,008,836591,Iatarola; Briana Marie,18,0,20,2
1739706805955,SYN 1,009,836592,Browne; Emily,20,0,20,0
1739706805955,SYN 1,010,836594,Staff,20,0,20,0
1739706805955,SYN 1,011,836595,Hom; Kirstyn Courtney,20,0,20,0
1739706805955,SYN 1,012,836599,Hom; Kirstyn Courtney,19,0,20,1
1739706805955,SYN 1,013,836600,Lagapa; Jason,20,0,20,0
1739706805955,SYN 1,014,836603,Deavenport; James Cary,18,0,20,2
1739706805955,SYN 1,015,836606,Girard; Gabrielle,19,0,20,1
1739706805955,SYN 1,016,836607,Deavenport; James Cary,20,0,20,0
1739706805955,SYN 1,017,836622,Girard; Gabrielle,20,0,20,0
1739706805955,SYN 1,018,836653,Atkinson; Arthur Laird,20,0,20,0
1739706805955,SYN 1,019,836656,Girard; Gabrielle,18,0,20,2
1739706805955,SYN 1,020,836658,Atkinson; Arthur Laird,18,0,20,2
1739706805955,SYN 1,021,836659,Staff,20,0,20,0
1739706805955,SYN 1,022,836662,Bishop; Graham,19,0,20,1
1739706805955,SYN 1,023,836663,Bishop; Graham,20,0,20,0
1739706805955,SYN 1,024,836666,Lagapa; Jason,18,0,20,2
1739706805955,SYN 1,025,836723,Lagapa; Jason,20,0,20,0
1739706805955,SYN 1,026,836728,Iatarola; Briana Marie,20,0,20,0
1739706805955,SYN 1,027,836729,Iatarola; Briana Marie,20,0,20,0
1739706805955,SYN 1,028,836730,Difruscio; Mark,20,0,20,0
1739706805955,SYN 1,029,836731,Difruscio; Mark,19,0,20,1
1739706806985,SYN 100,A01,836744,Gladstein; Jill M,12,0,15,3
1739706806985,SYN 100,A02,836745,Gladstein; Jill M,15,0,15,0
1739706806985,SYN 100,B01,836748,Rock; Martin,15,0,15,0
1739706806985,SYN 100,B02,836809,Rock; Martin,14,0,15,1
1739706806985,SYN 100,C01,836812,Browne; Emily,14,0,15,1
1739706806985,SYN 100,C02,836818,Browne; Emily,13,0,15,2
1739706806985,SYN 100,D01,836820,Meyer; Leslie Rose,10,0,15,5
1739706806985,SYN 100,D02,836822,Meyer; Leslie Rose,15,0,15,0
1739706806985,SYN 100,E01,836824,Tawater; Hanna Jean,13,0,15,2
1739706806985,SYN 100,E02,836825,Tawater; Hanna Jean,12,0,15,3
1739706806985,SYN 100,F01,836975,Meyer; Leslie Rose,15,0,15,0
1739706806985,SYN 100,F02,837038,Meyer; Leslie Rose,14,0,15,1
1739706806985,SYN 100,G01,837132,Deavenport; James Cary,13,0,15,2
1739706806985,SYN 100,G02,837133,Deavenport; James Cary,14,0,15,1
1739706806985,SYN 100,H01,837155,Gormally; Brenna,15,0,15,0
1739706806985,SYN 100,H02,872920,Gormally; Brenna,15,0,15,0
1739706806985,SYN 100,I01,837161,Gormally; Brenna,13,0,15,2
1739706806985,SYN 100,I02,837166,Gormally; Brenna,15,0,15,0
1739706806985,SYN 100,J01,837169,Difruscio; Mark,9,0,15,6
1739706806985,SYN 100,J02,837171,Difruscio; Mark,12,0,15,3
1739706806985,SYN 100,K01,837174,Rosenberg; Ryan Glenn,9,0,15,6
1739706806985,SYN 100,K02,837176,Rosenberg; Ryan Glenn,15,0,15,0
1739706806985,SYN 100,L01,837264,Rosenberg; Ryan Glenn,13,0,15,2
1739706806985,SYN 100,L02,837265,Rosenberg; Ryan Glenn,15,0,15,0
1739706806985,SYN 100,M01,837268,Hom; Kirstyn Courtney,12,0,15,3
1739706806985,SYN 100,M02,837269,Hom; Kirstyn Courtney,12,0,15,3
1739706806985,SYN 100,N01,837272,Atkinson; Arthur Laird,14,0,15,1
1739706806985,SYN 100,N02,837275,Atkinson; Arthur Laird,14,0,15,1
1739706806985,SYN 100,O01,837278,Bishop; Graham,13,0,15,2
1739706806985,SYN 100,O02,837284,Bishop; Graham,15,0,15,0
1739706808012,SYN 150,001,837627,Vega; Adrian,20,0,20,0
1739706808012,SYN 150,002,837643,Vega; Adrian,20,0,20,0
1739706809039,TDAC 1,A00,835839,Walsh; Kim C.,19,0,20,1
1739706809039,TDAC 1,B00,835840,Walsh; Kim C.,20,0,20,0
1739706809039,TDAC 1,C00,835841,Walsh; Kim C.,7,0,20,13
1739706809039,TDAC 1,D00,835843,Walsh; Kim C.,19,0,20,1
1739706809039,TDAC 1,E00,835844,Walsh; Kim C.,6,0,20,14
1739706809039,TDAC 1,F00,835845,Walsh; Kim C.,15,0,20,5
1739706810063,TDAC 101,A00,836005,Basso; Beatrice,17,0,20,3
1739706811089,TDAC 102,A00,836006,Harting; Carla Kelso,16,0,20,4
1739706812118,TDAC 105,A00,836007,Barricelli; Marc Alexander,20,0,20,0
1739706813144,TDAC 108,A00,836008,Buescher; Stephen W.,17,0,20,3
1739706813144,TDAC 108,B00,836009,Buescher; Stephen W.,16,0,20,4
1739706813144,TDAC 108,C00,836010,Walsh; Kim C.,20,0,20,0
1739706814168,TDAC 109,A00,836012,Blair; Kyle Adam,20,0,20,0
1739706815194,TDAC 122,A00,836014,Stalling; Vanessa,30,0,30,0
1739706815194,TDAC 122,B00,836015,Perry; Lamar,30,0,30,0
1739706815194,TDAC 122,C00,872388,Celik; Aysan Karagasli,30,0,30,0
1739706815194,TDAC 122,D00,874223,Caban; Andrea Chudnow,30,0,30,0
1739706815194,TDAC 122,E00,874224,Staff,30,0,30,0
1739706816219,TDDE 101,A00,836016,Guirguis; Mark C,20,0,20,0
1739706817246,TDDE 121,A01,836018,Kuhl; Christopher August,16,0,17,1
1739706818273,TDDE 130,A00,836019,Guirguis; Mark C,20,0,20,0
1739706819296,TDDE 131,A00,836020,Petrovich; Victoria A.,19,0,20,1
1739706819296,TDDE 131,B00,872473,Brill; Robert L.,100,0,100,0
1739706820324,TDDE 132,A00,836021,Guirguis; Mark C,20,0,20,0
1739706821348,TDDM 1,A00,835853,Sammartano; Tonnie,40,0,40,0
1739706822372,TDDM 100,A00,836022,Alvarez; Ana Maria,29,0,30,1
1739706823397,TDDR 102,A00,836024,Powell; Lora,19,0,20,1
1739706824424,TDDR 108,A00,836029,Stalling; Vanessa,20,0,20,0
1739706825448,TDDR 111,A00,836039,Castro; Robert Jess,15,0,16,1
1739706825448,TDDR 111,B00,836070,Castro; Robert Jess,16,0,16,0
1739706826471,TDDR 190,A00,836072,Perry; Lamar,35,0,35,0
1739706827501,TDGE 1,A01,835855,Salovey; Todd,19,0,20,1
1739706827501,TDGE 1,A02,835856,Salovey; Todd,20,0,20,0
1739706827501,TDGE 1,A03,835857,Salovey; Todd,19,0,20,1
1739706827501,TDGE 1,A04,835858,Salovey; Todd,20,0,20,0
1739706827501,TDGE 1,A05,835859,Salovey; Todd,19,0,20,1
1739706827501,TDGE 1,A06,835861,Salovey; Todd,17,0,20,3
1739706828527,TDGE 11,A00,835862,Fulton; Julia,224,0,245,21
1739706828527,TDGE 11,B00,835863,Salimi; Rana,157,0,158,1
1739706829555,TDGE 25,A00,835864,Harting; Carla Kelso,15,0,20,5
1739706829555,TDGE 25,B00,835865,Harting; Carla Kelso,14,0,20,6
1739706829555,TDGE 25,C00,835866,Harting; Carla Kelso,19,0,20,1
1739706829555,TDGE 25,D00,835868,Harting; Carla Kelso,16,0,20,4
1739706830582,TDGE 40,A02,835872,Power; Jade Yukana,29,0,30,1
1739706830582,TDGE 40,A03,835873,Power; Jade Yukana,30,0,30,0
1739706831609,TDGE 100,A01,836080,Salovey; Todd,24,0,25,1
1739706831609,TDGE 100,A02,836084,Salovey; Todd,24,0,25,1
1739706832633,TDGE 124,A00,836091,Fulton; Julia,232,0,250,18
1739706833659,TDGE 125,B00,836162,Havis; Allan,215,0,220,5
1739706834694,TDGE 196B,A00,872390,Brown; Bernard Joseph,1,0,1,0
1739706834694,TDGE 196B,B00,872391,Burelle; Julie Sara Veronique,2,0,2,0
1739706834694,TDGE 196B,C00,872392,Celik; Aysan Karagasli,2,0,2,0
1739706834694,TDGE 196B,D00,872394,Havis; Allan,1,0,1,0
1739706834694,TDGE 196B,E00,872396,Mehrishi; Rishika,1,0,1,0
1739706834694,TDGE 196B,F00,872397,Powell; Lora,1,0,1,0
1739706834694,TDGE 196B,G00,872398,Stalling; Vanessa,1,0,1,0
1739706834694,TDGE 196B,H00,872399,Stein; Deborah Isobel,2,0,2,0
1739706835722,TDGR 212,A00,836303,Meyer; Ursula,10,0,10,0
1739706836749,TDGR 219,A00,836305,Portes; Elizabeth Marie,5,0,5,0
1739706837829,TDGR 221B,A00,836306,Caban; Andrea Chudnow,10,0,10,0
1739706838854,TDGR 229,A00,836307,Meyer; Ursula,9,0,9,0
1739706839881,TDGR 233,A00,836308,Staff,9,0,9,0
1739706840905,TDGR 245,A00,836309,Stalling; Vanessa,3,0,3,0
1739706841929,TDGR 250,A00,836311,Staff,5,0,5,0
1739706842954,TDGR 251,A00,836314,Iizuka; Naomi Hisako,5,0,5,0
1739706842954,TDGR 251,B00,836315,Stein; Deborah Isobel,5,0,5,0
1739706843979,TDGR 257B,A00,836388,Stein; Deborah Isobel,7,0,7,0
1739706845005,TDGR 278,A00,836431,Petrovich; Victoria A.,20,0,20,0
1739706846034,TDGR 279,A00,836437,Brill; Robert L.,3,0,3,0
1739706846034,TDGR 279,B00,836440,Petrovich; Victoria A.,3,0,3,0
1739706846034,TDGR 279,C00,836441,McElver; Robert Harrison,3,0,3,0
1739706846034,TDGR 279,D00,836443,Kuhl; Christopher August,3,0,3,0
1739706846034,TDGR 279,E00,836444,Bokovikova; Alina V,3,0,3,0
1739706847062,TDGR 289C,A00,836447,Anderson; Mysia Anyse,10,0,10,0
1739706848086,TDGR 289D,A00,836448,Burelle; Julie Sara Veronique,10,0,10,0
1739706849115,TDGR 292,A00,836449,Anderson; Mysia Anyse,15,0,15,0
1739706850142,TDGR 296,A00,872384,Powell; Lora,10,0,10,0
1739706851168,TDHD 175,A00,836190,Brown; Bernard Joseph,19,0,20,1
1739706852198,TDHT 10,A00,835875,Power; Jade Yukana,24,0,25,1
1739706853224,TDHT 23,A01,835878,Burelle; Julie Sara Veronique,24,0,24,0
1739706853224,TDHT 23,A02,835879,Burelle; Julie Sara Veronique,24,0,24,0
1739706853224,TDHT 23,A03,835880,Burelle; Julie Sara Veronique,22,0,24,2
1739706854252,TDHT 101,A00,836191,Anderson; Mysia Anyse,23,0,25,2
1739706854252,TDHT 101,B00,836193,Staff,24,0,25,1
1739706855279,TDHT 104,A00,836196,Basso; Beatrice,24,0,25,1
1739706856304,TDHT 115,A00,872386,Staff,21,0,25,4
1739706857329,TDMV 1,A00,835881,Caligagan; Maria T.,21,0,30,9
1739706858356,TDMV 2,A00,835882,Weinberg; Sadie,25,0,30,5
1739706859381,TDMV 3,A00,835884,Mack; Kara Shanai',28,0,40,12
1739706860406,TDMV 11,A00,835886,Naves Tannus; Melissa,27,0,30,3
1739706861433,TDMV 20,A00,835890,Smith; Alison D,18,0,20,2
1739706861433,TDMV 20,B00,835920,Brown; Bernard Joseph,40,0,40,0
1739706862459,TDMV 110,A00,836197,Caligagan; Maria T.,29,0,30,1
1739706863485,TDMV 111,A00,836201,Smith; Alison D,26,0,30,4
1739706864512,TDMV 120,A00,836206,Johnston; Holly,30,0,30,0
1739706865539,TDMV 122,A00,836209,Weinberg; Sadie,30,0,30,0
1739706866563,TDMV 123,A00,836214,Johnston; Holly,30,0,30,0
1739706867587,TDMV 130,A00,836216,Mack; Kara Shanai',40,0,40,0
1739706868614,TDMV 138,A00,836222,Jun; Grace Shin Hae,17,0,40,23
1739706869641,TDMV 140,A00,836225,Caligagan; Maria T.,38,0,40,2
1739706869641,TDMV 140,B00,836226,Corrales; Joseph Bernales,39,0,40,1
1739706869641,TDMV 140,C00,836228,Mack; Kara Shanai',30,0,30,0
1739706869641,TDMV 140,D00,836229,Power; Jade Yukana,27,0,30,3
1739706869641,TDMV 140,E00,836232,Lima; Paulo Henrique,30,0,30,0
1739706870666,TDMV 141,A00,836236,Caligagan; Tony,29,0,30,1
1739706871691,TDMV 142,A00,836239,Blanco; Juan Carlos,27,0,30,3
1739706872714,TDMV 143,A00,836288,Fyall; Daunte Edward,29,0,30,1
1739706873743,TDMV 144,A00,836289,Camaya; Michelle Ann,25,0,30,5
1739706873743,TDMV 144,B00,836293,Patnaik; Shibani,30,0,30,0
1739706874767,TDMV 146,A00,836295,Caligagan; Tony,39,0,40,1
1739706875794,TDMV 149,A00,836296,Jun; Grace Shin Hae,38,0,40,2
1739706876821,TDPF 162,A00,836297,Alvarez; Ana Maria,30,0,30,0
1739706877849,TDPR 6,A01,835924,Guirguis; Mark C,50,0,50,0
1739706877849,TDPR 6,A02,835925,Guirguis; Mark C,50,0,50,0
1739706878874,TDPR 102,A00,836298,Guirguis; Mark C,20,0,20,0
1739706879900,TDPR 104,A00,836299,Powell; Lora,15,0,15,0
1739706880925,TDPW 1,A00,835931,Stein; Deborah Isobel,14,0,15,1
1739706880925,TDPW 1,B00,835932,Stein; Deborah Isobel,15,0,15,0
1739706880925,TDPW 1,C00,835934,Stein; Deborah Isobel,15,0,15,0
1739706880925,TDPW 1,D00,835936,Stein; Deborah Isobel,13,0,15,2
1739706880925,TDPW 1,E00,835939,Stein; Deborah Isobel,13,0,15,2
1739706881952,TDPW 102,A00,836300,Iizuka; Naomi Hisako,19,0,20,1
1739706882977,TDTR 10,A00,836002,Wilson; Terry A.,26,0,30,4
1739706884001,TDTR 15,A00,836003,Johnston; Holly,29,0,30,1
1739706885030,TDTR 20,A00,836004,Smith; Alison D,19,0,20,1
1739706886058,TMC 15,A00,836574,Hemans; Patricia Ann Benitez,25,0,27,2
1739706887083,TMC 120,A01,836579,Browne; Errol Tsekani,24,0,25,1
1739706888111,UROL 296,001,868229,Staff,5,0,5,0
1739706888111,UROL 296,002,868230,Staff,5,0,5,0
1739706889140,USP 1,A01,835156,Kwak; Nancy,30,0,30,0
1739706889140,USP 1,A02,835157,Kwak; Nancy,27,0,30,3
1739706889140,USP 1,A03,835158,Kwak; Nancy,29,0,30,1
1739706889140,USP 1,A04,835159,Kwak; Nancy,28,0,30,2
1739706889140,USP 1,A05,835160,Kwak; Nancy,30,0,30,0
1739706889140,USP 1,A06,835161,Kwak; Nancy,30,0,30,0
1739706890165,USP 2,A01,835188,Pezzoli; Keith,34,0,35,1
1739706890165,USP 2,A02,835191,Pezzoli; Keith,33,0,35,2
1739706891190,USP 3,A01,835207,Wickland; Teo Akande,30,0,30,0
1739706891190,USP 3,A02,835290,Wickland; Teo Akande,28,0,30,2
1739706892216,USP 4,A00,835371,Shi; Xiao,24,0,25,1
1739706893243,USP 5,A01,835376,Shenkman; Michael Thomas,30,0,35,5
1739706893243,USP 5,A02,835381,Shenkman; Michael Thomas,34,0,35,1
1739706894270,USP 6,A01,835456,Shvartzberg Carrio; Manuel,35,0,35,0
1739706894270,USP 6,A02,835457,Shvartzberg Carrio; Manuel,35,0,35,0
1739706895295,USP 15,A01,835460,Martin; Isaac,32,0,35,3
1739706895295,USP 15,A02,835461,Martin; Isaac,35,0,35,0
1739706896320,USP 25,A00,835462,Sun; Feiyang,58,0,60,2
1739706897346,USP 60,A01,835468,Wali; Behram,27,0,28,1
1739706898373,USP 100,A00,835469,Moses; Kelema Lee,68,0,70,2
1739706899398,USP 119,A00,835472,Schwaller; Nora Louise,30,0,35,5
1739706900423,USP 124,A00,835475,Hinds; Juli Beth,67,0,70,3
1739706901448,USP 125,A00,835477,Garcia; Guadalupe,22,0,22,0
1739706902476,USP 128B,A01,835530,Lewis; Leslie R,13,0,13,0
1739706903503,USP 131,A00,835537,Wartell; Julie Dara,35,0,65,30
1739706904532,USP 142C,A00,835546,Lerner; Amy M,0,0,0,3
1739706905555,USP 145,A00,835547,Yaghmaee; Saman,142,0,146,4
1739706906580,USP 150,A00,835548,Holmes; Michael Joseph,58,0,60,2
1739706907605,USP 151,A00,835551,Clark; Christopher N,42,0,45,3
1739706908630,USP 152A,A01,835569,Moeder; Nathan L,22,0,22,0
1739706908630,USP 152A,A02,835571,Moeder; Nathan L,21,0,22,1
1739706909655,USP 152B,A00,835581,Moeder; Nathan L,23,0,25,2
1739706910679,USP 153,A00,835641,Shenkman; Michael Thomas,63,0,65,2
1739706911705,USP 158A,A00,835683,Sun; Feiyang,25,0,25,0
1739706912732,USP 159B,A00,835704,Gherini; Paul Pier-Carlo,7,0,8,1
1739706913756,USP 160,A00,835742,Wartell; Julie Dara,25,0,25,0
1739706914779,USP 164,A00,835796,Moses; Kelema Lee,24,0,32,8
1739706915803,USP 165C,A00,835797,Frank; Lawrence Douglas,20,0,20,0
1739706916829,USP 169,A00,835799,Bajaj; Ravi Siddharth,29,0,30,1
1739706917853,USP 170,A00,835800,Entezam; Maryam,60,0,65,5
1739706918879,USP 171,A00,835802,Herzog; Lawrence,65,0,70,5
1739706919904,USP 172,A00,835804,Peerson; Susan,13,0,22,9
1739706920930,USP 175,A00,835805,Velasco; Diego,20,0,22,2
1739706920930,USP 175,B00,835806,Staff,20,0,22,2
1739706921958,USP 177A,A00,835807,Velasco; Diego,21,0,22,1
1739706922985,USP 177B,A00,835814,Peerson; Susan,22,0,25,3
1739706924009,USP 180,A00,835815,Frank; Lawrence Douglas,29,0,30,1
1739706925032,USP 188B,A00,835817,Pezzoli; Keith,30,0,30,0
1739706926059,USP 190,A00,835818,Collins; Caroline Imani,15,0,15,0
1739706927084,USP 191B,A00,835823,Shi; Xiao,18,0,20,2
1739706928110,USP 193,A00,835825,Staff,22,0,22,0
1739706929137,USP 194,A00,835837,Staff,0,0,0,0
1739706930164,USP 198,A00,880741,Moses; Kelema Lee,9999,0,9999,0
1739706931188,USP 265C,A00,835838,Frank; Lawrence Douglas,10,0,10,0
1739706932221,VIS 3,A01,833730,Fayman; Eva,25,0,25,0
1739706932221,VIS 3,A02,833731,Fayman; Eva,22,0,25,3
1739706932221,VIS 3,A03,833806,Fayman; Eva,24,0,25,1
1739706932221,VIS 3,A04,833888,Fayman; Eva,25,0,25,0
1739706932221,VIS 3,A05,833889,Fayman; Eva,25,0,25,0
1739706932221,VIS 3,A06,833890,Fayman; Eva,22,0,25,3
1739706932221,VIS 3,A07,833891,Fayman; Eva,24,0,25,1
1739706932221,VIS 3,A08,833892,Fayman; Eva,23,0,25,2
1739706932221,VIS 3,A09,833893,Fayman; Eva,25,0,25,0
1739706932221,VIS 3,A10,833894,Fayman; Eva,24,0,25,1
1739706932221,VIS 3,A11,833895,Fayman; Eva,25,0,25,0
1739706932221,VIS 3,A12,833896,Fayman; Eva,22,0,25,3
1739706933248,VIS 9,A00,833897,Sprague; Sean Jeffrey,213,0,250,37
1739706934272,VIS 10,A00,833898,Stone; Patricia,238,0,250,12
1739706935298,VIS 21A,A01,833900,Newsome; Elizabeth Ann,32,0,32,0
1739706935298,VIS 21A,A02,833901,Newsome; Elizabeth Ann,31,0,32,1
1739706935298,VIS 21A,A03,833902,Newsome; Elizabeth Ann,32,0,32,0
1739706935298,VIS 21A,A04,833903,Newsome; Elizabeth Ann,31,0,32,1
1739706935298,VIS 21A,A05,833904,Newsome; Elizabeth Ann,32,0,32,0
1739706935298,VIS 21A,A06,833905,Newsome; Elizabeth Ann,32,0,32,0
1739706936327,VIS 22,A01,833907,Williams; Alena J,32,0,32,0
1739706936327,VIS 22,A02,833908,Williams; Alena J,32,0,32,0
1739706936327,VIS 22,A03,833909,Williams; Alena J,30,0,32,2
1739706936327,VIS 22,A04,833910,Williams; Alena J,31,0,32,1
1739706936327,VIS 22,A05,833911,Williams; Alena J,31,0,32,1
1739706936327,VIS 22,A06,833912,Williams; Alena J,32,0,32,0
1739706936327,VIS 22,A07,833913,Williams; Alena J,32,0,32,0
1739706936327,VIS 22,A08,833914,Williams; Alena J,32,0,32,0
1739706936327,VIS 22,A09,833915,Williams; Alena J,32,0,32,0
1739706936327,VIS 22,A10,833916,Williams; Alena J,32,0,32,0
1739706936327,VIS 22,A11,833917,Williams; Alena J,31,0,32,1
1739706936327,VIS 22,A12,833918,Williams; Alena J,32,0,32,0
1739706937352,VIS 31,A00,833919,Dominguez; Ricardo,308,0,320,12
1739706938376,VIS 32,A01,833921,Yoldas; Pinar,31,0,32,1
1739706938376,VIS 32,A02,833922,Yoldas; Pinar,31,0,32,1
1739706939403,VIS 41,A01,833924,D'Elena-Tweed; Jessica Erin,25,0,25,0
1739706939403,VIS 41,A02,833925,D'Elena-Tweed; Jessica Erin,20,0,25,5
1739706939403,VIS 41,A03,833926,D'Elena-Tweed; Jessica Erin,25,0,25,0
1739706939403,VIS 41,A04,833927,D'Elena-Tweed; Jessica Erin,22,0,25,3
1739706939403,VIS 41,A05,833928,D'Elena-Tweed; Jessica Erin,25,0,25,0
1739706939403,VIS 41,A06,833929,D'Elena-Tweed; Jessica Erin,25,0,25,0
1739706940428,VIS 70N,A01,833931,Garnett; Mariah J,22,0,22,0
1739706940428,VIS 70N,A02,833932,Garnett; Mariah J,21,0,22,1
1739706940428,VIS 70N,A03,833972,Garnett; Mariah J,22,0,22,0
1739706940428,VIS 70N,A04,833974,Garnett; Mariah J,20,0,22,2
1739706940428,VIS 70N,A05,834047,Garnett; Mariah J,22,0,22,0
1739706940428,VIS 70N,A06,834048,Garnett; Mariah J,22,0,22,0
1739706941506,VIS 85A,A01,834098,Balboni; Francesca Jean,32,0,34,2
1739706941506,VIS 85A,A02,834099,Balboni; Francesca Jean,33,0,34,1
1739706942533,VIS 87,A00,872413,Mullin; Jennifer S & Twomey; Robert Daniel,10,0,10,0
1739706943558,VIS 100A,A00,834100,Cruz; Edwin Teddy,7,0,15,8
1739706944582,VIS 102,A00,834103,Cruz; Edwin Teddy,140,0,146,6
1739706945607,VIS 105A,A00,834105,Adler; Amy,29,0,30,1
1739706946635,VIS 105B,A00,834106,Tonies; Joshua Vanjaymes,26,0,30,4
1739706947661,VIS 105C,A00,834107,Herc-Balaszek; Malgorzata,14,0,15,1
1739706948685,VIS 106A,A00,834184,Staff,25,0,25,0
1739706948685,VIS 106A,B00,834185,Chew Ii; Troy Lamarr,24,0,25,1
1739706949711,VIS 106B,A00,834191,Ortiz-Torres; Ruben,24,0,25,1
1739706950736,VIS 106C,A00,834192,Staff,12,0,15,3
1739706951761,VIS 107A,A00,834193,Staff,21,0,25,4
1739706952787,VIS 107B,A00,834194,Pylypchuk; Jonathan,22,0,25,3
1739706953814,VIS 110A,A00,834217,Dinco; Dino,14,0,15,1
1739706954840,VIS 110B,A00,834218,Iglesias; Janelle Ann,13,0,15,2
1739706955864,VIS 110D,A00,834220,Tonies; Joshua Vanjaymes,14,0,15,1
1739706956892,VIS 110F,A00,834224,Fayman; Eva,15,0,15,0
1739706957917,VIS 110N,A00,834226,Adler; Amy,15,0,15,0
1739706958942,VIS 113BN,A00,834227,Staff,14,0,15,1
1739706959969,VIS 117E,A00,834229,Newsome; Elizabeth Ann,11,0,15,4
1739706960996,VIS 121AN,A00,834231,Tronzo; William,72,0,75,3
1739706962023,VIS 124E,A00,834312,Rose; Jordan M,70,0,75,5
1739706963049,VIS 127B,A00,834313,Shen; Kuiyi,146,0,146,0
1739706964074,VIS 128A,A00,834314,Tronzo; William,73,0,75,2
1739706965101,VIS 133,A01,834317,Cantrell; Joe Leo,33,0,34,1
1739706965101,VIS 133,A02,834318,Cantrell; Joe Leo,34,0,34,0
1739706966128,VIS 133A,A00,834409,Chevalier; Clarissa Maria,15,0,15,0
1739706967153,VIS 134,A00,834422,Staff,70,0,75,5
1739706968181,VIS 141B,A00,834423,Stalbaum; Brett,13,0,15,2
1739706969203,VIS 145B,A00,834455,Akten; Mehmet,13,0,15,2
1739706969203,VIS 145B,B00,834467,Alexander; Amy J,14,0,15,1
1739706970229,VIS 146A,A00,834482,Paden; Jonathon Dean,18,0,22,4
1739706971254,VIS 147A,A01,834484,Stalbaum; Brett,20,0,22,2
1739706971254,VIS 147A,A02,834485,Stalbaum; Brett,22,0,22,0
1739706971254,VIS 147A,A03,834493,Stalbaum; Brett,21,0,22,1
1739706971254,VIS 147A,A04,834494,Stalbaum; Brett,20,0,22,2
1739706972278,VIS 147B,A00,834495,Paden; Jonathon Dean,15,0,15,0
1739706973303,VIS 149,A00,834496,Yoldas; Pinar,12,0,15,3
1739706974330,VIS 150A,A00,834506,Staff,11,0,15,4
1739706975356,VIS 152D,A01,834679,Wardwell; Mariana Razo,33,0,34,1
1739706975356,VIS 152D,A02,834754,Wardwell; Mariana Razo,34,0,34,0
1739706975356,VIS 152D,A03,834757,Wardwell; Mariana Razo,32,0,34,2
1739706975356,VIS 152D,A04,834760,Wardwell; Mariana Razo,33,0,34,1
1739706976380,VIS 159,A01,834850,Cartwright; Lisa,34,0,34,0
1739706976380,VIS 159,A02,834851,Cartwright; Lisa,30,0,34,4
1739706976380,VIS 159,A03,834852,Cartwright; Lisa,32,0,34,2
1739706976380,VIS 159,A04,834853,Cartwright; Lisa,34,0,34,0
1739706976380,VIS 159,A05,834855,Cartwright; Lisa,31,0,34,3
1739706976380,VIS 159,A06,834857,Cartwright; Lisa,34,0,34,0
1739706977406,VIS 160A,A00,871872,Paden; Jonathon Dean,15,0,15,0
1739706978430,VIS 160B,A00,834858,Akten; Mehmet,8,0,15,7
1739706978430,VIS 160B,B00,834860,Twomey; Robert Daniel,12,0,15,3
1739706978430,VIS 160B,C00,834861,Alexander; Amy J,13,0,15,2
1739706979454,VIS 164,A00,834867,Sprague; Sean Jeffrey,21,0,22,1
1739706979454,VIS 164,B00,834868,Zurita; Dmitri,22,0,22,0
1739706980480,VIS 167,A00,835011,Staff,22,0,22,0
1739706981507,VIS 168,A00,835015,Zurita; Dmitri,21,0,22,1
1739706982532,VIS 169A,A00,881456,Cross; Brian R,21,0,22,1
1739706983558,VIS 171,A00,835016,Cross; Brian R,20,0,22,2
1739706984583,VIS 172,A00,835090,Trigilio; Michael,20,0,22,2
1739706985610,VIS 174,A00,835102,Stone; Patricia,18,0,22,4
1739706985610,VIS 174,B00,835113,Zurita; Dmitri,21,0,22,1
1739706986634,VIS 177,A00,835114,Crandall; Jordan,22,0,22,0
1739706987659,VIS 179,A00,835118,Segade; Alexandro Abraham,22,0,22,0
1739706988687,VIS 180A,A00,835120,Dinco; Dino,22,0,22,0
1739706989711,VIS 180B,A00,835121,Miller; Nicole L,21,0,22,1
1739706990735,VIS 182,A00,835141,Dinco; Dino,17,0,22,5
1739706991761,VIS 185,A00,835142,Miller; Nicole L,22,0,22,0
1739706992785,VIS 190,A00,835143,Dominguez; Ricardo,15,0,15,0
1739706992785,VIS 190,B00,835144,D'Elena-Tweed; Jessica Erin,13,0,15,2
1739706992785,VIS 190,C00,835146,Yoldas; Pinar,15,0,15,0
1739706993808,VIS 202,A00,835148,Garnett; Mariah J,12,0,15,3
1739706994834,VIS 203,A00,835149,Iglesias; Janelle Ann,9,0,15,6
1739706995858,VIS 206,A00,835150,Kester; Grant,9,0,15,6
1739706996884,VIS 208,A00,835151,Moss; Ceci,15,0,15,0
1739706997910,VIS 211,A00,871767,Dean; Danielle Adobi,4,0,15,11
1739706998935,VIS 220,A00,835152,Williams; Alena J,11,0,15,4
1739706999962,VIS 258,A00,835153,Shen; Kuiyi,11,0,15,4
1739707000989,WCWP 10A,001,833211,Dhir; Simrita,20,0,20,0
1739707000989,WCWP 10A,002,833218,Dhir; Simrita,19,0,20,1
1739707000989,WCWP 10A,003,833221,Staff,0,0,0,0
1739707000989,WCWP 10A,006,833232,Susi; Natalie,0,0,0,0
1739707000989,WCWP 10A,011,833250,Staff,0,0,0,0
1739707000989,WCWP 10A,012,833255,Windham; Emily,18,0,20,2
1739707000989,WCWP 10A,013,833258,Windham; Emily,14,0,20,6
1739707000989,WCWP 10A,014,833259,Holloway Ii; Mathew,19,0,20,1
1739707000989,WCWP 10A,015,833261,Windham; Emily,17,0,20,3
1739707000989,WCWP 10A,016,833262,Holloway Ii; Mathew,20,0,20,0
1739707000989,WCWP 10A,017,833263,Holloway Ii; Mathew,20,0,20,0
1739707000989,WCWP 10A,018,872017,Escobar; Jordan Christophe,20,0,20,0
1739707000989,WCWP 10A,019,872087,Escobar; Jordan Christophe,19,0,20,1
1739707000989,WCWP 10A,020,872122,Escobar; Jordan Christophe,19,0,20,1
1739707000989,WCWP 10A,021,872361,Martiniuk; Jill,20,0,20,0
1739707000989,WCWP 10A,022,872362,Martiniuk; Jill,20,0,20,0
1739707000989,WCWP 10A,023,872364,Martiniuk; Jill,20,0,20,0
1739707000989,WCWP 10A,024,872365,Welji; Haleema Nazir,0,0,0,0
1739707002021,WCWP 10B,003,833318,Merryman; Walter,20,0,20,0
1739707002021,WCWP 10B,005,833340,Merryman; Walter,19,0,20,1
1739707002021,WCWP 10B,006,833342,Merryman; Walter,18,0,20,2
1739707002021,WCWP 10B,007,833358,Staff,0,0,0,0
1739707002021,WCWP 10B,008,833359,Ornelas; Tricia,18,0,20,2
1739707002021,WCWP 10B,009,833364,Ornelas; Tricia,16,0,20,4
1739707002021,WCWP 10B,010,833371,Uriarte; Emma,9,0,20,11
1739707002021,WCWP 10B,011,833378,Gagnon; Jeffrey C,0,0,0,0
1739707002021,WCWP 10B,012,833395,Uriarte; Emma,17,0,20,3
1739707002021,WCWP 10B,013,833397,Uriarte; Emma,13,0,20,7
1739707002021,WCWP 10B,014,833398,Staff,0,0,0,0
1739707002021,WCWP 10B,019,833421,Staff,0,0,0,0
1739707002021,WCWP 10B,020,833422,Staff,0,0,0,0
1739707002021,WCWP 10B,021,833423,Staff,0,0,0,0
1739707002021,WCWP 10B,022,833455,Gagnon; Jeffrey C,15,0,16,1
1739707002021,WCWP 10B,023,833489,Gagnon; Jeffrey C,14,0,16,2
1739707002021,WCWP 10B,024,833614,Staff,0,0,0,0
1739707002021,WCWP 10B,025,833615,Gagnon; Jeffrey C,15,0,16,1
1739707002021,WCWP 10B,026,833635,Gagnon; Jeffrey C,16,0,16,0
1739707002021,WCWP 10B,027,833667,Staff,0,0,0,0
1739707002021,WCWP 10B,028,874686,Gagnon; Jeffrey C,14,0,16,2
1739707002021,WCWP 10B,029,874687,Gagnon; Jeffrey C,15,0,16,1
1739707003051,WCWP 100,A00,833668,McCleary; Keith Long,20,0,20,0
1739707003051,WCWP 100,B00,833669,McCleary; Keith Long,19,0,20,1
1739707003051,WCWP 100,C00,833673,Twohig; Niall Ivan,19,0,20,1
1739707003051,WCWP 100,D00,833677,Twohig; Niall Ivan,19,0,20,1
1739707003051,WCWP 100,E00,833678,Young; Mark T,18,0,20,2
1739707003051,WCWP 100,F00,833679,Young; Mark T,19,0,20,1
1739707004080,WES 207,A00,833201,Staff,20,0,20,0
1739707005105,WES 265,A00,833205,Staff,20,0,20,0
1739707007275,AAS 10R,A01,807278,Butler; Elizabeth Annette,28,0,34,6
1739707007275,AAS 10R,A02,807279,Butler; Elizabeth Annette,30,0,34,4
1739707008299,AAS 170R,A00,807281,Butler; Elizabeth Annette,26,0,28,2
1739707009324,AESE 261,A00,804942,Staff,30,0,30,0
1739707010357,AESE 278D,A00,804945,Staff,30,0,30,0
1739707011384,AESE 278E,A00,804981,Staff,30,0,30,0
1739707012409,AESE 279A,A00,804985,Staff,30,0,30,0
1739707013437,ANAR 100,A00,872378,Dunseth; Zachary Clark,19,0,20,1
1739707014464,ANAR 104,A01,803045,Shtienberg; Gilad,24,0,25,1
1739707014464,ANAR 104,A02,803066,Shtienberg; Gilad,0,0,0,0
1739707015489,ANAR 111,A00,803067,Dunseth; Zachary Clark,25,0,25,0
1739707016517,ANAR 138,A00,803079,Algaze; Guillermo,12,0,15,3
1739707017541,ANAR 155,A00,803081,Braswell; Geoffrey E.,19,0,25,6
1739707018566,ANBI 111,A00,803085,Staff,22,0,25,3
1739707019590,ANBI 116,A00,803087,Wilder; Linnea Lorene,149,0,150,1
1739707020617,ANBI 139,A00,870761,Gagneux; Pascal,137,0,145,8
1739707021644,ANBI 144,A00,803091,Wilder; Linnea Lorene,70,0,75,5
1739707022670,ANBI 149,A00,803093,Non; Amy L,19,0,20,1
1739707023695,ANBI 174,A00,803096,Strum; Shirley C.,15,0,15,0
1739707024719,ANES 296,001,866120,Suresh; Preetham John,4,0,5,1
1739707024719,ANES 296,002,866141,Staff,5,0,5,0
1739707024719,ANES 296,003,866168,Staff,5,0,5,0
1739707025747,ANSC 100,A00,803098,Bialecki; Jon Anthony,23,0,25,2
1739707025747,ANSC 100,B00,871150,Rabinowitz; Dan,20,0,20,0
1739707026772,ANSC 101,A00,803099,Sloane; Julia Kathryn,35,0,40,5
1739707027798,ANSC 117,A00,803100,Martin Sandino; Amanda Maria Yoland,16,0,18,2
1739707028821,ANSC 134,A00,803104,Petterson; John C.,25,0,25,0
1739707029848,ANSC 137,A00,803105,Stewart; Alexander B,39,0,40,1
1739707030876,ANSC 147,A00,803106,Stewart; Alexander B,36,0,40,4
1739707031900,ANSC 148,A00,803110,Schonberg; Jeffrey,45,0,46,1
1739707032928,ANSC 173,A00,803119,Brenner; Suzanne A,10,0,12,2
1739707033955,ANSC 180,A00,803121,Hankins; Joseph D.,22,0,25,3
1739707034979,ANSC 191,A00,803124,Yeh; Rihan Wen Xin,11,0,12,1
1739707036008,ANTH 2,A01,803000,Marchetto; Maria Carolina,32,0,33,1
1739707036008,ANTH 2,A02,803001,Marchetto; Maria Carolina,32,0,33,1
1739707036008,ANTH 2,A03,803005,Marchetto; Maria Carolina,30,0,33,3
1739707036008,ANTH 2,A04,803006,Marchetto; Maria Carolina,30,0,33,3
1739707036008,ANTH 2,A05,803007,Marchetto; Maria Carolina,33,0,33,0
1739707036008,ANTH 2,A06,803008,Marchetto; Maria Carolina,31,0,31,0
1739707037036,ANTH 3,A01,803012,Algaze; Guillermo,30,0,30,0
1739707037036,ANTH 3,A02,803013,Algaze; Guillermo,30,0,30,0
1739707037036,ANTH 3,A03,803015,Algaze; Guillermo,30,0,30,0
1739707037036,ANTH 3,A04,803016,Algaze; Guillermo,30,0,30,0
1739707038061,ANTH 4,A01,803020,Yeh; Rihan Wen Xin,27,0,30,3
1739707038061,ANTH 4,A02,803021,Yeh; Rihan Wen Xin,30,0,30,0
1739707038061,ANTH 4,A03,803022,Yeh; Rihan Wen Xin,30,0,30,0
1739707038061,ANTH 4,A04,803024,Yeh; Rihan Wen Xin,30,0,30,0
1739707039086,ANTH 10,A00,803025,Stewart; Alexander B,73,0,80,7
1739707040112,ANTH 21,A01,803027,Stone; Annika Britt,38,0,40,2
1739707040112,ANTH 21,A02,803030,Stone; Annika Britt,36,0,40,4
1739707040112,ANTH 21,A03,803031,Stone; Annika Britt,38,0,40,2
1739707040112,ANTH 21,A04,803032,Stone; Annika Britt,39,0,40,1
1739707041141,ANTH 23,A01,803034,Stone; Annika Britt,39,0,40,1
1739707041141,ANTH 23,A02,803036,Stone; Annika Britt,39,0,40,1
1739707041141,ANTH 23,A03,803037,Stone; Annika Britt,40,0,40,0
1739707041141,ANTH 23,A04,803038,Stone; Annika Britt,40,0,40,0
1739707042167,ANTH 87,A00,875928,Staff,20,0,20,0
1739707043192,ANTH 103,A00,803126,Hankins; Joseph D.,98,0,100,2
1739707044217,ANTH 105,A00,803130,Rabinowitz; Dan,73,0,75,2
1739707045300,ANTH 109,A00,803133,Staff,38,0,40,2
1739707046325,ANTH 110,A00,803135,Staff,15,0,20,5
1739707047349,ANTH 128B,A01,803139,Lewis; Leslie R,12,0,12,0
1739707048374,ANTH 196C,A00,803147,Varma; Saiba,20,0,20,0
1739707049401,ANTH 198,001,886925,Varma; Saiba,15,0,15,0
1739707050427,ANTH 200,A00,803150,Pedersen; David,15,0,15,0
1739707051452,ANTH 230,A00,889211,Gagneux; Pascal,17,0,20,3
1739707052476,ANTH 272,A00,803155,Gere; Catherina M.,9,0,10,1
1739707053503,ANTH 273,A00,803158,McKenzie; Kerry V.,10,0,10,0
1739707054530,ANTH 288,A00,803189,Braswell; Geoffrey E.,25,0,25,0
1739707055557,ANTH 295,001,887807,Algaze; Guillermo,3,0,3,0
1739707055557,ANTH 295,002,887809,Braswell; Geoffrey E.,3,0,3,0
1739707055557,ANTH 295,003,887890,Brenner; Suzanne A,3,0,3,0
1739707055557,ANTH 295,004,887891,Csordas; Thomas J.,3,0,3,0
1739707055557,ANTH 295,005,887909,Fox; Patrick Keolu Ozer,3,0,3,0
1739707055557,ANTH 295,006,887940,Gagneux; Pascal,3,0,3,0
1739707055557,ANTH 295,007,887941,Goldstein; Paul S,3,0,3,0
1739707055557,ANTH 295,008,887942,Hankins; Joseph D.,3,0,3,0
1739707055557,ANTH 295,009,887948,Jassal; Aftab,3,0,3,0
1739707055557,ANTH 295,010,887949,Jenkins; Janis A.,3,0,3,0
1739707055557,ANTH 295,011,887950,Jimenez Cano; Nayeli Guada,3,0,3,0
1739707055557,ANTH 295,012,887951,Kaiser; Bronwyn Nicole,3,0,3,0
1739707055557,ANTH 295,013,887955,Kang; Byung Chu,3,0,3,0
1739707055557,ANTH 295,014,887957,Marchetto; Maria Carolina,3,0,3,0
1739707055557,ANTH 295,015,887960,Non; Amy L,3,0,3,0
1739707055557,ANTH 295,016,887961,Pedersen; David,3,0,3,0
1739707055557,ANTH 295,017,887962,Rivera-Collazo; Isabel C,3,0,3,0
1739707055557,ANTH 295,018,887963,Varma; Saiba,3,0,3,0
1739707055557,ANTH 295,019,887969,Yeh; Rihan Wen Xin,3,0,3,0
1739707056590,ANTH 296,001,888015,Braswell; Geoffrey E.,3,0,3,0
1739707056590,ANTH 296,002,888024,Marchetto; Maria Carolina,3,0,3,0
1739707056590,ANTH 296,003,888035,Rivera-Collazo; Isabel C,3,0,3,0
1739707056590,ANTH 296,004,888050,Varma; Saiba,3,0,3,0
1739707056590,ANTH 296,005,888055,Algaze; Guillermo,3,0,3,0
1739707056590,ANTH 296,006,888067,Brenner; Suzanne A,3,0,3,0
1739707056590,ANTH 296,007,888075,Csordas; Thomas J.,3,0,3,0
1739707056590,ANTH 296,008,888081,Fox; Patrick Keolu Ozer,3,0,3,0
1739707056590,ANTH 296,009,888084,Gagneux; Pascal,3,0,3,0
1739707056590,ANTH 296,010,888086,Goldstein; Paul S,2,0,3,1
1739707056590,ANTH 296,011,888089,Hankins; Joseph D.,3,0,3,0
1739707056590,ANTH 296,012,888093,Jassal; Aftab,3,0,3,0
1739707056590,ANTH 296,013,888095,Jenkins; Janis A.,3,0,3,0
1739707056590,ANTH 296,014,888099,Jimenez Cano; Nayeli Guada,3,0,3,0
1739707056590,ANTH 296,015,888101,Kaiser; Bronwyn Nicole,3,0,3,0
1739707056590,ANTH 296,016,888102,Kang; Byung Chu,3,0,3,0
1739707056590,ANTH 296,017,888106,Levy; Thomas E,3,0,3,0
1739707056590,ANTH 296,018,888109,Non; Amy L,3,0,3,0
1739707056590,ANTH 296,019,888111,Pedersen; David,3,0,3,0
1739707056590,ANTH 296,020,888112,Postero; Nancy Grey,3,0,3,0
1739707056590,ANTH 296,021,888116,Semendeferi; Ekaterini,3,0,3,0
1739707056590,ANTH 296,022,888118,Yeh; Rihan Wen Xin,3,0,3,0
1739707057615,ASTR 2,A01,803214,Nadler; Ethan Oliver,296,0,300,4
1739707058644,ASTR 15,A01,803221,Wright; Shelley Adams,47,0,50,3
1739707059672,ASTR 18,A01,803234,Arnold; Kam S,30,0,30,0
1739707060696,ASTR 60,A01,803300,Burgasser; Adam Jonathan,14,0,15,1
1739707060696,ASTR 60,A02,803301,Burgasser; Adam Jonathan,15,0,15,0
1739707060696,ASTR 60,A03,803302,Burgasser; Adam Jonathan,15,0,15,0
1739707060696,ASTR 60,A04,803303,Burgasser; Adam Jonathan,15,0,15,0
1739707061721,ASTR 87,A00,871154,Burgasser; Adam Jonathan,20,0,20,0
1739707062745,ASTR 103,A01,803305,Diamond; Patrick H,30,0,30,0
1739707063770,ASTR 106,A01,803307,Boggs; Steven Edward,30,0,30,0
1739707064801,ASTR 123,A01,803343,Keres; Dusan,35,0,39,4
1739707065828,ASTR 154,A01,803345,Hosseinzadeh; Griffin Alex,40,0,40,0
1739707066854,ASTR 211,A00,803346,Broekgaarden; Floor Suzan,12,0,15,3
1739707067879,ASTR 250,A00,803347,Theissen; Christopher Alexander & Hosseinzadeh; Griffin Alex,26,0,30,4
1739707068906,ASTR 251,A00,803359,Theissen; Christopher Alexander & Hosseinzadeh; Griffin Alex,28,0,30,2
1739707069930,AUD 236,A00,804989,Harris; Jeffrey Paul,5,0,5,0
1739707070959,AUD 260,A01,804994,Zettner; Erika,13,0,13,0
1739707071983,AUD 272,A00,804997,Zettner; Erika,13,0,13,0
1739707073007,AUD 275,A00,805001,Zettner; Erika,13,0,13,0
1739707074034,AUD 284,A00,805004,Zettner; Erika,13,0,13,0
1739707075062,AUD 291,A00,805008,Zettner; Erika,13,0,13,0
1739707076089,AUD 296,A00,805013,Zettner; Erika,6,0,6,0
1739707077114,AWP 3,001,802590,O'Neil; Courtney L,9,0,9,0
1739707077114,AWP 3,002,802591,O'Neil; Courtney L,9,0,9,0
1739707077114,AWP 3,003,802592,Kolodezh; Samuel,8,0,9,1
1739707077114,AWP 3,004,802593,Zimmerman; Guy,9,0,9,0
1739707077114,AWP 3,005,802594,Vaughn; Kelsey Sara,9,0,9,0
1739707077114,AWP 3,006,802595,Vaughn; Kelsey Sara,9,0,9,0
1739707077114,AWP 3,007,802597,Given; William Allan,9,0,9,0
1739707078138,AWP 4A,A00,802601,Ajo; Frances Margaret,10,0,10,0
1739707078138,AWP 4A,B00,802602,Ajo; Frances Margaret,9,0,10,1
1739707078138,AWP 4A,C00,880738,Bauer; Holly Jean,10,0,10,0
1739707079179,AWP 4B,001,802603,Steinberg; Stacy A,0,0,0,0
1739707079179,AWP 4B,002,802604,Steinberg; Stacy A,0,0,0,2
1739707079179,AWP 4B,003,802605,Gilmore; Lauren Monica,0,0,0,1
1739707079179,AWP 4B,004,802606,Gilmore; Lauren Monica,0,0,0,0
1739707079179,AWP 4B,007,802609,Bolin; Jillian,0,0,0,0
1739707079179,AWP 4B,008,802610,Bolin; Jillian,0,0,0,0
1739707079179,AWP 4B,009,802611,Zroka; Amy Liane,0,0,0,0
1739707079179,AWP 4B,010,802612,Zroka; Amy Liane,0,0,0,0
1739707079179,AWP 4B,011,802614,Christie; Veronica Ann,0,0,0,0
1739707079179,AWP 4B,012,802672,Christie; Veronica Ann,0,0,0,0
1739707079179,AWP 4B,013,802673,Jones; William Jadie,0,0,0,0
1739707079179,AWP 4B,014,802676,Jones; William Jadie,0,0,0,1
1739707079179,AWP 4B,015,802677,Heiser; Jerrod A,0,0,0,0
1739707079179,AWP 4B,016,802679,Heiser; Jerrod A,0,0,0,1
1739707079179,AWP 4B,017,802683,Bourdeau; Joseph Albert,0,0,0,0
1739707079179,AWP 4B,018,802684,Bourdeau; Joseph Albert,0,0,0,1
1739707079179,AWP 4B,019,802690,Wilson; Natalie Ann,0,0,0,0
1739707079179,AWP 4B,020,802691,Wilson; Natalie Ann,0,0,0,0
1739707079179,AWP 4B,021,802692,Stanton; Jennifer K,0,0,0,0
1739707079179,AWP 4B,022,802693,Stanton; Jennifer K,0,0,0,1
1739707079179,AWP 4B,023,802696,Riggle; Amanda L,0,0,0,1
1739707079179,AWP 4B,024,802699,Riggle; Amanda L,0,0,0,0
1739707079179,AWP 4B,025,802702,Homenick; Erik Christopher,0,0,0,0
1739707079179,AWP 4B,026,802703,Homenick; Erik Christopher,0,0,0,0
1739707079179,AWP 4B,027,802705,Ornelas Jr.; David Paul,0,0,0,0
1739707079179,AWP 4B,028,802706,Grant; Melinda G,0,0,0,0
1739707079179,AWP 4B,029,802707,Grant; Melinda G,0,0,0,0
1739707079179,AWP 4B,030,802708,Ornelas Jr.; David Paul,0,0,0,0
1739707079179,AWP 4B,031,802709,Falcon; Jennifer A,0,0,0,0
1739707079179,AWP 4B,032,802710,Falcon; Jennifer A,0,0,0,0
1739707079179,AWP 4B,033,802711,Westerfeld; Kevin John,0,0,0,0
1739707079179,AWP 4B,034,802712,Tiernan; Christa Michelle,0,0,0,0
1739707079179,AWP 4B,035,802714,Tiernan; Christa Michelle,0,0,0,0
1739707079179,AWP 4B,036,802980,Westerfeld; Kevin John,0,0,0,0
1739707079179,AWP 4B,038,802982,Gardella; Alexander Drew,0,0,0,0
1739707079179,AWP 4B,039,802983,Gardella; Alexander Drew,0,0,0,0
1739707079179,AWP 4B,040,802985,Coulter; Jane Elisabeth,0,0,0,0
1739707079179,AWP 4B,041,802986,Spicer; Jacqueline,0,0,0,0
1739707079179,AWP 4B,042,802987,Spicer; Jacqueline,0,0,0,0
1739707079179,AWP 4B,043,802989,Tsurska Svetina; Olena,0,0,0,0
1739707079179,AWP 4B,044,802990,Tsurska Svetina; Olena,0,0,0,1
1739707079179,AWP 4B,045,802991,Chandler; Bailee Daniele,0,0,0,0
1739707079179,AWP 4B,046,802993,Chandler; Bailee Daniele,0,0,0,1
1739707079179,AWP 4B,047,802994,Hall; Graham T,0,0,0,0
1739707079179,AWP 4B,048,802995,Hall; Graham T,0,0,0,0
1739707080205,AWP 10R,001,871136,Gocsik; Karen Marie,13,0,15,2
1739707081231,BENG 87,A00,886240,Sah; Robert Lie-Yuan,20,0,20,0
1739707081231,BENG 87,B00,886257,Sah; Robert Lie-Yuan,20,0,20,0
1739707082256,BENG 100,A01,805026,Alexandrov; Ludmil B,30,0,30,0
1739707082256,BENG 100,A02,805028,Alexandrov; Ludmil B,29,0,30,1
1739707082256,BENG 100,A03,805030,Alexandrov; Ludmil B,30,0,30,0
1739707082256,BENG 100,A04,805031,Alexandrov; Ludmil B,29,0,30,1
1739707083280,BENG 102,A00,805032,Chapelin; Fanny,52,0,56,4
1739707084306,BENG 103B,A00,805039,Fraley; Stephanie I.,116,0,120,4
1739707085329,BENG 112B,A01,805055,Shi; Lingyan,22,0,23,1
1739707085329,BENG 112B,A02,805056,Shi; Lingyan,20,0,23,3
1739707086355,BENG 125,A01,805058,Hasty; Jeff M,14,0,32,18
1739707086355,BENG 125,A02,805059,Hasty; Jeff M,31,0,32,1
1739707086355,BENG 125,A03,805060,Hasty; Jeff M,31,0,32,1
1739707086355,BENG 125,A04,805102,Hasty; Jeff M,32,0,32,0
1739707086355,BENG 125,A05,805109,Hasty; Jeff M,19,0,32,13
1739707087382,BENG 130,A00,805118,Kravets; Vira V.,37,0,40,3
1739707088409,BENG 134,A01,805171,Smarr; Benjamin,34,0,40,6
1739707089433,BENG 140B,A01,805175,Cabrales; Pedro,27,0,30,3
1739707089433,BENG 140B,A02,805176,Cabrales; Pedro,29,0,30,1
1739707089433,BENG 140B,A03,805177,Cabrales; Pedro,28,0,30,2
1739707090461,BENG 160,A50,805180,Aguado; Brian Alberto,18,0,25,7
1739707090461,BENG 160,A51,805181,Aguado; Brian Alberto,23,0,25,2
1739707090461,BENG 160,A52,805182,Aguado; Brian Alberto,25,0,25,0
1739707091488,BENG 168,A01,805184,Khojah; Reem I,30,0,30,0
1739707092514,BENG 172,A50,805187,Cabrales; Pedro & Sah; Robert Lie-Yuan,13,0,20,7
1739707092514,BENG 172,A51,805188,Cabrales; Pedro & Sah; Robert Lie-Yuan,19,0,20,1
1739707093539,BENG 182,A01,805190,Bafna; Vineet,29,0,35,6
1739707094567,BENG 186A,A01,805192,Kwon; Ester Jihae,0,0,25,25
1739707094567,BENG 186A,A02,805193,Kwon; Ester Jihae,23,0,25,2
1739707094567,BENG 186A,A04,805195,Kwon; Ester Jihae,17,0,25,8
1739707095590,BENG 186B,A01,805230,Aran; Kiana,39,0,40,1
1739707096614,BENG 187A,A00,805231,Taylor Amos; Alyssa C,152,0,170,18
1739707097638,BENG 187D,A00,805243,Taylor Amos; Alyssa C,34,0,60,26
1739707097638,BENG 187D,B00,805249,Taylor Amos; Alyssa C,50,0,60,10
1739707097638,BENG 187D,C00,805286,Taylor Amos; Alyssa C,41,0,60,19
1739707098663,BENG 190,A00,872568,Khojah; Reem I,24,0,40,16
1739707099687,BENG 193,A00,805288,Engler; Adam J.,0,0,0,0
1739707100714,BENG 196,A00,803380,Engler; Adam J.,9999,0,9999,0
1739707101742,BENG 197,A00,803381,Engler; Adam J.,9999,0,9999,0
1739707102767,BENG 203,A00,805307,Bafna; Vineet & Zhong; Sheng,20,0,20,0
1739707103792,BENG 207,A00,805308,Kwon; Ester Jihae,1,0,40,39
1739707103792,BENG 207,B00,805309,Taylor Amos; Alyssa C,0,0,30,30
1739707103792,BENG 207,C00,805310,Spang; Martin Thomas,15,0,40,25
1739707104819,BENG 209,A00,805311,Scholtes Acevedo; Claire,30,0,30,0
1739707105845,BENG 213,A00,805312,Palsson; Bernhard O.,16,0,20,4
1739707106872,BENG 224,A00,805313,Prado; Gustavo Rotelli,0,0,20,30
1739707107898,BENG 226,A01,805315,Staff,74,0,140,66
1739707108925,BENG 227,A00,805316,Fraley; Stephanie I.,42,0,120,78
1739707109952,BENG 230C,A00,805318,King; Kevin R,59,0,90,31
1739707110980,BENG 232,A01,805320,Sah; Robert Lie-Yuan,16,0,70,54
1739707112008,BENG 233,A00,805364,Shah; Sameer B,21,0,50,29
1739707113033,BENG 234,A00,805365,Silva; Gabriel,22,0,70,48
1739707114061,BENG 235,A00,805366,Bintu; Bogdan,18,0,40,22
1739707115089,BENG 276,A00,805367,Mc Culloch; Andrew Douglas,0,0,0,0
1739707116113,BENG 280C,A01,805370,McVeigh; Elliot R.,37,0,56,19
1739707117139,BENG 281,A00,805371,Smarr; Benjamin,40,0,110,70
1739707118168,BENG 283,A00,805372,Ghassemian; Majid & Sanchez Roige; Alexandra & Chavez; Alejandro,5,0,5,0
1739707119194,BENG 285,A00,805374,Alexandrov; Ludmil B,8,0,8,0
1739707120218,BENG 292,A01,805387,Ross; Camille,20,0,20,0
1739707121245,BENG 294C,A00,805396,Engler; Adam J.,0,0,0,0
1739707122270,BENG 295,A00,803924,Watson; John Thomas,9999,0,9999,0
1739707123293,BGGN 205,A00,851551,Daugherty; Matthew Dorton,53,0,60,7
1739707124319,BGGN 207,A01,851553,Ross; Camille,0,0,0,0
1739707125344,BGGN 215,A00,851554,Petrie; Katherine Lynn,0,0,30,30
1739707126369,BGGN 232,A00,851556,Briggs; Steven & Troemel; Emily Ruth,0,0,30,30
1739707127395,BGGN 239,A01,851558,Kronenberg; Mitchell E.,22,0,30,8
1739707128422,BGGN 240,A01,851560,Aoi; Mikio C,1,0,5,4
1739707128422,BGGN 240,A02,851561,Aoi; Mikio C,5,0,5,0
1739707128422,BGGN 240,A03,851562,Aoi; Mikio C,2,0,5,3
1739707128422,BGGN 240,A04,851564,Aoi; Mikio C,4,0,5,1
1739707129447,BGGN 249C,A00,851566,Miller; Cory T.,0,0,0,0
1739707130475,BGGN 255,A00,851567,Root; Cory Matthew,9,0,30,21
1739707131502,BGGN 267,A01,851569,Benna; Marcus K & Aljadeff; Johnatan,0,0,2,2
1739707131502,BGGN 267,A02,851570,Benna; Marcus K & Aljadeff; Johnatan,2,0,2,0
1739707131502,BGGN 267,A03,851571,Benna; Marcus K & Aljadeff; Johnatan,1,0,1,0
1739707131502,BGGN 267,A04,851572,Benna; Marcus K & Aljadeff; Johnatan,1,0,1,0
1739707132538,BGGN 271,001,881551,Ackerman; Susan,9999,0,9999,0
1739707132538,BGGN 271,002,881552,Akbari; Omar Sultan,9997,0,9999,2
1739707132538,BGGN 271,003,881553,Allen; Nicola J,9998,0,9999,1
1739707132538,BGGN 271,004,881554,Alperin; Mariann,9998,0,9999,1
1739707132538,BGGN 271,005,881555,Antal; Corina Elena,9999,0,9999,0
1739707132538,BGGN 271,006,881561,Boss; Gerard R.,9998,0,9999,1
1739707132538,BGGN 271,007,881562,Bouvet; Michael,9999,0,9999,0
1739707132538,BGGN 271,008,881563,Breen; Ellen C.,9999,0,9999,0
1739707132538,BGGN 271,009,881564,Bui; Jack D,9999,0,9999,0
1739707132538,BGGN 271,010,881565,Burnett; Lindsey,9998,0,9999,1
1739707132538,BGGN 271,011,881566,Caffrey; Conor,9998,0,9999,1
1739707132538,BGGN 271,012,881567,Castle; Michael James,9998,0,9999,1
1739707132538,BGGN 271,013,881568,Chang; John Tzu-yu,9999,0,9999,0
1739707132538,BGGN 271,014,881569,Cheng; Christine Shiang-Ling,9999,0,9999,0
1739707132538,BGGN 271,015,881612,Cheresh; David A.,9997,0,9999,2
1739707132538,BGGN 271,016,881616,Cherqui; Stephanie,9999,0,9999,0
1739707132538,BGGN 271,017,881620,Chu; Hiutung,9998,0,9999,1
1739707132538,BGGN 271,018,881627,Church; Kellie Breen,9999,0,9999,0
1739707132538,BGGN 271,019,881637,Cleland; Elsa Eleanor,9998,0,9999,1
1739707132538,BGGN 271,020,881638,Croker; Ben Adam,9999,0,9999,0
1739707132538,BGGN 271,021,881639,Crotty Alexander; Laura E,9997,0,9999,2
1739707132538,BGGN 271,022,881640,Daugherty; Matthew Dorton,9999,0,9999,0
1739707132538,BGGN 271,023,881641,De Silva; Shermin,9998,0,9999,1
1739707132538,BGGN 271,024,881642,Dhar; Debanjan,9999,0,9999,0
1739707132538,BGGN 271,025,881643,Doherty; Taylor Alan,9998,0,9999,1
1739707132538,BGGN 271,026,881644,Dore; Kim Bohemie,9998,0,9999,1
1739707132538,BGGN 271,027,881645,Dulawa; Stephanie Carole,9999,0,9999,0
1739707132538,BGGN 271,028,881646,Farley; Emma Kristen,9998,0,9999,1
1739707132538,BGGN 271,029,881647,Feng; Gen-Sheng,9998,0,9999,1
1739707132538,BGGN 271,030,881648,Fisch; Kathleen Marie,9995,0,9999,4
1739707132538,BGGN 271,031,881649,George; Olivier,9998,0,9999,1
1739707132538,BGGN 271,032,881650,Ghosh; Pradipta,9998,0,9999,1
1739707132538,BGGN 271,033,881651,Glasgow; Stacey Marie,9997,0,9999,2
1739707132538,BGGN 271,034,881652,Golden; James W,9999,0,9999,0
1739707132538,BGGN 271,035,881653,Gonzalez Gamboa; Ivonne,9999,0,9999,0
1739707132538,BGGN 271,036,881654,Goren; Alon M,9999,0,9999,0
1739707132538,BGGN 271,037,881655,Guatelli; John C,9998,0,9999,1
1739707132538,BGGN 271,038,881656,Guma; Monica,9999,0,9999,0
1739707132538,BGGN 271,039,881657,Gustafsson; Asa Birgitta,9998,0,9999,1
1739707132538,BGGN 271,040,881658,Hamdoun; Amr,9999,0,9999,0
1739707132538,BGGN 271,041,881659,Hao; Nan,9999,0,9999,0
1739707132538,BGGN 271,042,881660,Hasty; Jeff M,9998,0,9999,1
1739707132538,BGGN 271,043,881661,Jiang; Qingfei,9999,0,9999,0
1739707132538,BGGN 271,044,881664,Jin; Yishi,9998,0,9999,1
1739707132538,BGGN 271,045,881665,Joiner; William J.,9999,0,9999,0
1739707132538,BGGN 271,046,881666,Joshi; Shweta,9998,0,9999,1
1739707132538,BGGN 271,047,881667,Ju; Won-Kyu,9998,0,9999,1
1739707132538,BGGN 271,048,881668,Jun; Suckjoon,9999,0,9999,0
1739707132538,BGGN 271,049,881669,Kaech; Susan Michelle,9999,0,9999,0
1739707132538,BGGN 271,050,881670,Kauffman; Alexander,9997,0,9999,2
1739707132538,BGGN 271,051,881672,Koloski; Miranda Jane,9998,0,9999,1
1739707132538,BGGN 271,052,881673,Komiyama; Takaki,9998,0,9999,1
1739707132538,BGGN 271,053,881674,Kronenberg; Mitchell E.,9999,0,9999,0
1739707132538,BGGN 271,054,881675,Kufareva; Irina,9998,0,9999,1
1739707132538,BGGN 271,055,881676,Lee; Yun Sok,9999,0,9999,0
1739707132538,BGGN 271,056,881677,Leutgeb; Stefan,9999,0,9999,0
1739707132538,BGGN 271,057,881678,Li; Willis Xiaowei,9998,0,9999,1
1739707132538,BGGN 271,058,881679,Lim; Byungkook,9999,0,9999,0
1739707132538,BGGN 271,059,881680,Lo; Stanley M.,9998,0,9999,1
1739707132538,BGGN 271,060,881681,Lopez Ramirez; Miguel Alej,9999,0,9999,0
1739707132538,BGGN 271,061,881740,Lu; Li-Fan,9999,0,9999,0
1739707132538,BGGN 271,062,881741,Lu; Pengzhe,9998,0,9999,1
1739707132538,BGGN 271,063,881743,Lyons; Deirdre Colleen,9998,0,9999,1
1739707132538,BGGN 271,064,881744,Lyumkis; Dmitry Evgenievich,9999,0,9999,0
1739707132538,BGGN 271,065,881746,McConville; Patrick James,9999,0,9999,0
1739707132538,BGGN 271,066,881749,Mertens; Jerome Stefan,9997,0,9999,2
1739707132538,BGGN 271,067,881751,Morris; Gerald P,9999,0,9999,0
1739707132538,BGGN 271,068,881752,Muroyama; Andrew David,9999,0,9999,0
1739707132538,BGGN 271,069,881757,Murre; Cornelis,9999,0,9999,0
1739707132538,BGGN 271,070,881758,Nieh; James Charles,9997,0,9999,2
1739707132538,BGGN 271,071,881759,Niwa; Maho,9999,0,9999,0
1739707132538,BGGN 271,072,881760,Parast; Mana,9999,0,9999,0
1739707132538,BGGN 271,073,881761,Perry; Michael William,9999,0,9999,0
1739707132538,BGGN 271,074,881762,Pillus; Lorraine,9998,0,9999,1
1739707132538,BGGN 271,075,881765,Pogliano; Joseph,9998,0,9999,1
1739707132538,BGGN 271,076,881767,Pruneda-Paz; Jose L.,9999,0,9999,0
1739707132538,BGGN 271,077,881768,Rana; Tariq,9999,0,9999,0
1739707132538,BGGN 271,078,881769,Rao; Anjana,9999,0,9999,0
1739707132538,BGGN 271,079,881771,Raz; Eyal,9998,0,9999,1
1739707132538,BGGN 271,080,881772,Ren; Bing,9999,0,9999,0
1739707132538,BGGN 271,081,881775,Rifkin; Scott,9998,0,9999,1
1739707132538,BGGN 271,082,881777,Risbrough; Victoria Blythe,9999,0,9999,0
1739707132538,BGGN 271,083,881778,Rose; Noah Hartmann,9999,0,9999,0
1739707132538,BGGN 271,084,881779,Saier; Milton H.,9998,0,9999,1
1739707132538,BGGN 271,085,881781,Saltiel; Alan,9997,0,9999,2
1739707132538,BGGN 271,086,881782,Sanchez-Lopez; Elsa,9998,0,9999,1
1739707132538,BGGN 271,087,881784,Schroeder; Julian I,9999,0,9999,0
1739707132538,BGGN 271,088,881794,Sebat; Lilia Mikhailovna,9998,0,9999,1
1739707132538,BGGN 271,089,881796,Sen; George L,9999,0,9999,0
1739707132538,BGGN 271,090,881797,Shaner; Nathan C.,9999,0,9999,0
1739707132538,BGGN 271,091,881804,Shurin; Jonathan,9998,0,9999,1
1739707132538,BGGN 271,092,881819,Sicklick; Jason Keith,9999,0,9999,0
1739707132538,BGGN 271,093,881908,Signer; Robert,9999,0,9999,0
1739707132538,BGGN 271,094,881909,Simonson; Tatum Sasha Summ,9999,0,9999,0
1739707132538,BGGN 271,095,881923,Steinmetz; Nicole F,9999,0,9999,0
1739707132538,BGGN 271,096,881924,Su; Chih-Ying,9999,0,9999,0
1739707132538,BGGN 271,097,881936,Telese; Francesca,9999,0,9999,0
1739707132538,BGGN 271,098,881955,Towers; Christina Garlingt,9998,0,9999,1
1739707132538,BGGN 271,099,881956,Wahlin; Karl Jonas,9997,0,9999,2
1739707132538,BGGN 271,100,882046,Webster; Nicholas J G,9998,0,9999,1
1739707132538,BGGN 271,101,882047,Weiskopf; Daniela,9999,0,9999,0
1739707132538,BGGN 271,102,882130,Welsbie; Derek,9999,0,9999,0
1739707132538,BGGN 271,103,882167,Wildonger; Jill Cathleen,9999,0,9999,0
1739707132538,BGGN 271,104,882168,Yeo; Eugene Wei-Ming,9998,0,9999,1
1739707132538,BGGN 271,105,882175,Ying; Wei,9998,0,9999,1
1739707132538,BGGN 271,106,882196,Young; Jared W.,9998,0,9999,1
1739707132538,BGGN 271,107,882235,Zage; Peter,9999,0,9999,0
1739707132538,BGGN 271,108,882236,Zengler; Karsten B,9999,0,9999,0
1739707132538,BGGN 271,109,882237,Zhang; Jin,9999,0,9999,0
1739707132538,BGGN 271,110,882238,Zhao; Yunde,9999,0,9999,0
1739707132538,BGGN 271,111,882239,Zheng; Ye,9998,0,9999,1
1739707132538,BGGN 271,112,882288,Zhou; Huilin,9999,0,9999,0
1739707132538,BGGN 271,113,882289,Zou; Yimin,9998,0,9999,1
1739707132538,BGGN 271,114,882290,Zuniga; Elina I,9999,0,9999,0
1739707133567,BGGN 273,A01,851574,Mueller; Liam O'Connor,13,0,50,37
1739707134592,BGGN 275,A00,851577,Flagg; Matthew Paul,0,0,0,5
1739707135620,BGGN 276,A00,851578,Flagg; Matthew Paul,0,0,0,5
1739707136646,BGGN 292,A00,851579,Shiau; Andrew K,35,0,35,0
1739707137673,BGGN 293,A00,851580,Wilhelm; James E.,0,0,0,5
1739707138697,BGGN 295,A00,851581,Juavinett; Ashley Lauren,0,0,30,30
1739707139720,BGJC 204,A00,851584,Lu; Li-Fan & Chang; John Tzu-yu,9991,0,9999,8
1739707140817,BGRD 200,001,883698,Ackerman; Susan,9999,0,9999,0
1739707140817,BGRD 200,002,883700,Akbari; Omar Sultan,9998,0,9999,1
1739707140817,BGRD 200,003,883710,Allen; Eric,9999,0,9999,0
1739707140817,BGRD 200,004,883736,Allen; Nicola J,9998,0,9999,1
1739707140817,BGRD 200,005,883737,Alperin; Mariann,9998,0,9999,1
1739707140817,BGRD 200,006,883765,Amaro; Rommie E,9999,0,9999,0
1739707140817,BGRD 200,007,883766,Antal; Corina Elena,9999,0,9999,0
1739707140817,BGRD 200,008,883827,Asahina; Kenta,9999,0,9999,0
1739707140817,BGRD 200,009,883879,Augustine; Vineet,9999,0,9999,0
1739707140817,BGRD 200,010,883881,Ayres; Janelle Samantha,9998,0,9999,1
1739707140817,BGRD 200,011,883883,Banghart; Matthew Ryan,9999,0,9999,0
1739707140817,BGRD 200,012,883884,Barton; Andrew David,9999,0,9999,0
1739707140817,BGRD 200,013,883886,Benna; Marcus K,9999,0,9999,0
1739707140817,BGRD 200,014,883887,Bennett; Eric J,9998,0,9999,1
1739707140817,BGRD 200,015,883888,Biering; Scott B,9999,0,9999,0
1739707140817,BGRD 200,016,883890,Bloodgood; Brenda Laurie,9999,0,9999,0
1739707140817,BGRD 200,017,883891,Boss; Gerard R.,9999,0,9999,0
1739707140817,BGRD 200,018,883893,Bouvet; Michael,9999,0,9999,0
1739707140817,BGRD 200,019,883894,Breen; Ellen C.,9999,0,9999,0
1739707140817,BGRD 200,020,883895,Briggs; Steven,9999,0,9999,0
1739707140817,BGRD 200,021,883896,Bui; Jack D,9999,0,9999,0
1739707140817,BGRD 200,022,883897,Burnett; Lindsey,9998,0,9999,1
1739707140817,BGRD 200,023,883899,Caffrey; Conor,9998,0,9999,1
1739707140817,BGRD 200,024,883908,Callaway; Edward M,9999,0,9999,0
1739707140817,BGRD 200,025,883911,Castle; Michael James,9999,0,9999,0
1739707140817,BGRD 200,026,883915,Chaim; Isaac,9998,0,9999,1
1739707140817,BGRD 200,027,883916,Chang; John Tzu-yu,9999,0,9999,0
1739707140817,BGRD 200,028,883917,Chen; Xu,9999,0,9999,0
1739707140817,BGRD 200,029,883919,Cheng; Christine Shiang-Ling,9999,0,9999,0
1739707140817,BGRD 200,030,883921,Cheresh; David A.,9997,0,9999,2
1739707140817,BGRD 200,031,883924,Cherqui; Stephanie,9999,0,9999,0
1739707140817,BGRD 200,032,883929,Chu; Hiutung,9998,0,9999,1
1739707140817,BGRD 200,033,883931,Church; Kellie Breen,9999,0,9999,0
1739707140817,BGRD 200,034,883933,Cleland; Elsa Eleanor,9998,0,9999,1
1739707140817,BGRD 200,035,883934,Cooper; Kimberly Lynn,9999,0,9999,0
1739707140817,BGRD 200,036,883935,Coufal; Nicole Gabriele,9999,0,9999,0
1739707140817,BGRD 200,037,883938,Croker; Ben Adam,9999,0,9999,0
1739707140817,BGRD 200,038,883939,Crotty Alexander; Laura E,9997,0,9999,2
1739707140817,BGRD 200,039,883940,Daugherty; Matthew Dorton,9999,0,9999,0
1739707140817,BGRD 200,040,883941,De Silva; Shermin,9998,0,9999,1
1739707140817,BGRD 200,041,883946,Desai; Arshad,9999,0,9999,0
1739707140817,BGRD 200,042,883949,Dhar; Debanjan,9999,0,9999,0
1739707140817,BGRD 200,043,883993,Dickinson; Alexandra Jazz,9999,0,9999,0
1739707140817,BGRD 200,044,884003,Dixon; Jesse,9999,0,9999,0
1739707140817,BGRD 200,045,884008,Doherty; Taylor Alan,9998,0,9999,1
1739707140817,BGRD 200,046,884028,Dore; Kim Bohemie,9998,0,9999,1
1739707140817,BGRD 200,047,884082,Dulawa; Stephanie Carole,9999,0,9999,0
1739707140817,BGRD 200,048,884084,Ecker; Joseph R,9999,0,9999,0
1739707140817,BGRD 200,049,884107,Engle; Dannielle D,9999,0,9999,0
1739707140817,BGRD 200,050,884337,Ernst; Andreas,9999,0,9999,0
1739707140817,BGRD 200,051,884338,Esko; Jeffrey D.,9999,0,9999,0
1739707140817,BGRD 200,052,884339,Farley; Emma Kristen,9998,0,9999,1
1739707140817,BGRD 200,053,884340,Feldstein; Ariel E,9999,0,9999,0
1739707140817,BGRD 200,054,884341,Feng; Gen-Sheng,9998,0,9999,1
1739707140817,BGRD 200,055,884342,Fisch; Kathleen Marie,9995,0,9999,4
1739707140817,BGRD 200,056,884343,Friedman; Rick Adam,9999,0,9999,0
1739707140817,BGRD 200,057,884344,Furnari; Frank,9999,0,9999,0
1739707140817,BGRD 200,058,884345,Gage; Fred H,9999,0,9999,0
1739707140817,BGRD 200,059,884346,George; Olivier,9998,0,9999,1
1739707140817,BGRD 200,060,884347,Ghosh; Pradipta,9998,0,9999,1
1739707140817,BGRD 200,061,884348,Glasgow; Stacey Marie,9997,0,9999,2
1739707140817,BGRD 200,062,884349,Glass; Christopher,9999,0,9999,0
1739707140817,BGRD 200,063,884350,Golden; James W,9999,0,9999,0
1739707140817,BGRD 200,064,884352,Golden; Susan S.,9999,0,9999,0
1739707140817,BGRD 200,065,884354,Gonzalez Gamboa; Ivonne,9999,0,9999,0
1739707140817,BGRD 200,066,884355,Goren; Alon M,9999,0,9999,0
1739707140817,BGRD 200,067,884356,Guatelli; John C,9998,0,9999,1
1739707140817,BGRD 200,068,884357,Guma; Monica,9999,0,9999,0
1739707140817,BGRD 200,069,884360,Gustafsson; Asa Birgitta,9998,0,9999,1
1739707140817,BGRD 200,070,884361,Gutkind; Jorge Silvio,9999,0,9999,0
1739707140817,BGRD 200,071,884362,Hamdoun; Amr,9999,0,9999,0
1739707140817,BGRD 200,072,884364,Hampton; Randolph Y.,9999,0,9999,0
1739707140817,BGRD 200,073,884367,Hao; Nan,9999,0,9999,0
1739707140817,BGRD 200,074,884368,Hargreaves; Diana Clare,9999,0,9999,0
1739707140817,BGRD 200,075,884369,Hasty; Jeff M,9998,0,9999,1
1739707140817,BGRD 200,076,884370,Hollern; Daniel Patrick,9999,0,9999,0
1739707140817,BGRD 200,077,884372,Holway; David A.,9999,0,9999,0
1739707140817,BGRD 200,078,884374,Huffaker; Alisa,9999,0,9999,0
1739707140817,BGRD 200,079,884375,Hui; Enfu,9999,0,9999,0
1739707140817,BGRD 200,080,884376,Hwa; Terence T.,9999,0,9999,0
1739707140817,BGRD 200,081,884377,Ideker; Trey,9999,0,9999,0
1739707140817,BGRD 200,082,884378,Jackrel; Sara,9998,0,9999,1
1739707140817,BGRD 200,083,884380,Jiang; Qingfei,9999,0,9999,0
1739707140817,BGRD 200,084,884382,Jin; Yishi,9998,0,9999,1
1739707140817,BGRD 200,085,884384,Joiner; William J.,9999,0,9999,0
1739707140817,BGRD 200,086,884385,Joshi; Shweta,9998,0,9999,1
1739707140817,BGRD 200,087,884386,Ju; Won-Kyu,9998,0,9999,1
1739707140817,BGRD 200,088,884387,Jun; Suckjoon,9999,0,9999,0
1739707140817,BGRD 200,089,884388,Kadonaga; James T,9999,0,9999,0
1739707140817,BGRD 200,090,884389,Kaech; Susan Michelle,9999,0,9999,0
1739707140817,BGRD 200,091,884391,Kauffman; Alexander,9997,0,9999,2
1739707140817,BGRD 200,092,884392,Kleinfeld; David,9999,0,9999,0
1739707140817,BGRD 200,093,884393,Knight; Robin,9999,0,9999,0
1739707140817,BGRD 200,094,884394,Koloski; Miranda Jane,9998,0,9999,1
1739707140817,BGRD 200,095,884395,Komiyama; Takaki,9998,0,9999,1
1739707140817,BGRD 200,096,884396,Kosuri; Pallav,9999,0,9999,0
1739707140817,BGRD 200,097,884397,Kronenberg; Mitchell E.,9999,0,9999,0
1739707140817,BGRD 200,099,884400,Kryazhimskiy; Sergey A,9999,0,9999,0
1739707140817,BGRD 200,100,884401,Kufareva; Irina,9998,0,9999,1
1739707140817,BGRD 200,101,884402,Lee; Kuo Fen,9999,0,9999,0
1739707140817,BGRD 200,102,884403,Lee; Yun Sok,9999,0,9999,0
1739707140817,BGRD 200,103,884404,Leutgeb; Jill K.,9999,0,9999,0
1739707140817,BGRD 200,104,884405,Leutgeb; Stefan,9999,0,9999,0
1739707140817,BGRD 200,105,884406,Li; Willis Xiaowei,9998,0,9999,1
1739707140817,BGRD 200,106,884407,Lim; Byungkook,9998,0,9999,1
1739707140817,BGRD 200,107,884410,Lo; Stanley M.,9998,0,9999,1
1739707140817,BGRD 200,108,884414,Looger; Loren Lee,9999,0,9999,0
1739707140817,BGRD 200,109,884415,Lopez Ramirez; Miguel Alej,9999,0,9999,0
1739707140817,BGRD 200,110,884416,Lovett-Barron; Matthew Rod,9999,0,9999,0
1739707140817,BGRD 200,111,884418,Lu; Li-Fan,9998,0,9999,1
1739707140817,BGRD 200,112,884419,Lu; Pengzhe,9998,0,9999,1
1739707140817,BGRD 200,113,884421,Lykke-Andersen; Jens,9999,0,9999,0
1739707140817,BGRD 200,114,884423,Lyons; Deirdre Colleen,9998,0,9999,1
1739707140817,BGRD 200,115,884424,Lyumkis; Dmitry Evgenievich,9999,0,9999,0
1739707140817,BGRD 200,116,884425,Manor; Uri,9999,0,9999,0
1739707140817,BGRD 200,117,884426,Mayfield; Stephen P.,9998,0,9999,1
1739707140817,BGRD 200,118,884427,McConville; Patrick James,9999,0,9999,0
1739707140817,BGRD 200,119,884428,McDonnell; Lisa Marie,9999,0,9999,0
1739707140817,BGRD 200,120,884429,Mertens; Jerome Stefan,9997,0,9999,2
1739707140817,BGRD 200,121,884430,Meyer; Justin Raymond,9999,0,9999,0
1739707140817,BGRD 200,122,884431,Morris; Gerald P,9999,0,9999,0
1739707140817,BGRD 200,123,884432,Mueller; Lena,9999,0,9999,0
1739707140817,BGRD 200,124,884433,Muotri; Alysson,9999,0,9999,0
1739707140817,BGRD 200,125,884434,Muroyama; Andrew David,9997,0,9999,2
1739707140817,BGRD 200,126,884435,Murre; Cornelis,9999,0,9999,0
1739707140817,BGRD 200,127,884436,Neal; Sonya E,9999,0,9999,0
1739707140817,BGRD 200,128,884438,Nieh; James Charles,9997,0,9999,2
1739707140817,BGRD 200,129,884441,Nimmerjahn; Axel,9999,0,9999,0
1739707140817,BGRD 200,130,884444,Niwa; Maho,9999,0,9999,0
1739707140817,BGRD 200,131,884445,Nizet; Victor F.,9998,0,9999,1
1739707140817,BGRD 200,132,884446,Oegema; Karen,9999,0,9999,0
1739707140817,BGRD 200,133,884447,Panda; Satchidananda,9999,0,9999,0
1739707140817,BGRD 200,134,884448,Parast; Mana,9999,0,9999,0
1739707140817,BGRD 200,135,884449,Pasquinelli; Amy,9998,0,9999,1
1739707140817,BGRD 200,136,884450,Pekkurnaz Banghart; Gulcin,9999,0,9999,0
1739707140817,BGRD 200,137,884451,Perry; Michael William,9999,0,9999,0
1739707140817,BGRD 200,138,884452,Pillus; Lorraine,9998,0,9999,1
1739707140817,BGRD 200,139,884454,Pogliano; Joseph,9998,0,9999,1
1739707140817,BGRD 200,140,884456,Pogliano; Kit J.,9999,0,9999,0
1739707140817,BGRD 200,141,884457,Pride; David Tevis,9999,0,9999,0
1739707140817,BGRD 200,142,884458,Pruneda-Paz; Jose L.,9999,0,9999,0
1739707140817,BGRD 200,143,884459,Ramanan; Deepshika,9998,0,9999,1
1739707140817,BGRD 200,144,884460,Rana; Tariq,9999,0,9999,0
1739707140817,BGRD 200,145,884461,Rao; Anjana,9999,0,9999,0
1739707140817,BGRD 200,146,884462,Raz; Eyal,9998,0,9999,1
1739707140817,BGRD 200,147,884464,Reck-Peterson; Samara L,9999,0,9999,0
1739707140817,BGRD 200,148,884468,Ren; Bing,9999,0,9999,0
1739707140817,BGRD 200,149,884469,Rennison; Diana,9999,0,9999,0
1739707140817,BGRD 200,150,884471,Reyes De Barboza; Nabora S,9999,0,9999,0
1739707140817,BGRD 200,151,884472,Rifkin; Scott,9998,0,9999,1
1739707140817,BGRD 200,152,884482,Risbrough; Victoria Blythe,9999,0,9999,0
1739707140817,BGRD 200,153,884484,Rivera; Fabian Chavez,9999,0,9999,0
1739707140817,BGRD 200,154,884486,Rohner; Patrick Thomas,9999,0,9999,0
1739707140817,BGRD 200,155,884488,Rose; Noah Hartmann,9999,0,9999,0
1739707140817,BGRD 200,156,884491,Rosenfeld; Michael G,9999,0,9999,0
1739707140817,BGRD 200,157,884493,Russell; Alistair B,9999,0,9999,0
1739707140817,BGRD 200,158,884494,Saier; Milton H.,9998,0,9999,1
1739707140817,BGRD 200,159,884496,Saltiel; Alan,9997,0,9999,2
1739707140817,BGRD 200,160,884498,Sanchez-Lopez; Elsa,9999,0,9999,0
1739707140817,BGRD 200,161,884502,Saphire; Erica Ollmann,9999,0,9999,0
1739707140817,BGRD 200,162,884504,Schroeder; Julian I,9999,0,9999,0
1739707140817,BGRD 200,163,884508,Sebat; Lilia Mikhailovna,9998,0,9999,1
1739707140817,BGRD 200,164,884510,Sen; George L,9999,0,9999,0
1739707140817,BGRD 200,165,884513,Shah; Sameer B,9999,0,9999,0
1739707140817,BGRD 200,166,884515,Shaner; Nathan C.,9999,0,9999,0
1739707140817,BGRD 200,167,884517,Sharpee; Tatyana,9999,0,9999,0
1739707140817,BGRD 200,168,884519,Shaw; Reuben,9998,0,9999,1
1739707140817,BGRD 200,169,884522,Shurin; Jonathan,9998,0,9999,1
1739707140817,BGRD 200,170,884524,Sicklick; Jason Keith,9999,0,9999,0
1739707140817,BGRD 200,171,884526,Signer; Robert,9999,0,9999,0
1739707140817,BGRD 200,172,884530,Simonson; Tatum Sasha Summ,9999,0,9999,0
1739707140817,BGRD 200,173,884533,Soncin; Francesca,9999,0,9999,0
1739707140817,BGRD 200,174,884535,Steinmetz; Nicole F,9999,0,9999,0
1739707140817,BGRD 200,175,884536,Su; Chih-Ying,9999,0,9999,0
1739707140817,BGRD 200,176,884537,Suel; Gurol Mehmet,9999,0,9999,0
1739707140817,BGRD 200,177,884538,Sun; Xin,9999,0,9999,0
1739707140817,BGRD 200,178,884540,Telese; Francesca,9999,0,9999,0
1739707140817,BGRD 200,179,884543,Towers; Christina Garlingt,9998,0,9999,1
1739707140817,BGRD 200,180,884544,Traver; David,9999,0,9999,0
1739707140817,BGRD 200,181,884545,Troemel; Emily Ruth,9999,0,9999,0
1739707140817,BGRD 200,182,884546,Valdez-Jasso; Daniela,9999,0,9999,0
1739707140817,BGRD 200,183,884549,Vijayanand; Pandurangan,9999,0,9999,0
1739707140817,BGRD 200,184,884552,Villa Rodriguez; Elizabeth,9999,0,9999,0
1739707140817,BGRD 200,185,884553,Wahlin; Karl Jonas,9997,0,9999,2
1739707140817,BGRD 200,186,884555,Wang; Jean Yin Jen,9998,0,9999,1
1739707140817,BGRD 200,187,884556,Webster; Nicholas J G,9998,0,9999,1
1739707140817,BGRD 200,188,884557,Welsbie; Derek,9999,0,9999,0
1739707140817,BGRD 200,189,884600,Wildonger; Jill Cathleen,9998,0,9999,1
1739707140817,BGRD 200,190,884644,Winzeler; Elizabeth A,9998,0,9999,1
1739707140817,BGRD 200,191,884686,Yaksh; Tony L.,9999,0,9999,0
1739707140817,BGRD 200,192,884695,Yelon; Deborah,9999,0,9999,0
1739707140817,BGRD 200,193,884698,Yeo; Eugene Wei-Ming,9998,0,9999,1
1739707140817,BGRD 200,194,884706,Ying; Wei,9998,0,9999,1
1739707140817,BGRD 200,195,884707,Young; Jared W.,9998,0,9999,1
1739707140817,BGRD 200,196,884737,Zage; Peter,9999,0,9999,0
1739707140817,BGRD 200,197,884740,Zengler; Karsten B,9999,0,9999,0
1739707140817,BGRD 200,198,884749,Zhang; Dong-Er,9999,0,9999,0
1739707140817,BGRD 200,199,884750,Zhang; Jin,9999,0,9999,0
1739707140817,BGRD 200,200,884751,Zhao; Yunde,9999,0,9999,0
1739707140817,BGRD 200,201,884766,Zheng; Binhai,9999,0,9999,0
1739707140817,BGRD 200,202,884774,Zheng; Ye,9998,0,9999,1
1739707140817,BGRD 200,203,884849,Zhou; Huilin,9999,0,9999,0
1739707140817,BGRD 200,204,884894,Zou; Yimin,9998,0,9999,1
1739707140817,BGRD 200,205,884895,Zuniga; Elina I,9999,0,9999,0
1739707141842,BGSE 200,A00,851586,Tour; Ella & Petrie; Katherine Lynn,9989,0,9999,10
1739707142873,BGSE 205,A00,851588,Bennett; Eric J,46,0,50,4
1739707142873,BGSE 205,C00,851589,Bennett; Eric J,43,0,50,7
1739707142873,BGSE 205,D00,851590,Bennett; Eric J,48,0,50,2
1739707142873,BGSE 205,E00,851591,Bennett; Eric J,49,0,50,1
1739707143898,BIBC 102,A01,864157,Hampton; Randolph Y.,48,0,73,25
1739707143898,BIBC 102,A02,864159,Hampton; Randolph Y.,66,0,73,7
1739707143898,BIBC 102,A03,864171,Hampton; Randolph Y.,69,0,73,4
1739707143898,BIBC 102,A04,864227,Hampton; Randolph Y.,63,0,73,10
1739707144924,BIBC 103,A01,850483,Coleman; Aaron B.,19,0,24,5
1739707144924,BIBC 103,A02,850484,Coleman; Aaron B.,24,0,24,0
1739707144924,BIBC 103,B01,850487,Coleman; Aaron B.,21,0,24,3
1739707144924,BIBC 103,B02,850489,Coleman; Aaron B.,24,0,24,0
1739707144924,BIBC 103,C01,850492,Burg; Michael,15,0,24,9
1739707144924,BIBC 103,C02,850493,Burg; Michael,23,0,24,1
1739707145953,BIBC 104,A01,850495,Zhao; Yunde,49,0,50,1
1739707145953,BIBC 104,A02,850496,Zhao; Yunde,50,0,50,0
1739707145953,BIBC 104,A03,850500,Zhao; Yunde,48,0,50,2
1739707145953,BIBC 104,A04,850501,Zhao; Yunde,48,0,50,2
1739707146977,BIBC 194,A00,850502,Ernst; Andreas,20,0,32,12
1739707146977,BIBC 194,B00,850503,Saier; Milton H.,21,0,32,11
1739707148008,BICD 100,A01,864248,Biering; Scott B,70,0,73,3
1739707148008,BICD 100,A02,864249,Biering; Scott B,72,0,73,1
1739707148008,BICD 100,A03,864274,Biering; Scott B,73,0,73,0
1739707148008,BICD 100,A04,864287,Biering; Scott B,70,0,73,3
1739707148008,BICD 100,B01,864290,Reinagel; Pam,70,0,73,3
1739707148008,BICD 100,B02,864291,Reinagel; Pam,72,0,73,1
1739707148008,BICD 100,B03,864294,Reinagel; Pam,72,0,73,1
1739707148008,BICD 100,B04,864299,Reinagel; Pam,73,0,73,0
1739707148008,BICD 100,C01,864303,Nguyen; Vu Quang,72,0,73,1
1739707148008,BICD 100,C02,864314,Nguyen; Vu Quang,71,0,73,2
1739707148008,BICD 100,C03,864347,Nguyen; Vu Quang,72,0,73,1
1739707148008,BICD 100,C04,864362,Nguyen; Vu Quang,73,0,73,0
1739707149088,BICD 110,A01,850512,Ernst; Andreas,42,0,73,31
1739707149088,BICD 110,A02,850513,Ernst; Andreas,53,0,73,20
1739707149088,BICD 110,A03,850516,Ernst; Andreas,61,0,73,12
1739707149088,BICD 110,A04,850518,Ernst; Andreas,53,0,73,20
1739707150113,BICD 123,A01,850521,Zhao; Yunde,29,0,36,7
1739707151138,BICD 140,A01,850561,Lu; Li-Fan,50,0,61,11
1739707151138,BICD 140,A02,850563,Lu; Li-Fan,57,0,61,4
1739707151138,BICD 140,A03,850569,Lu; Li-Fan,57,0,61,4
1739707151138,BICD 140,A04,850577,Lu; Li-Fan,60,0,62,2
1739707152162,BICD 158,A01,850601,Bier; Ethan,30,0,36,6
1739707152162,BICD 158,A02,850644,Bier; Ethan,32,0,36,4
1739707152162,BICD 158,A03,850655,Bier; Ethan,33,0,36,3
1739707152162,BICD 158,A04,850656,Bier; Ethan,36,0,37,1
1739707153189,BIEB 121,A00,850668,Butler; Shannon Rhey,25,0,32,7
1739707153189,BIEB 121,B00,850674,Butler; Shannon Rhey,21,0,32,11
1739707154215,BIEB 146,A01,850680,Petrie; Katherine Lynn,91,0,99,8
1739707154215,BIEB 146,A02,850682,Petrie; Katherine Lynn,81,0,99,18
1739707154215,BIEB 146,A03,850684,Petrie; Katherine Lynn,95,0,99,4
1739707154215,BIEB 146,A04,850687,Petrie; Katherine Lynn,94,0,98,4
1739707155239,BIEB 148,A01,850691,Rose; Noah Hartmann,25,0,36,11
1739707155239,BIEB 148,A02,850706,Rose; Noah Hartmann,33,0,36,3
1739707155239,BIEB 148,A03,850778,Rose; Noah Hartmann,34,0,36,2
1739707155239,BIEB 148,A04,850779,Rose; Noah Hartmann,24,0,36,12
1739707156264,BIEB 152,A01,850784,Wodarz; Dominik Franz Xave,70,0,75,5
1739707156264,BIEB 152,A02,850785,Wodarz; Dominik Franz Xave,73,0,75,2
1739707156264,BIEB 152,A03,850786,Wodarz; Dominik Franz Xave,69,0,75,6
1739707156264,BIEB 152,A04,850789,Wodarz; Dominik Franz Xave,67,0,75,8
1739707157295,BIEB 154,A01,850792,Stockwell; Sarah R,15,0,15,0
1739707157295,BIEB 154,A02,850795,Stockwell; Sarah R,14,0,15,1
1739707157295,BIEB 154,A03,850796,Stockwell; Sarah R,13,0,15,2
1739707157295,BIEB 154,A04,850854,Stockwell; Sarah R,15,0,15,0
1739707158323,BIEB 159,A00,850856,Jackrel; Sara,33,0,36,3
1739707159348,BIEB 164,A01,850859,De Silva; Shermin,47,0,50,3
1739707159348,BIEB 164,A02,850862,De Silva; Shermin,41,0,50,9
1739707159348,BIEB 164,A03,850863,De Silva; Shermin,45,0,50,5
1739707159348,BIEB 164,A04,850865,De Silva; Shermin,45,0,50,5
1739707160379,BILD 1,A01,860138,Patrick; Gentry,62,0,62,0
1739707160379,BILD 1,A02,860253,Patrick; Gentry,61,0,62,1
1739707160379,BILD 1,A03,860277,Patrick; Gentry,61,0,62,1
1739707160379,BILD 1,A04,860281,Patrick; Gentry,61,0,64,3
1739707160379,BILD 1,B01,860381,Gonzalez Gamboa; Ivonne,51,0,62,11
1739707160379,BILD 1,B02,860382,Gonzalez Gamboa; Ivonne,61,0,62,1
1739707160379,BILD 1,B03,860383,Gonzalez Gamboa; Ivonne,59,0,62,3
1739707160379,BILD 1,B04,860384,Gonzalez Gamboa; Ivonne,63,0,64,1
1739707160379,BILD 1,C01,860385,Cooper; Andrew Michael,61,0,62,1
1739707160379,BILD 1,C02,860386,Cooper; Andrew Michael,59,0,62,3
1739707160379,BILD 1,C03,860387,Cooper; Andrew Michael,62,0,62,0
1739707160379,BILD 1,C04,860388,Cooper; Andrew Michael,64,0,64,0
1739707161408,BILD 2,A01,860389,Reyes Gonzalez; Catalina,87,0,99,12
1739707161408,BILD 2,A02,860390,Reyes Gonzalez; Catalina,96,0,99,3
1739707161408,BILD 2,A03,860391,Reyes Gonzalez; Catalina,99,0,99,0
1739707161408,BILD 2,A04,860392,Reyes Gonzalez; Catalina,98,0,98,0
1739707162439,BILD 3,A01,860393,Stockwell; Sarah R,68,0,70,2
1739707162439,BILD 3,A02,860394,Stockwell; Sarah R,65,0,70,5
1739707162439,BILD 3,A03,860395,Stockwell; Sarah R,69,0,70,1
1739707162439,BILD 3,A04,860396,Stockwell; Sarah R,66,0,68,2
1739707162439,BILD 3,B01,860397,Hammond; LaTisha Marie,48,0,63,15
1739707162439,BILD 3,B02,860398,Hammond; LaTisha Marie,54,0,60,6
1739707162439,BILD 3,B03,860399,Hammond; LaTisha Marie,57,0,60,3
1739707162439,BILD 3,B04,860400,Hammond; LaTisha Marie,60,0,62,2
1739707162439,BILD 3,C01,860401,Hammond; LaTisha Marie,60,0,62,2
1739707162439,BILD 3,C02,860402,Hammond; LaTisha Marie,58,0,63,5
1739707162439,BILD 3,C03,860403,Hammond; LaTisha Marie,59,0,60,1
1739707162439,BILD 3,C04,860404,Hammond; LaTisha Marie,60,0,60,0
1739707163466,BILD 4,A01,850172,Ochoa Mikrut; Stacy Daniel,22,0,24,2
1739707163466,BILD 4,A02,850250,Ochoa Mikrut; Stacy Daniel,24,0,24,0
1739707163466,BILD 4,A03,850251,Ochoa Mikrut; Stacy Daniel,22,0,24,2
1739707163466,BILD 4,A04,850252,Ochoa Mikrut; Stacy Daniel,23,0,24,1
1739707163466,BILD 4,A05,850253,Ochoa Mikrut; Stacy Daniel,24,0,24,0
1739707163466,BILD 4,A06,850254,Ochoa Mikrut; Stacy Daniel,24,0,24,0
1739707163466,BILD 4,A07,850255,Ochoa Mikrut; Stacy Daniel,24,0,24,0
1739707163466,BILD 4,A08,850257,Ochoa Mikrut; Stacy Daniel,23,0,24,1
1739707163466,BILD 4,B01,850259,Reuther; Keefe,18,0,24,6
1739707163466,BILD 4,B02,850260,Reuther; Keefe,22,0,24,2
1739707163466,BILD 4,B03,850261,Reuther; Keefe,24,0,24,0
1739707163466,BILD 4,B04,850263,Reuther; Keefe,22,0,24,2
1739707163466,BILD 4,B05,850264,Reuther; Keefe,23,0,24,1
1739707163466,BILD 4,B06,850265,Reuther; Keefe,24,0,24,0
1739707163466,BILD 4,B07,850266,Reuther; Keefe,24,0,24,0
1739707163466,BILD 4,B08,850267,Reuther; Keefe,24,0,24,0
1739707163466,BILD 4,C01,850269,Gonzalez Gamboa; Ivonne,19,0,24,5
1739707163466,BILD 4,C02,850270,Gonzalez Gamboa; Ivonne,24,0,24,0
1739707163466,BILD 4,C03,850271,Gonzalez Gamboa; Ivonne,24,0,24,0
1739707163466,BILD 4,C04,850273,Gonzalez Gamboa; Ivonne,24,0,24,0
1739707163466,BILD 4,C05,850283,Gonzalez Gamboa; Ivonne,23,0,24,1
1739707163466,BILD 4,C06,850329,Gonzalez Gamboa; Ivonne,23,0,24,1
1739707163466,BILD 4,C07,850331,Gonzalez Gamboa; Ivonne,24,0,24,0
1739707163466,BILD 4,C08,850336,Gonzalez Gamboa; Ivonne,23,0,24,1
1739707164492,BILD 5,A01,860586,Reuther; Keefe,63,0,65,2
1739707164492,BILD 5,A02,860597,Reuther; Keefe,62,0,65,3
1739707164492,BILD 5,A03,860600,Reuther; Keefe,65,0,65,0
1739707164492,BILD 5,A04,860672,Reuther; Keefe,64,0,65,1
1739707164492,BILD 5,B01,860673,Yang; Mingyu,65,0,65,0
1739707164492,BILD 5,B02,860681,Yang; Mingyu,64,0,65,1
1739707164492,BILD 5,B03,860686,Yang; Mingyu,65,0,65,0
1739707164492,BILD 5,B04,860687,Yang; Mingyu,65,0,65,0
1739707164492,BILD 5,C01,860694,Day; Christopher D,62,0,65,3
1739707164492,BILD 5,C02,860697,Day; Christopher D,65,0,65,0
1739707164492,BILD 5,C03,860709,Day; Christopher D,63,0,65,2
1739707164492,BILD 5,C04,860714,Day; Christopher D,65,0,65,0
1739707165522,BILD 30,A01,850343,Madigan; Cressida Ariana,28,0,28,0
1739707165522,BILD 30,A02,850344,Madigan; Cressida Ariana,28,0,28,0
1739707165522,BILD 30,A03,850345,Madigan; Cressida Ariana,26,0,28,2
1739707165522,BILD 30,A04,850349,Madigan; Cressida Ariana,30,0,31,1
1739707166547,BILD 88,A00,850480,Kurle; Carolyn M.,20,0,20,0
1739707167579,BIMM 100,A01,860726,Farley; Emma Kristen,35,0,48,13
1739707167579,BIMM 100,A02,860737,Farley; Emma Kristen,43,0,48,5
1739707167579,BIMM 100,A03,860771,Farley; Emma Kristen,46,0,48,2
1739707167579,BIMM 100,A04,860812,Farley; Emma Kristen,45,0,48,3
1739707167579,BIMM 100,B01,860817,Wildonger; Jill Cathleen,35,0,48,13
1739707167579,BIMM 100,B02,860838,Wildonger; Jill Cathleen,38,0,48,10
1739707167579,BIMM 100,B03,860839,Wildonger; Jill Cathleen,44,0,48,4
1739707167579,BIMM 100,B04,860840,Wildonger; Jill Cathleen,46,0,48,2
1739707168611,BIMM 101,A01,850871,Meaders; Clara Leigh,0,0,24,24
1739707168611,BIMM 101,A02,850872,Meaders; Clara Leigh,1,0,24,23
1739707168611,BIMM 101,B01,850876,Day; Christopher D,23,0,24,1
1739707168611,BIMM 101,B02,850877,Day; Christopher D,22,0,24,2
1739707168611,BIMM 101,C01,850880,Cooper; Andrew Michael,17,0,24,7
1739707168611,BIMM 101,C02,850887,Cooper; Andrew Michael,22,0,24,2
1739707168611,BIMM 101,D01,850890,Grossman; Emily N,19,0,24,5
1739707168611,BIMM 101,D02,850894,Grossman; Emily N,20,0,24,4
1739707168611,BIMM 101,E01,850897,Grossman; Emily N,19,0,24,5
1739707168611,BIMM 101,E02,850900,Grossman; Emily N,22,0,24,2
1739707168611,BIMM 101,F01,850906,Rusert; Jessica Marie,21,0,24,3
1739707168611,BIMM 101,F02,850910,Rusert; Jessica Marie,24,0,24,0
1739707168611,BIMM 101,G01,850920,Rusert; Jessica Marie,20,0,24,4
1739707168611,BIMM 101,G02,850921,Rusert; Jessica Marie,24,0,24,0
1739707169637,BIMM 118,A01,850923,David; Michael,25,0,29,4
1739707169637,BIMM 118,A02,850926,David; Michael,27,0,29,2
1739707169637,BIMM 118,A03,850927,David; Michael,25,0,29,4
1739707169637,BIMM 118,A04,850928,David; Michael,27,0,28,1
1739707170665,BIMM 120,A01,850932,Saier; Milton H.,78,0,87,9
1739707170665,BIMM 120,A02,850934,Saier; Milton H.,71,0,87,16
1739707170665,BIMM 120,A03,850986,Saier; Milton H.,81,0,87,6
1739707170665,BIMM 120,A04,851000,Saier; Milton H.,84,0,87,3
1739707171692,BIMM 121,A01,851020,Gustafson-Brown; Cindy,18,0,24,6
1739707171692,BIMM 121,A02,851023,Gustafson-Brown; Cindy,23,0,24,1
1739707171692,BIMM 121,B01,851032,Gustafson-Brown; Cindy,15,0,24,9
1739707171692,BIMM 121,B02,851058,Gustafson-Brown; Cindy,19,0,24,5
1739707171692,BIMM 121,C01,851077,Staff,1,0,24,23
1739707171692,BIMM 121,C02,851081,Staff,19,0,24,5
1739707171692,BIMM 121,D01,851152,Staff,15,0,24,9
1739707171692,BIMM 121,D02,851169,Staff,23,0,24,1
1739707172717,BIMM 134,A01,851210,Burg; Michael,94,0,103,9
1739707172717,BIMM 134,A02,851211,Burg; Michael,93,0,103,10
1739707172717,BIMM 134,A03,851212,Burg; Michael,93,0,103,10
1739707172717,BIMM 134,A04,851213,Burg; Michael,96,0,101,5
1739707173746,BIMM 143,A01,851215,Grant; Barry J,28,0,40,12
1739707173746,BIMM 143,B01,851218,Bozinovic; Goran,38,0,40,2
1739707173746,BIMM 143,C01,851220,Bozinovic; Goran,40,0,40,0
1739707174773,BIMM 182,A01,851597,Bafna; Vineet,31,0,50,19
1739707175798,BIMM 194,A00,851222,Russell; Alistair B,23,0,32,9
1739707176823,BIOM 202,A01,806511,Sheikh; Farah,21,0,40,19
1739707177848,BIOM 218,A00,806606,Gagneux; Pascal,10,0,12,2
1739707178878,BIOM 219,A00,806612,Ross; Camille,1,0,1,0
1739707179904,BIOM 222,A00,872553,Esko; Jeffrey D.,0,0,0,0
1739707180928,BIOM 229,A00,806613,Gagneux; Pascal,12,0,12,0
1739707181953,BIOM 231,A00,881485,Daneman; Richard & Newton; Alexandra C.,0,0,0,0
1739707181953,BIOM 231,B00,881487,Staff,0,0,0,0
1739707181953,BIOM 231,C00,881488,Schoeneberg; Johannes,0,0,0,0
1739707182981,BIOM 234,A00,881480,Newton; Alexandra C.,0,0,0,0
1739707184005,BIOM 242,A00,806624,Hamilton; Bruce Alan,0,0,0,0
1739707185029,BIOM 246,A00,872559,Gordts; Philip & Lewis; Amanda Lark & Godula; Kamil & Gagneux; Pascal & Esko; Jeffrey D. & Bode; Lars,0,0,0,0
1739707186054,BIOM 252,A00,806625,Ayyagari; Radha,7,0,20,13
1739707187083,BIOM 283,A00,806628,Ghassemian; Majid,0,0,0,0
1739707188109,BIOM 295,A00,806638,Joiner; William J.,0,0,0,0
1739707189144,BIPN 100,A01,860405,Augustine; Vineet,32,0,36,4
1739707189144,BIPN 100,A02,860406,Augustine; Vineet,35,0,36,1
1739707189144,BIPN 100,A03,860407,Augustine; Vineet,35,0,36,1
1739707189144,BIPN 100,A04,860408,Augustine; Vineet,36,0,37,1
1739707189144,BIPN 100,B01,860409,George; Monique Leana,27,0,36,9
1739707189144,BIPN 100,B02,860410,George; Monique Leana,33,0,36,3
1739707189144,BIPN 100,B03,860411,George; Monique Leana,31,0,36,5
1739707189144,BIPN 100,B04,860412,George; Monique Leana,31,0,37,6
1739707189144,BIPN 100,C01,860413,Maita; Isabella Vincenza,36,0,36,0
1739707189144,BIPN 100,C02,860414,Maita; Isabella Vincenza,35,0,36,1
1739707189144,BIPN 100,C03,860415,Maita; Isabella Vincenza,33,0,36,3
1739707189144,BIPN 100,C04,860416,Maita; Isabella Vincenza,36,0,37,1
1739707189144,BIPN 100,D01,860417,Marino; Marc J,47,0,50,3
1739707189144,BIPN 100,D02,860418,Marino; Marc J,48,0,50,2
1739707189144,BIPN 100,D03,860419,Marino; Marc J,48,0,50,2
1739707189144,BIPN 100,D04,860420,Marino; Marc J,50,0,50,0
1739707189144,BIPN 100,E01,860421,Yang; Mingyu,36,0,36,0
1739707189144,BIPN 100,E02,860422,Yang; Mingyu,34,0,36,2
1739707189144,BIPN 100,E03,860423,Yang; Mingyu,36,0,36,0
1739707189144,BIPN 100,E04,860424,Yang; Mingyu,37,0,37,0
1739707190168,BIPN 102,A01,851476,Reyes Gonzalez; Catalina,45,0,54,9
1739707190168,BIPN 102,A02,851477,Reyes Gonzalez; Catalina,48,0,54,6
1739707190168,BIPN 102,A03,851478,Reyes Gonzalez; Catalina,53,0,54,1
1739707190168,BIPN 102,A04,851479,Reyes Gonzalez; Catalina,51,0,54,3
1739707191191,BIPN 105,A01,851482,Armour; Jon Christopher,13,0,21,8
1739707191191,BIPN 105,A02,851483,Armour; Jon Christopher,20,0,21,1
1739707191191,BIPN 105,B01,851487,Armour; Jon Christopher,10,0,21,11
1739707191191,BIPN 105,B02,851488,Armour; Jon Christopher,20,0,21,1
1739707192220,BIPN 140,A01,851492,Owens; Melinda Tsao-Ying,37,0,40,3
1739707192220,BIPN 140,A02,851493,Owens; Melinda Tsao-Ying,38,0,40,2
1739707192220,BIPN 140,A03,851494,Owens; Melinda Tsao-Ying,39,0,40,1
1739707192220,BIPN 140,A04,851495,Owens; Melinda Tsao-Ying,32,0,38,6
1739707193246,BIPN 144,A01,851498,Zou; Yimin,35,0,40,5
1739707193246,BIPN 144,A02,851499,Zou; Yimin,35,0,40,5
1739707193246,BIPN 144,A03,851500,Zou; Yimin,40,0,40,0
1739707193246,BIPN 144,A04,851501,Zou; Yimin,37,0,38,1
1739707194272,BIPN 145,A01,851505,Maita; Isabella Vincenza,33,0,42,9
1739707194272,BIPN 145,B01,851507,Juavinett; Ashley Lauren,36,0,42,6
1739707194272,BIPN 145,C01,851512,Marino; Marc J,34,0,42,8
1739707195300,BIPN 147,A01,851516,Sejnowski; Terrence J,5,0,16,11
1739707195300,BIPN 147,A02,851517,Sejnowski; Terrence J,16,0,16,0
1739707195300,BIPN 147,A03,851520,Sejnowski; Terrence J,13,0,16,3
1739707195300,BIPN 147,A04,851521,Sejnowski; Terrence J,14,0,16,2
1739707196326,BIPN 152,A01,860841,Halpain; Shelley,32,0,44,12
1739707196326,BIPN 152,A02,860842,Halpain; Shelley,43,0,44,1
1739707196326,BIPN 152,A03,860843,Halpain; Shelley,42,0,44,2
1739707196326,BIPN 152,A04,860844,Halpain; Shelley,40,0,43,3
1739707197353,BIPN 162,A01,851524,Aoi; Mikio C,7,0,8,1
1739707197353,BIPN 162,A02,851525,Aoi; Mikio C,7,0,8,1
1739707197353,BIPN 162,A03,851527,Aoi; Mikio C,6,0,8,2
1739707197353,BIPN 162,A04,851529,Aoi; Mikio C,6,0,6,0
1739707198383,BIPN 164,A01,851531,Benna; Marcus K & Aljadeff; Johnatan,13,0,14,1
1739707198383,BIPN 164,A02,851532,Benna; Marcus K & Aljadeff; Johnatan,13,0,14,1
1739707198383,BIPN 164,A03,851533,Benna; Marcus K & Aljadeff; Johnatan,13,0,14,1
1739707198383,BIPN 164,A04,851535,Benna; Marcus K & Aljadeff; Johnatan,12,0,12,0
1739707199406,BIPN 194,A00,851536,Glasgow; Stacey Marie,29,0,32,3
1739707199406,BIPN 194,B00,851537,Augustine; Vineet,28,0,32,4
1739707199406,BIPN 194,C00,851539,Reinagel; Pam,31,0,32,1
1739707200430,BISP 170,A00,851540,French; Kathleen Ann,28,0,30,2
1739707201455,BISP 182,A00,869152,Pogliano; Joseph,9999,0,9999,0
1739707202484,BISP 194,A00,851542,Greenspan; Ralph J.,10,0,32,22
1739707202484,BISP 194,B00,851543,Nguyen; Vu Quang,25,0,32,7
1739707202484,BISP 194,C00,869153,Patrick; Gentry,23,0,32,9
1739707203509,BNFO 281,A00,805637,Gaasterland; Theresa,94,0,100,6
1739707204535,BNFO 283,A00,805640,Chavez; Alejandro & D'Antonio; Matteo,48,0,50,2
1739707204535,BNFO 283,B00,805642,Carter; Hannah Kathryn & Sanchez Roige; Alexandra,47,0,50,3
1739707205562,BNFO 285,A00,805666,Alexandrov; Ludmil B,6,0,8,2
1739707206589,BNFO 294,A01,805680,Ross; Camille,49,0,50,1
1739707207643,CAT 3,A01,813335,Marchisotto; Jennifer Anne,16,0,16,0
1739707207643,CAT 3,A02,813336,Marchisotto; Jennifer Anne,16,0,16,0
1739707207643,CAT 3,A03,813341,Marchisotto; Jennifer Anne,8,0,16,8
1739707207643,CAT 3,A04,813343,Marchisotto; Jennifer Anne,12,0,16,4
1739707207643,CAT 3,A05,813345,Marchisotto; Jennifer Anne,16,0,16,0
1739707207643,CAT 3,A06,813346,Marchisotto; Jennifer Anne,12,0,16,4
1739707207643,CAT 3,A07,813347,Marchisotto; Jennifer Anne,15,0,16,1
1739707207643,CAT 3,A08,813349,Marchisotto; Jennifer Anne,15,0,16,1
1739707207643,CAT 3,A09,813350,Marchisotto; Jennifer Anne,16,0,16,0
1739707207643,CAT 3,A10,813365,Marchisotto; Jennifer Anne,15,0,16,1
1739707207643,CAT 3,A11,813366,Marchisotto; Jennifer Anne,5,0,16,11
1739707207643,CAT 3,A12,813384,Marchisotto; Jennifer Anne,16,0,16,0
1739707207643,CAT 3,A13,813385,Marchisotto; Jennifer Anne,16,0,16,0
1739707207643,CAT 3,A14,813434,Marchisotto; Jennifer Anne,15,0,16,1
1739707207643,CAT 3,B01,813444,Popko; Elizabeth Ashley,16,0,16,0
1739707207643,CAT 3,B02,813445,Popko; Elizabeth Ashley,12,0,16,4
1739707207643,CAT 3,B03,813464,Popko; Elizabeth Ashley,14,0,16,2
1739707207643,CAT 3,B04,813465,Popko; Elizabeth Ashley,7,0,16,9
1739707207643,CAT 3,B05,813466,Popko; Elizabeth Ashley,12,0,16,4
1739707207643,CAT 3,B06,813475,Popko; Elizabeth Ashley,13,0,16,3
1739707207643,CAT 3,B07,813531,Popko; Elizabeth Ashley,15,0,16,1
1739707207643,CAT 3,B08,813538,Popko; Elizabeth Ashley,15,0,16,1
1739707207643,CAT 3,B09,813539,Popko; Elizabeth Ashley,11,0,16,5
1739707207643,CAT 3,B10,813543,Popko; Elizabeth Ashley,12,0,16,4
1739707207643,CAT 3,B11,813545,Popko; Elizabeth Ashley,16,0,16,0
1739707207643,CAT 3,B12,813551,Popko; Elizabeth Ashley,16,0,16,0
1739707207643,CAT 3,B13,813552,Popko; Elizabeth Ashley,15,0,16,1
1739707207643,CAT 3,B14,813554,Popko; Elizabeth Ashley,16,0,16,0
1739707207643,CAT 3,B15,813556,Popko; Elizabeth Ashley,16,0,16,0
1739707207643,CAT 3,B16,813558,Popko; Elizabeth Ashley,16,0,16,0
1739707207643,CAT 3,C01,813564,Glaser; Amelia,15,0,16,1
1739707207643,CAT 3,C02,813578,Glaser; Amelia,13,0,16,3
1739707207643,CAT 3,C03,813602,Glaser; Amelia,4,0,16,12
1739707207643,CAT 3,C04,813604,Glaser; Amelia,3,0,16,13
1739707207643,CAT 3,C05,813606,Glaser; Amelia,14,0,16,2
1739707207643,CAT 3,C06,813607,Glaser; Amelia,14,0,16,2
1739707207643,CAT 3,C07,813609,Glaser; Amelia,14,0,16,2
1739707207643,CAT 3,C08,813611,Glaser; Amelia,16,0,16,0
1739707207643,CAT 3,C09,813613,Glaser; Amelia,15,0,16,1
1739707207643,CAT 3,C10,813614,Glaser; Amelia,13,0,16,3
1739707207643,CAT 3,C11,813617,Glaser; Amelia,14,0,16,2
1739707207643,CAT 3,C12,813618,Glaser; Amelia,16,0,16,0
1739707207643,CAT 3,C13,813622,Glaser; Amelia,15,0,16,1
1739707207643,CAT 3,C14,813623,Glaser; Amelia,15,0,16,1
1739707207643,CAT 3,D01,813625,Bigham; David Joseph,11,0,16,5
1739707207643,CAT 3,D02,813627,Bigham; David Joseph,8,0,16,8
1739707207643,CAT 3,D03,813632,Bigham; David Joseph,15,0,16,1
1739707207643,CAT 3,D04,813637,Bigham; David Joseph,15,0,16,1
1739707207643,CAT 3,D05,813641,Bigham; David Joseph,16,0,16,0
1739707207643,CAT 3,D06,813642,Bigham; David Joseph,15,0,16,1
1739707207643,CAT 3,D07,813644,Bigham; David Joseph,15,0,16,1
1739707207643,CAT 3,D08,813645,Bigham; David Joseph,15,0,16,1
1739707207643,CAT 3,D09,813648,Bigham; David Joseph,15,0,16,1
1739707207643,CAT 3,D10,813651,Bigham; David Joseph,16,0,16,0
1739707207643,CAT 3,D11,813654,Bigham; David Joseph,16,0,16,0
1739707207643,CAT 3,D12,813656,Bigham; David Joseph,16,0,16,0
1739707207643,CAT 3,D13,813657,Bigham; David Joseph,16,0,16,0
1739707207643,CAT 3,D14,813658,Bigham; David Joseph,16,0,16,0
1739707207643,CAT 3,D15,813662,Bigham; David Joseph,15,0,16,1
1739707207643,CAT 3,D16,813663,Bigham; David Joseph,16,0,16,0
1739707208667,CAT 3CE,A01,813665,Bronstein; Phoebe Malan,25,0,25,0
1739707209699,CAT 87,A00,813667,Bronstein; Phoebe Malan,20,0,20,0
1739707209699,CAT 87,B00,886854,Geibel; William,20,0,20,0
1739707210726,CAT 98,001,881482,Geibel; William,20,0,20,0
1739707211751,CAT 124,A01,813672,Geibel; William,20,0,20,0
1739707211751,CAT 124,B01,813675,Rose; Becca Rae,20,0,20,0
1739707212777,CAT 125,A00,813692,Marchisotto; Jennifer Anne,17,0,20,3
1739707212777,CAT 125,B00,813696,Bigham; David Joseph,18,0,20,2
1739707212777,CAT 125,C00,813698,Vanderschuit; Maya Alysia,20,0,20,0
1739707212777,CAT 125,D00,813700,Vanderschuit; Maya Alysia,20,0,20,0
1739707212777,CAT 125,E00,813703,Vanderschuit; Maya Alysia,20,0,20,0
1739707212777,CAT 125,F00,813711,Morales; Celeste Georgianna,19,0,20,1
1739707212777,CAT 125,G00,813714,Morales; Celeste Georgianna,18,0,20,2
1739707212777,CAT 125,H00,813717,Morales; Celeste Georgianna,20,0,20,0
1739707212777,CAT 125,I00,813720,Rose; Becca Rae,20,0,20,0
1739707212777,CAT 125,J00,813744,Rose; Becca Rae,19,0,20,1
1739707212777,CAT 125,K00,813761,Tosun; Adriana,18,0,20,2
1739707212777,CAT 125,L00,813762,Tosun; Adriana,19,0,20,1
1739707212777,CAT 125,M00,872512,Delaville; Romain,19,0,20,1
1739707212777,CAT 125,N00,872514,Irwin; Matthew Joseph,18,0,20,2
1739707212777,CAT 125,O00,872516,Irwin; Matthew Joseph,20,0,20,0
1739707212777,CAT 125,P00,872517,Irwin; Matthew Joseph,19,0,20,1
1739707213818,CAT 125R,A00,813763,Smith; Lauryn Alissa,17,0,20,3
1739707213818,CAT 125R,B00,813764,Smith; Lauryn Alissa,18,0,20,2
1739707213818,CAT 125R,C00,813765,Smith; Lauryn Alissa,20,0,20,0
1739707213818,CAT 125R,D00,813766,Hyland; Tina Mae,16,0,20,4
1739707213818,CAT 125R,E00,813767,Hyland; Tina Mae,15,0,20,5
1739707213818,CAT 125R,F00,813768,Hyland; Tina Mae,19,0,20,1
1739707213818,CAT 125R,G00,813769,Tosun; Adriana,17,0,20,3
1739707214846,CCE 1,A00,815913,Merryman; Ashley,39,0,40,1
1739707214846,CCE 1,D00,815916,Garcia; Kathryn Mary,39,0,40,1
1739707214846,CCE 1,E00,815918,Labat Ii; Michael Luis,36,0,40,4
1739707214846,CCE 1,F00,815919,Bigley; Michele Heather,39,0,40,1
1739707214846,CCE 1,G00,815921,Santos; Vabianna Daria,40,0,40,0
1739707214846,CCE 1,H00,815922,Lee; Kassandra,39,0,40,1
1739707215875,CCE 3,001,815923,Kenley; Nicole,15,0,20,5
1739707215875,CCE 3,002,815924,Quijada; David,19,0,20,1
1739707215875,CCE 3,003,815926,Crawford; James,20,0,20,0
1739707215875,CCE 3,004,815963,Williams; Danielle,20,0,20,0
1739707215875,CCE 3,005,815964,Merryman; Ashley,20,0,20,0
1739707215875,CCE 3,006,815965,Merryman; Ashley,20,0,20,0
1739707215875,CCE 3,007,815966,Lee; Kassandra,19,0,20,1
1739707215875,CCE 3,008,815967,Lee; Kassandra,20,0,20,0
1739707215875,CCE 3,009,816009,Garcia; Kathryn Mary,19,0,20,1
1739707215875,CCE 3,010,816011,Garcia; Kathryn Mary,19,0,20,1
1739707215875,CCE 3,011,816012,Labat Ii; Michael Luis,18,0,20,2
1739707215875,CCE 3,012,816013,Labat Ii; Michael Luis,20,0,20,0
1739707215875,CCE 3,013,816014,Bigley; Michele Heather,18,0,20,2
1739707215875,CCE 3,014,816015,Santos; Vabianna Daria,20,0,20,0
1739707215875,CCE 3,015,816016,Santos; Vabianna Daria,20,0,20,0
1739707215875,CCE 3,016,889148,Crawford; James,39,0,40,1
1739707216904,CENG 101B,A00,808970,Chen; Shaochen,50,0,50,0
1739707217929,CENG 101C,A00,808971,Li; Yanran,144,0,146,2
1739707218958,CENG 113,A00,808993,Li; Wan-Lu,67,0,70,3
1739707218958,CENG 113,B00,808994,Chen; Zheng,70,0,70,0
1739707219983,CENG 124B,A00,808995,Drews; Aaron,46,0,60,14
1739707219983,CENG 124B,B00,809012,Powell; Alyssa,51,0,60,9
1739707221008,CENG 160,A00,809013,Powell; Alyssa,65,0,70,5
1739707222035,CENG 170,A01,809059,Drews; Aaron,28,0,30,2
1739707223060,CENG 176B,A01,809097,Opatkiewicz; Justin Paul,55,0,60,5
1739707223060,CENG 176B,B01,809104,Shah; Nisarg,47,0,48,1
1739707224085,CENG 205,A00,809106,Jahed Motlagh; Zeinab,41,0,60,19
1739707225108,CENG 260,A00,809107,Powell; Alyssa,30,0,30,0
1739707226133,CENG 273,A00,809114,Shah; Nisarg,23,0,30,7
1739707227163,CGS 2B,A01,812749,Whitley; Leila Marie,23,0,25,2
1739707227163,CGS 2B,A02,812761,Whitley; Leila Marie,24,0,24,0
1739707228187,CGS 87,A00,812765,Wesling; Megan E.,20,0,20,0
1739707229211,CGS 100B,A00,812766,Whitley; Leila Marie,30,0,33,3
1739707230238,CGS 105,A01,812868,Wesling; Megan E.,22,0,23,1
1739707230238,CGS 105,A02,812869,Wesling; Megan E.,22,0,23,1
1739707230238,CGS 105,A03,812872,Wesling; Megan E.,23,0,23,0
1739707231263,CGS 106,A00,812873,Whitley; Leila Marie,46,0,50,4
1739707232290,CGS 112,A00,812902,Cuong; Marisol,30,0,30,0
1739707233314,CGS 114,A00,812906,Cuong; Marisol,20,0,22,2
1739707234339,CGS 117,A00,812907,Martin Sandino; Amanda Maria Yoland,13,0,16,3
1739707235367,CGS 120,A00,812908,Hankins; Joseph D.,21,0,22,1
1739707236396,CGS 121,A00,812916,Martin Sandino; Amanda Maria Yoland,20,0,20,0
1739707237422,CGS 122,A00,812917,Martin Sandino; Amanda Maria Yoland,19,0,20,1
1739707238447,CGS 147,A00,872913,Staff,20,0,20,0
1739707239471,CGS 196B,A00,812923,Taylor-Garcia; Daphne,0,0,0,0
1739707239471,CGS 196B,B00,812971,Hankins; Joseph D.,0,0,0,0
1739707239471,CGS 196B,C00,812978,Perez; Roy,0,0,0,0
1739707240498,CGS 198,001,812980,Anderson; Patrick W.,0,0,0,0
1739707240498,CGS 198,002,813054,Anderson; Patrick W.,0,0,0,0
1739707240498,CGS 198,003,813102,Anderson; Patrick W.,0,0,0,0
1739707240498,CGS 198,004,813257,Anderson; Patrick W.,0,0,0,0
1739707241523,CGS 200,A00,813286,Okonkwo; Holly,0,0,0,0
1739707242552,CHEM 6A,A01,860027,Lam; Tin Yiu,40,0,40,0
1739707242552,CHEM 6A,A02,860042,Lam; Tin Yiu,37,0,40,3
1739707242552,CHEM 6A,A03,860049,Lam; Tin Yiu,35,0,40,5
1739707242552,CHEM 6A,A04,860050,Lam; Tin Yiu,37,0,40,3
1739707242552,CHEM 6A,A05,860051,Lam; Tin Yiu,35,0,40,5
1739707242552,CHEM 6A,A06,860052,Lam; Tin Yiu,40,0,40,0
1739707242552,CHEM 6A,A07,860065,Lam; Tin Yiu,40,0,40,0
1739707242552,CHEM 6A,A08,860068,Lam; Tin Yiu,39,0,40,1
1739707243579,CHEM 6B,A01,859962,Lam; Tin Yiu,39,0,40,1
1739707243579,CHEM 6B,A02,859975,Lam; Tin Yiu,40,0,40,0
1739707243579,CHEM 6B,A03,859990,Lam; Tin Yiu,36,0,40,4
1739707243579,CHEM 6B,A04,859994,Lam; Tin Yiu,39,0,40,1
1739707243579,CHEM 6B,A05,859999,Lam; Tin Yiu,40,0,40,0
1739707243579,CHEM 6B,A06,860019,Lam; Tin Yiu,40,0,40,0
1739707243579,CHEM 6B,A07,860024,Lam; Tin Yiu,40,0,40,0
1739707243579,CHEM 6B,B01,861221,Zajac; Eva L,34,0,40,6
1739707243579,CHEM 6B,B02,861224,Zajac; Eva L,36,0,40,4
1739707243579,CHEM 6B,B03,861229,Zajac; Eva L,39,0,40,1
1739707243579,CHEM 6B,B04,861232,Zajac; Eva L,38,0,40,2
1739707243579,CHEM 6B,B05,861239,Zajac; Eva L,37,0,40,3
1739707243579,CHEM 6B,B06,861240,Zajac; Eva L,36,0,40,4
1739707243579,CHEM 6B,B07,861242,Zajac; Eva L,40,0,40,0
1739707244609,CHEM 6C,A01,861431,Hopkins; Patrycja Anna,35,0,40,5
1739707244609,CHEM 6C,A02,861466,Hopkins; Patrycja Anna,38,0,40,2
1739707244609,CHEM 6C,A03,861467,Hopkins; Patrycja Anna,40,0,40,0
1739707244609,CHEM 6C,A04,861530,Hopkins; Patrycja Anna,40,0,40,0
1739707244609,CHEM 6C,A05,861531,Hopkins; Patrycja Anna,38,0,40,2
1739707244609,CHEM 6C,A06,861622,Hopkins; Patrycja Anna,40,0,40,0
1739707244609,CHEM 6C,A07,861649,Hopkins; Patrycja Anna,39,0,40,1
1739707244609,CHEM 6C,A08,861650,Hopkins; Patrycja Anna,0,0,0,0
1739707244609,CHEM 6C,B01,861651,Zajac; Eva L,31,0,40,9
1739707244609,CHEM 6C,B02,861763,Zajac; Eva L,37,0,40,3
1739707244609,CHEM 6C,B03,861768,Zajac; Eva L,38,0,40,2
1739707244609,CHEM 6C,B04,861770,Zajac; Eva L,38,0,40,2
1739707244609,CHEM 6C,B05,861771,Zajac; Eva L,35,0,40,5
1739707244609,CHEM 6C,B06,861773,Zajac; Eva L,39,0,40,1
1739707244609,CHEM 6C,B07,861777,Zajac; Eva L,40,0,40,0
1739707244609,CHEM 6C,B08,861781,Zajac; Eva L,0,0,0,0
1739707244609,CHEM 6C,D01,859938,Stallings; Dontarie M,39,0,40,1
1739707244609,CHEM 6C,D02,859942,Stallings; Dontarie M,32,0,40,8
1739707244609,CHEM 6C,D03,859943,Stallings; Dontarie M,38,0,40,2
1739707244609,CHEM 6C,D04,859952,Stallings; Dontarie M,38,0,40,2
1739707244609,CHEM 6C,D05,859953,Stallings; Dontarie M,19,0,40,21
1739707244609,CHEM 6C,D06,859959,Stallings; Dontarie M,37,0,40,3
1739707244609,CHEM 6C,D07,859960,Stallings; Dontarie M,37,0,40,3
1739707244609,CHEM 6C,D08,859961,Stallings; Dontarie M,0,0,0,0
1739707244609,CHEM 6C,E01,861810,Debelouchina; Galia T,40,0,40,0
1739707244609,CHEM 6C,E02,861860,Debelouchina; Galia T,40,0,40,0
1739707244609,CHEM 6C,E03,861879,Debelouchina; Galia T,39,0,40,1
1739707244609,CHEM 6C,E04,861880,Debelouchina; Galia T,39,0,40,1
1739707244609,CHEM 6C,E05,861890,Debelouchina; Galia T,39,0,40,1
1739707244609,CHEM 6C,E06,861908,Debelouchina; Galia T,40,0,40,0
1739707244609,CHEM 6C,E07,861910,Debelouchina; Galia T,40,0,40,0
1739707244609,CHEM 6C,E08,861911,Debelouchina; Galia T,0,0,0,0
1739707245634,CHEM 6CH,A01,859928,Tezcan; Faik,39,0,40,1
1739707246661,CHEM 7L,A01,844470,Piercy; Marc Anthony,17,0,24,7
1739707246661,CHEM 7L,A02,844472,Piercy; Marc Anthony,21,0,24,3
1739707246661,CHEM 7L,A03,844473,Piercy; Marc Anthony,22,0,24,2
1739707246661,CHEM 7L,A04,844475,Piercy; Marc Anthony,24,0,24,0
1739707246661,CHEM 7L,A05,844476,Piercy; Marc Anthony,23,0,24,1
1739707246661,CHEM 7L,A06,844482,Piercy; Marc Anthony,22,0,24,2
1739707246661,CHEM 7L,A07,844490,Piercy; Marc Anthony,20,0,24,4
1739707246661,CHEM 7L,A08,844493,Piercy; Marc Anthony,24,0,24,0
1739707246661,CHEM 7L,A09,844496,Piercy; Marc Anthony,23,0,24,1
1739707246661,CHEM 7L,A10,844503,Piercy; Marc Anthony,24,0,24,0
1739707246661,CHEM 7L,B01,844506,Piercy; Marc Anthony,2,0,24,22
1739707246661,CHEM 7L,B02,844508,Piercy; Marc Anthony,23,0,24,1
1739707246661,CHEM 7L,B03,844661,Piercy; Marc Anthony,22,0,24,2
1739707246661,CHEM 7L,B04,844716,Piercy; Marc Anthony,24,0,24,0
1739707246661,CHEM 7L,B05,844717,Piercy; Marc Anthony,21,0,24,3
1739707246661,CHEM 7L,B06,844719,Piercy; Marc Anthony,22,0,24,2
1739707246661,CHEM 7L,B07,844841,Piercy; Marc Anthony,24,0,24,0
1739707246661,CHEM 7L,B08,845021,Piercy; Marc Anthony,23,0,24,1
1739707246661,CHEM 7L,B09,845022,Piercy; Marc Anthony,23,0,24,1
1739707246661,CHEM 7L,B10,845184,Piercy; Marc Anthony,24,0,24,0
1739707247688,CHEM 7LM,A01,845187,Leigh; Brian,24,0,24,0
1739707247688,CHEM 7LM,A02,845321,Leigh; Brian,21,0,21,0
1739707247688,CHEM 7LM,A03,845322,Leigh; Brian,24,0,24,0
1739707247688,CHEM 7LM,A04,845340,Leigh; Brian,19,0,21,2
1739707247688,CHEM 7LM,A05,845350,Leigh; Brian,23,0,24,1
1739707247688,CHEM 7LM,A06,845398,Leigh; Brian,21,0,21,0
1739707247688,CHEM 7LM,A07,845399,Leigh; Brian,18,0,24,6
1739707247688,CHEM 7LM,A08,845406,Leigh; Brian,20,0,21,1
1739707248712,CHEM 11,A01,861914,Albizati; Kim F.,37,0,40,3
1739707248712,CHEM 11,A02,861934,Albizati; Kim F.,38,0,40,2
1739707248712,CHEM 11,A03,861939,Albizati; Kim F.,40,0,40,0
1739707248712,CHEM 11,A04,861940,Albizati; Kim F.,40,0,40,0
1739707248712,CHEM 11,A05,861951,Albizati; Kim F.,36,0,40,4
1739707248712,CHEM 11,A06,861975,Albizati; Kim F.,40,0,40,0
1739707249742,CHEM 40A,A01,861976,Hopkins; Patrycja Anna,32,0,40,8
1739707249742,CHEM 40A,A02,861977,Hopkins; Patrycja Anna,36,0,40,4
1739707249742,CHEM 40A,A03,861978,Hopkins; Patrycja Anna,37,0,40,3
1739707249742,CHEM 40A,A04,862061,Hopkins; Patrycja Anna,38,0,40,2
1739707249742,CHEM 40A,A05,862062,Hopkins; Patrycja Anna,38,0,40,2
1739707249742,CHEM 40A,A06,862063,Hopkins; Patrycja Anna,37,0,40,3
1739707249742,CHEM 40A,A07,862064,Hopkins; Patrycja Anna,39,0,40,1
1739707249742,CHEM 40A,A08,862065,Hopkins; Patrycja Anna,37,0,40,3
1739707250771,CHEM 40B,A01,862066,Weizman; Haim,29,0,40,11
1739707250771,CHEM 40B,A02,862067,Weizman; Haim,38,0,40,2
1739707250771,CHEM 40B,A03,862077,Weizman; Haim,40,0,40,0
1739707250771,CHEM 40B,A04,862085,Weizman; Haim,37,0,40,3
1739707250771,CHEM 40B,A05,862086,Weizman; Haim,34,0,40,6
1739707250771,CHEM 40B,A06,862087,Weizman; Haim,40,0,40,0
1739707250771,CHEM 40B,A07,862088,Weizman; Haim,39,0,40,1
1739707250771,CHEM 40B,A08,862089,Weizman; Haim,0,0,0,0
1739707251797,CHEM 41B,A01,860069,Klosterman; Jeremy K,32,0,40,8
1739707251797,CHEM 41B,A02,860074,Klosterman; Jeremy K,37,0,40,3
1739707251797,CHEM 41B,A03,860081,Klosterman; Jeremy K,39,0,40,1
1739707252877,CHEM 41C,A01,862090,Romero; Nathan A,39,0,40,1
1739707252877,CHEM 41C,A02,862091,Romero; Nathan A,40,0,40,0
1739707252877,CHEM 41C,A03,862092,Romero; Nathan A,39,0,40,1
1739707252877,CHEM 41C,A04,862213,Romero; Nathan A,39,0,40,1
1739707252877,CHEM 41C,A05,862214,Romero; Nathan A,38,0,40,2
1739707252877,CHEM 41C,A06,862215,Romero; Nathan A,40,0,40,0
1739707252877,CHEM 41C,A07,862216,Romero; Nathan A,38,0,40,2
1739707253914,CHEM 43A,A01,845450,Ternansky; Robert J.,15,0,24,9
1739707253914,CHEM 43A,A02,845676,Ternansky; Robert J.,21,0,24,3
1739707253914,CHEM 43A,A03,845679,Ternansky; Robert J.,21,0,24,3
1739707253914,CHEM 43A,A04,845682,Ternansky; Robert J.,23,0,24,1
1739707253914,CHEM 43A,A05,845684,Ternansky; Robert J.,22,0,24,2
1739707253914,CHEM 43A,A06,845686,Ternansky; Robert J.,19,0,24,5
1739707253914,CHEM 43A,A07,845692,Ternansky; Robert J.,22,0,24,2
1739707253914,CHEM 43A,A08,845694,Ternansky; Robert J.,17,0,24,7
1739707253914,CHEM 43A,A09,845697,Ternansky; Robert J.,24,0,24,0
1739707253914,CHEM 43A,A10,845698,Ternansky; Robert J.,23,0,24,1
1739707253914,CHEM 43A,A11,845700,Ternansky; Robert J.,23,0,24,1
1739707253914,CHEM 43A,A12,845702,Ternansky; Robert J.,24,0,24,0
1739707253914,CHEM 43A,A13,845704,Ternansky; Robert J.,22,0,24,2
1739707253914,CHEM 43A,B01,845707,Ternansky; Robert J.,23,0,24,1
1739707253914,CHEM 43A,B02,845712,Ternansky; Robert J.,22,0,24,2
1739707253914,CHEM 43A,B03,845794,Ternansky; Robert J.,14,0,24,10
1739707253914,CHEM 43A,B04,845797,Ternansky; Robert J.,20,0,24,4
1739707253914,CHEM 43A,B05,845800,Ternansky; Robert J.,22,0,24,2
1739707253914,CHEM 43A,B06,845801,Ternansky; Robert J.,20,0,24,4
1739707253914,CHEM 43A,B07,845816,Ternansky; Robert J.,21,0,24,3
1739707253914,CHEM 43A,B08,845817,Ternansky; Robert J.,19,0,24,5
1739707253914,CHEM 43A,B09,845827,Ternansky; Robert J.,23,0,24,1
1739707253914,CHEM 43A,B10,845832,Ternansky; Robert J.,22,0,24,2
1739707253914,CHEM 43A,B11,845866,Ternansky; Robert J.,22,0,24,2
1739707253914,CHEM 43A,B12,845867,Ternansky; Robert J.,21,0,24,3
1739707254941,CHEM 96,A00,845868,Brydges; Stacey,18,0,20,2
1739707255968,CHEM 100A,A01,845921,Staff,0,0,0,0
1739707255968,CHEM 100A,A02,845922,Staff,0,0,0,0
1739707255968,CHEM 100A,A03,845983,Staff,0,0,0,0
1739707255968,CHEM 100A,A04,845984,Staff,0,0,0,0
1739707255968,CHEM 100A,A05,845985,Staff,0,0,0,0
1739707255968,CHEM 100A,A06,845986,Staff,0,0,0,0
1739707256993,CHEM 100B,A01,845988,Pomeroy; Robert S.,27,0,30,3
1739707258018,CHEM 105A,A01,845991,Young; Mark,33,0,40,7
1739707259042,CHEM 108,A01,845993,Mrse; Anthony Adrian,18,0,20,2
1739707259042,CHEM 108,A02,845994,Mrse; Anthony Adrian,18,0,24,6
1739707259042,CHEM 108,B01,845996,Mrse; Anthony Adrian,16,0,20,4
1739707259042,CHEM 108,B02,845997,Mrse; Anthony Adrian,23,0,24,1
1739707260072,CHEM 109,A01,845999,McHugh; Colleen A,11,0,20,9
1739707260072,CHEM 109,A02,846000,McHugh; Colleen A,24,0,24,0
1739707260072,CHEM 109,B01,846002,McHugh; Colleen A,18,0,20,2
1739707260072,CHEM 109,B02,846003,McHugh; Colleen A,23,0,24,1
1739707261097,CHEM 114B,A01,862223,Mishanina; Tatiana V,37,0,40,3
1739707261097,CHEM 114B,A02,862224,Mishanina; Tatiana V,40,0,40,0
1739707261097,CHEM 114B,A03,862225,Mishanina; Tatiana V,40,0,40,0
1739707262123,CHEM 114C,A01,859769,Joseph; Simpson,35,0,40,5
1739707262123,CHEM 114C,A02,859782,Joseph; Simpson,29,0,40,11
1739707262123,CHEM 114C,A03,859790,Joseph; Simpson,25,0,40,15
1739707262123,CHEM 114C,A04,859791,Joseph; Simpson,40,0,40,0
1739707262123,CHEM 114C,A05,859793,Joseph; Simpson,37,0,40,3
1739707262123,CHEM 114C,A06,859804,Joseph; Simpson,37,0,40,3
1739707262123,CHEM 114C,A07,859805,Joseph; Simpson,0,0,0,0
1739707262123,CHEM 114C,A08,859810,Joseph; Simpson,0,0,0,0
1739707263151,CHEM 114D,A00,846006,Ghosh; Gourisankar,19,0,25,6
1739707264189,CHEM 118,A01,862235,Donoghue; Daniel J.,28,0,40,12
1739707264189,CHEM 118,A02,862236,Donoghue; Daniel J.,38,0,40,2
1739707264189,CHEM 118,A03,862238,Donoghue; Daniel J.,28,0,40,12
1739707264189,CHEM 118,A04,862240,Donoghue; Daniel J.,39,0,40,1
1739707264189,CHEM 118,A05,862242,Donoghue; Daniel J.,39,0,40,1
1739707264189,CHEM 118,A06,862243,Donoghue; Daniel J.,39,0,40,1
1739707265215,CHEM 120B,A01,859811,Staff,32,0,40,8
1739707265215,CHEM 120B,A02,859812,Staff,39,0,40,1
1739707265215,CHEM 120B,A03,859813,Staff,0,0,0,0
1739707266239,CHEM 123,A00,846009,Schimpf; Alina M,0,0,0,2
1739707267267,CHEM 125,A00,846010,Tezcan; Faik,17,0,20,3
1739707268292,CHEM 126B,A01,859888,Tauber; Michael,27,0,40,13
1739707268292,CHEM 126B,A02,859927,Tauber; Michael,0,0,0,0
1739707269315,CHEM 132,A01,862270,Tauber; Michael,39,0,40,1
1739707269315,CHEM 132,A02,862271,Tauber; Michael,36,0,40,4
1739707270340,CHEM 135,A01,860846,Xiong; Wei,14,0,15,1
1739707271364,CHEM 143B,A01,846015,Klosterman; Jeremy K,20,0,24,4
1739707271364,CHEM 143B,A02,846016,Klosterman; Jeremy K,15,0,24,9
1739707272391,CHEM 156,A00,846017,Romero; Erik Anthony,29,0,30,1
1739707273417,CHEM 157,A00,846018,Tor; Yitzhak,74,0,80,6
1739707274443,CHEM 158,A00,846020,Molinski; Tadeusz,9,0,10,1
1739707275469,CHEM 167,A01,862285,Deshmukh; Lalit,36,0,40,4
1739707275469,CHEM 167,A02,862286,Deshmukh; Lalit,39,0,40,1
1739707275469,CHEM 167,A03,862287,Deshmukh; Lalit,37,0,40,3
1739707275469,CHEM 167,A04,862288,Deshmukh; Lalit,39,0,40,1
1739707276496,CHEM 173,A00,846023,Young; Mark,36,0,40,4
1739707277523,CHEM 174,A01,851594,Pomeroy; Robert S.,58,0,60,2
1739707278548,CHEM 185,A00,846025,Paesani; Francesco,21,0,26,5
1739707279573,CHEM 188,A00,846026,Brydges; Stacey,20,0,20,0
1739707280601,CHEM 207,A00,846088,Deshmukh; Lalit,23,0,30,7
1739707281625,CHEM 214,A00,846089,Ghosh; Gourisankar,5,0,15,10
1739707282652,CHEM 217,A00,846092,Joseph; Simpson,15,0,30,15
1739707283677,CHEM 225,A00,846095,Tezcan; Faik,5,0,10,5
1739707284701,CHEM 227,A00,846097,Schimpf; Alina M,30,0,30,0
1739707285726,CHEM 229,A00,846100,Stauber; Julia Megan,19,0,20,1
1739707286754,CHEM 235,A01,860847,Xiong; Wei,17,0,20,3
1739707287781,CHEM 236,A00,846106,Kummel; Andrew C,5,0,15,10
1739707288807,CHEM 237,A00,872555,Esko; Jeffrey D.,7,0,7,0
1739707289835,CHEM 250,A00,846107,Weizman; Haim,0,0,0,0
1739707290862,CHEM 256,A00,846108,Romero; Erik Anthony,20,0,20,0
1739707291890,CHEM 257,A00,846109,Tor; Yitzhak,28,0,30,2
1739707292913,CHEM 258,A00,846110,Molinski; Tadeusz,13,0,15,2
1739707293938,CHEM 262,A00,846111,Kubiak; Clifford Paul,26,0,30,4
1739707294965,CHEM 273,A00,846118,Young; Mark,15,0,20,5
1739707295993,CHEM 276,A00,846119,Mc Culloch; Andrew Douglas,4,0,5,1
1739707297020,CHEM 283,A00,846120,Ghassemian; Majid,10,0,10,0
1739707298049,CHEM 285,A00,846121,Paesani; Francesco,18,0,20,2
1739707299076,CHEM 291,A00,846122,Debelouchina; Galia T,20,0,20,0
1739707300100,CHEM 294,A00,846123,Pun; Andrew Brian,48,0,50,2
1739707301129,CHIN 10CD,A01,809156,Liu; Mingming,17,0,17,0
1739707301129,CHIN 10CD,A02,809192,Liu; Mingming,18,0,18,0
1739707302155,CHIN 10CM,A01,809196,Chen; Pei-Chia,15,0,15,0
1739707302155,CHIN 10CM,A02,809197,Chen; Pei-Chia,19,0,20,1
1739707303179,CHIN 10CN,A01,809203,Xu; Li,12,0,14,2
1739707303179,CHIN 10CN,A03,809218,Xu; Li,14,0,14,0
1739707303179,CHIN 10CN,B01,809296,Xu; Li,13,0,14,1
1739707303179,CHIN 10CN,B02,809307,Xu; Li,10,0,14,4
1739707303179,CHIN 10CN,B03,809361,Xu; Li,14,0,14,0
1739707304207,CHIN 20CM,A01,809437,Wang; Xiao,10,0,10,0
1739707304207,CHIN 20CM,A02,809458,Wang; Xiao,10,0,10,0
1739707305234,CHIN 20CN,A01,809462,Anderson; Qin-Hong,12,0,12,0
1739707305234,CHIN 20CN,A02,809463,Anderson; Qin-Hong,12,0,12,0
1739707305234,CHIN 20CN,A03,871383,Anderson; Qin-Hong,12,0,12,0
1739707305234,CHIN 20CN,B01,809488,Anderson; Qin-Hong,12,0,12,0
1739707306260,CHIN 100CM,A00,809489,Anderson; Qin-Hong,23,0,24,1
1739707307286,CHIN 100CN,A00,809490,Chen; Pei-Chia,24,0,24,0
1739707308311,CHIN 169B,A00,809720,Wang; Xiao,20,0,20,0
1739707309335,CHIN 182B,A00,809728,Liu; Mingming,17,0,20,3
1739707310359,CLAS 196B,A00,869154,Myerston Santana; Jacobo,1,0,1,0
1739707311387,CLIN 294C,A00,870690,Wierenga; Christina E & Banks; Sarah Jane,20,0,20,0
1739707312412,CLIN 296,001,870694,Brookman; Lauren Irene,100,0,100,0
1739707312412,CLIN 296,002,870695,Brookman; Lauren Irene,10,0,10,0
1739707312412,CLIN 296,003,870696,Wall; Tamara Lynn,100,0,100,0
1739707313435,CLRE 238R,A00,809924,Mehta; Ravindra L.,9999,0,9999,0
1739707314459,CLRE 254,A00,809952,Vaida; Florin,9999,0,9999,0
1739707315484,CLRE 255,A01,809989,Cuomo; Raphael Eduardo,9999,0,9999,0
1739707316512,CLRE 256,A01,810211,Morris; Sheldon,9999,0,9999,0
1739707317540,CLRE 257,A00,810214,Mehta; Ravindra L.,9999,0,9999,0
1739707318564,CLRE 258,A00,810216,Mehta; Ravindra L.,9999,0,9999,0
1739707319589,CLRE 260,A00,810217,Cuomo; Raphael Eduardo,9999,0,9999,0
1739707320615,CLRE 265,A00,810220,Vaida; Florin,9999,0,9999,0
1739707321642,CLRE 297,001,810222,Cuomo; Raphael Eduardo,9999,0,9999,0
1739707322667,CLX 87,A00,809115,Castro; Robert Jess,20,0,20,0
1739707323690,CMM 225,A00,872556,Esko; Jeffrey D.,7,0,7,0
1739707324713,CMM 246,A00,872560,Gordts; Philip & Lewis; Amanda Lark & Godula; Kamil & Gagneux; Pascal & Esko; Jeffrey D. & Bode; Lars,10,0,10,0
1739707325738,CMM 250,A00,884466,Willert; Karl Heinrich,60,0,60,0
1739707326765,COGR 201D,A00,808201,Serlin; David,10,0,10,0
1739707327794,COGR 219,A00,808207,Harb; Anthony Joseph,5,0,10,5
1739707328820,COGR 225B,A00,808212,Gere; Catherina M.,10,0,10,0
1739707329843,COGR 225C,A00,808214,McKenzie; Kerry V.,10,0,10,0
1739707330868,COGR 275,A00,808219,Jack; Caroline Sarah,8,0,10,2
1739707331897,COGR 296,A00,808221,Ybarra; Megan,5,0,5,0
1739707332955,COGS 1,A01,810294,Deak; Gedeon O.,58,0,60,2
1739707332955,COGS 1,A02,810296,Deak; Gedeon O.,57,0,60,3
1739707332955,COGS 1,A03,810298,Deak; Gedeon O.,56,0,60,4
1739707332955,COGS 1,A04,810299,Deak; Gedeon O.,57,0,60,3
1739707332955,COGS 1,A05,810300,Deak; Gedeon O.,60,0,60,0
1739707332955,COGS 1,A06,810301,Deak; Gedeon O.,59,0,60,1
1739707332955,COGS 1,A07,810302,Deak; Gedeon O.,57,0,57,0
1739707333985,COGS 2,A01,810304,Boyle; Mary E. T.,54,0,56,2
1739707333985,COGS 2,A02,810305,Boyle; Mary E. T.,56,0,56,0
1739707333985,COGS 2,A03,810307,Boyle; Mary E. T.,54,0,56,2
1739707333985,COGS 2,A04,810309,Boyle; Mary E. T.,57,0,60,3
1739707333985,COGS 2,A05,810310,Boyle; Mary E. T.,67,0,67,0
1739707335014,COGS 9,A01,810312,Shannon; Kyle Michael,49,0,50,1
1739707335014,COGS 9,A02,810313,Shannon; Kyle Michael,49,0,50,1
1739707335014,COGS 9,A03,810314,Shannon; Kyle Michael,49,0,50,1
1739707335014,COGS 9,A04,810316,Shannon; Kyle Michael,50,0,50,0
1739707335014,COGS 9,A05,810320,Shannon; Kyle Michael,50,0,50,0
1739707335014,COGS 9,A06,810321,Shannon; Kyle Michael,49,0,50,1
1739707336039,COGS 11,A01,810324,Boroditsky; Lera,134,0,140,6
1739707337064,COGS 13,A01,810328,Rossano; Federico,42,0,50,8
1739707337064,COGS 13,A02,810329,Rossano; Federico,48,0,49,1
1739707337064,COGS 13,A03,810330,Rossano; Federico,48,0,50,2
1739707337064,COGS 13,A04,810331,Rossano; Federico,48,0,49,1
1739707337064,COGS 13,A05,810332,Rossano; Federico,48,0,49,1
1739707337064,COGS 13,A06,810333,Rossano; Federico,49,0,49,0
1739707338089,COGS 14A,A01,810335,Barrera; Steven James,45,0,50,5
1739707338089,COGS 14A,A02,810336,Barrera; Steven James,47,0,50,3
1739707338089,COGS 14A,A03,810338,Barrera; Steven James,49,0,50,1
1739707338089,COGS 14A,A04,810339,Barrera; Steven James,56,0,60,4
1739707338089,COGS 14A,A05,810340,Barrera; Steven James,50,0,50,0
1739707338089,COGS 14A,A06,810341,Barrera; Steven James,50,0,50,0
1739707338089,COGS 14A,A07,810343,Barrera; Steven James,54,0,56,2
1739707339118,COGS 14B,A01,810346,Hoffman; Drew Ellen,54,0,57,3
1739707339118,COGS 14B,A02,810347,Hoffman; Drew Ellen,55,0,55,0
1739707339118,COGS 14B,A03,810348,Hoffman; Drew Ellen,52,0,55,3
1739707339118,COGS 14B,A04,810350,Hoffman; Drew Ellen,54,0,55,1
1739707339118,COGS 14B,A05,810351,Hoffman; Drew Ellen,53,0,55,2
1739707340142,COGS 17,A01,810353,Johnson; Christine M.,49,0,50,1
1739707340142,COGS 17,A02,810354,Johnson; Christine M.,48,0,50,2
1739707340142,COGS 17,A03,810356,Johnson; Christine M.,48,0,50,2
1739707340142,COGS 17,A04,810357,Johnson; Christine M.,47,0,50,3
1739707340142,COGS 17,A05,810359,Johnson; Christine M.,49,0,50,1
1739707340142,COGS 17,A06,810360,Johnson; Christine M.,50,0,50,0
1739707340142,COGS 17,A07,810361,Johnson; Christine M.,52,0,55,3
1739707340142,COGS 17,A08,810362,Johnson; Christine M.,54,0,55,1
1739707341174,COGS 18,A01,810366,Ellis; Shannon Elizabeth,31,0,35,4
1739707341174,COGS 18,A02,810367,Ellis; Shannon Elizabeth,31,0,35,4
1739707341174,COGS 18,A03,810371,Ellis; Shannon Elizabeth,30,0,35,5
1739707341174,COGS 18,A04,810372,Ellis; Shannon Elizabeth,34,0,35,1
1739707341174,COGS 18,A05,810373,Ellis; Shannon Elizabeth,32,0,35,3
1739707341174,COGS 18,A06,810374,Ellis; Shannon Elizabeth,35,0,35,0
1739707341174,COGS 18,A07,810375,Ellis; Shannon Elizabeth,35,0,35,0
1739707341174,COGS 18,A08,810376,Ellis; Shannon Elizabeth,34,0,35,1
1739707341174,COGS 18,A09,810377,Ellis; Shannon Elizabeth,35,0,35,0
1739707341174,COGS 18,B01,810379,Ellis; Shannon Elizabeth,33,0,35,2
1739707341174,COGS 18,B02,810384,Ellis; Shannon Elizabeth,34,0,35,1
1739707341174,COGS 18,B03,810385,Ellis; Shannon Elizabeth,34,0,35,1
1739707341174,COGS 18,B04,810388,Ellis; Shannon Elizabeth,34,0,35,1
1739707341174,COGS 18,B05,810389,Ellis; Shannon Elizabeth,31,0,35,4
1739707341174,COGS 18,B06,810390,Ellis; Shannon Elizabeth,31,0,35,4
1739707341174,COGS 18,B07,810392,Ellis; Shannon Elizabeth,34,0,35,1
1739707341174,COGS 18,B08,810393,Ellis; Shannon Elizabeth,34,0,35,1
1739707341174,COGS 18,B09,810395,Ellis; Shannon Elizabeth,32,0,35,3
1739707342198,COGS 87,A00,810426,Deak; Gedeon O.,20,0,20,0
1739707343228,COGS 100,A01,810564,Morgan; Eric,49,0,56,7
1739707343228,COGS 100,A02,810582,Morgan; Eric,54,0,56,2
1739707343228,COGS 100,A03,810589,Morgan; Eric,55,0,56,1
1739707343228,COGS 100,A04,810651,Morgan; Eric,54,0,56,2
1739707343228,COGS 100,A05,810684,Morgan; Eric,56,0,56,0
1739707343228,COGS 100,A06,810690,Morgan; Eric,54,0,56,2
1739707344252,COGS 101A,A01,810697,Morgan; Eric,49,0,50,1
1739707344252,COGS 101A,A02,810701,Morgan; Eric,49,0,50,1
1739707344252,COGS 101A,A03,810707,Morgan; Eric,49,0,50,1
1739707344252,COGS 101A,A04,810708,Morgan; Eric,50,0,50,0
1739707345281,COGS 101B,A01,810716,Barrera; Steven James,49,0,50,1
1739707345281,COGS 101B,A02,810718,Barrera; Steven James,45,0,50,5
1739707345281,COGS 101B,A03,810719,Barrera; Steven James,47,0,50,3
1739707345281,COGS 101B,A04,810730,Barrera; Steven James,38,0,50,12
1739707346313,COGS 101C,A01,810737,Cooperrider; Kensy A,50,0,50,0
1739707346313,COGS 101C,A02,810742,Cooperrider; Kensy A,43,0,50,7
1739707346313,COGS 101C,A03,810743,Cooperrider; Kensy A,48,0,50,2
1739707347362,COGS 102A,A01,810750,Allen; Michael Gordon,49,0,50,1
1739707347362,COGS 102A,A02,810751,Allen; Michael Gordon,50,0,50,0
1739707347362,COGS 102A,A03,810754,Allen; Michael Gordon,44,0,49,5
1739707348399,COGS 107A,A01,810756,Boyle; Mary E. T.,54,0,56,2
1739707348399,COGS 107A,A02,810757,Boyle; Mary E. T.,52,0,56,4
1739707348399,COGS 107A,A03,810760,Boyle; Mary E. T.,55,0,56,1
1739707348399,COGS 107A,A04,810767,Boyle; Mary E. T.,54,0,56,2
1739707348399,COGS 107A,A05,810769,Boyle; Mary E. T.,54,0,56,2
1739707348399,COGS 107A,A06,810777,Boyle; Mary E. T.,55,0,56,1
1739707349433,COGS 107B,A03,810800,Mooshagian; Eric Frederick,41,0,50,9
1739707349433,COGS 107B,A04,810810,Mooshagian; Eric Frederick,33,0,50,17
1739707349433,COGS 107B,A05,810811,Mooshagian; Eric Frederick,44,0,50,6
1739707350467,COGS 107C,A01,810815,Chiba; Andrea,41,0,47,6
1739707350467,COGS 107C,A02,810816,Chiba; Andrea,35,0,50,15
1739707350467,COGS 107C,A03,810853,Chiba; Andrea,44,0,49,5
1739707351499,COGS 108,A01,810862,Fleischer; Jason G,42,0,50,8
1739707351499,COGS 108,A02,810870,Fleischer; Jason G,42,0,50,8
1739707351499,COGS 108,A03,810871,Fleischer; Jason G,50,0,50,0
1739707351499,COGS 108,A04,810874,Fleischer; Jason G,49,0,50,1
1739707351499,COGS 108,A05,810876,Fleischer; Jason G,47,0,50,3
1739707351499,COGS 108,A06,810879,Fleischer; Jason G,48,0,50,2
1739707351499,COGS 108,A07,810896,Fleischer; Jason G,50,0,50,0
1739707351499,COGS 108,B01,810950,Fleischer; Jason G,54,0,56,2
1739707351499,COGS 108,B02,810960,Fleischer; Jason G,54,0,56,2
1739707351499,COGS 108,B03,810961,Fleischer; Jason G,52,0,56,4
1739707351499,COGS 108,B04,810962,Fleischer; Jason G,43,0,60,17
1739707351499,COGS 108,B05,810963,Fleischer; Jason G,58,0,60,2
1739707351499,COGS 108,B06,810964,Fleischer; Jason G,57,0,60,3
1739707351499,COGS 108,B07,810965,Fleischer; Jason G,62,0,62,0
1739707353555,COGS 112,A01,811001,Hoffman; Drew Ellen,33,0,50,17
1739707353555,COGS 112,A02,811020,Hoffman; Drew Ellen,42,0,50,8
1739707353555,COGS 112,A03,811045,Hoffman; Drew Ellen,44,0,50,6
1739707353555,COGS 112,A04,811047,Hoffman; Drew Ellen,49,0,50,1
1739707354579,COGS 124,A00,811065,Guo; Philip J,1,0,25,24
1739707355606,COGS 125,A00,811079,Klemmer; Scott R,43,0,50,7
1739707356686,COGS 142,A01,811081,Rossano; Federico,50,0,50,0
1739707357710,COGS 143,A01,811108,Staff,46,0,50,4
1739707358741,COGS 150,A01,811185,Trott; Sean Thomas,35,0,50,15
1739707358741,COGS 150,A02,811319,Trott; Sean Thomas,50,0,50,0
1739707358741,COGS 150,A03,811360,Trott; Sean Thomas,41,0,49,8
1739707359766,COGS 157,A00,811371,Creel; Sarah,66,0,75,9
1739707360793,COGS 160,A00,872440,Saygin; Ayse P,29,0,30,1
1739707360793,COGS 160,B00,872441,Saygin; Ayse P,30,0,30,0
1739707360793,COGS 160,C00,872442,Kirsh; David Joel,30,0,30,0
1739707361821,COGS 172,A01,811389,Greene; Deanna Jacquelyn,46,0,50,4
1739707361821,COGS 172,A02,811390,Greene; Deanna Jacquelyn,48,0,50,2
1739707361821,COGS 172,A03,811391,Greene; Deanna Jacquelyn,45,0,50,5
1739707361821,COGS 172,A04,811392,Greene; Deanna Jacquelyn,47,0,50,3
1739707363871,COGS 179,A01,811401,Staff,43,0,50,7
1739707364899,COGS 184,A01,811403,Johnson; Christine M.,46,0,50,4
1739707365928,COGS 185,A01,811514,Tu; Zhuowen,38,0,50,12
1739707365928,COGS 185,A02,811580,Tu; Zhuowen,46,0,50,4
1739707366956,COGS 187A,A01,811589,Allen; Michael Gordon,45,0,50,5
1739707366956,COGS 187A,A02,811590,Allen; Michael Gordon,46,0,50,4
1739707366956,COGS 187A,A03,811591,Allen; Michael Gordon,44,0,49,5
1739707367984,COGS 190C,001,811592,Chiba; Andrea,9999,0,9999,0
1739707367984,COGS 190C,002,811601,Fleischer; Jason G,9999,0,9999,0
1739707367984,COGS 190C,003,811602,Boyle; Mary E. T.,9999,0,9999,0
1739707367984,COGS 190C,004,811604,Nitz; Douglas A.,9999,0,9999,0
1739707367984,COGS 190C,005,811605,Rangel; Lara M,9999,0,9999,0
1739707367984,COGS 190C,006,811609,Hoffman; Drew Ellen,9999,0,9999,0
1739707367984,COGS 190C,007,811610,Deak; Gedeon O.,9999,0,9999,0
1739707367984,COGS 190C,008,811613,Kiyonaga; Anastasia,9999,0,9999,0
1739707367984,COGS 190C,009,811716,Creel; Sarah,9999,0,9999,0
1739707367984,COGS 190C,010,811733,Voytek; Bradley Thomas,9999,0,9999,0
1739707367984,COGS 190C,011,811836,Beatty-Martinez; Anne,9999,0,9999,0
1739707367984,COGS 190C,012,811838,De Sa; Virginia,9999,0,9999,0
1739707367984,COGS 190C,013,811839,Kirsh; David Joel,9999,0,9999,0
1739707367984,COGS 190C,014,811843,Jernigan; Terry Lynne,9999,0,9999,0
1739707367984,COGS 190C,015,811844,Tu; Zhuowen,9999,0,9999,0
1739707369009,COGS 190D,A00,811922,Voytek; Bradley Thomas,25,0,25,0
1739707370035,COGS 194,A00,811949,Hill; Seth J,9999,0,9999,0
1739707371064,COGS 202,A00,872444,Khosla; Meenakshi,12,0,25,13
1739707372091,COGS 205,A00,812100,Chiba; Andrea,20,0,20,0
1739707373115,COGS 209,A00,812101,Mukamel; Eran A,25,0,46,21
1739707374141,COGS 210C,A00,812186,Kirsh; David Joel,9999,0,9999,0
1739707374141,COGS 210C,B00,812192,Greene; Deanna Jacquelyn,9999,0,9999,0
1739707374141,COGS 210C,C00,812199,Xia; Haijun,9999,0,9999,0
1739707374141,COGS 210C,D00,812206,Nitz; Douglas A.,9999,0,9999,0
1739707374141,COGS 210C,E00,812207,Hollan; James D.,9999,0,9999,0
1739707374141,COGS 210C,F00,812260,De Sa; Virginia,9999,0,9999,0
1739707374141,COGS 210C,G00,812261,Rossano; Federico,9999,0,9999,0
1739707374141,COGS 210C,H00,812262,Kiyonaga; Anastasia,9999,0,9999,0
1739707374141,COGS 210C,I00,812263,Guo; Philip J,9999,0,9999,0
1739707374141,COGS 210C,J00,812264,Dow; Steven P,9999,0,9999,0
1739707374141,COGS 210C,K00,812265,Bergen; Benjamin,9998,0,9999,1
1739707374141,COGS 210C,L00,812266,Coulson; Seana M,9999,0,9999,0
1739707374141,COGS 210C,M00,812267,Rangel; Lara M,9999,0,9999,0
1739707375166,COGS 211C,A00,812268,Boroditsky; Lera,19,0,20,1
1739707376192,COGS 229,A00,812269,Irani; Lilly C & Shvartzberg Carrio; Manuel,10,0,10,0
1739707377215,COGS 231,A00,812270,Guo; Philip J,0,0,20,20
1739707378240,COGS 238,A00,812271,Bergen; Benjamin,18,0,20,2
1739707379297,COMM 10,A01,807316,Whitworth-Smith; Andrew C,22,0,23,1
1739707379297,COMM 10,A02,807320,Whitworth-Smith; Andrew C,23,0,23,0
1739707379297,COMM 10,A03,807321,Whitworth-Smith; Andrew C,23,0,23,0
1739707379297,COMM 10,A04,807324,Whitworth-Smith; Andrew C,23,0,23,0
1739707379297,COMM 10,A05,807328,Whitworth-Smith; Andrew C,17,0,23,6
1739707379297,COMM 10,A06,807329,Whitworth-Smith; Andrew C,21,0,23,2
1739707379297,COMM 10,A07,807330,Whitworth-Smith; Andrew C,21,0,23,2
1739707379297,COMM 10,A08,807333,Whitworth-Smith; Andrew C,21,0,22,1
1739707379297,COMM 10,A09,807334,Whitworth-Smith; Andrew C,23,0,23,0
1739707379297,COMM 10,A11,807363,Whitworth-Smith; Andrew C,0,0,0,0
1739707379297,COMM 10,A12,807364,Whitworth-Smith; Andrew C,0,0,0,0
1739707379297,COMM 10,A13,807366,Whitworth-Smith; Andrew C,23,0,23,0
1739707379297,COMM 10,A15,807374,Whitworth-Smith; Andrew C,0,0,0,0
1739707379297,COMM 10,A16,807427,Whitworth-Smith; Andrew C,23,0,23,0
1739707379297,COMM 10,A17,807428,Whitworth-Smith; Andrew C,23,0,23,0
1739707379297,COMM 10,A18,807429,Whitworth-Smith; Andrew C,0,0,0,0
1739707380323,COMM 20,A01,807435,Hill; Erin Truesdell,72,0,75,3
1739707381349,COMM 30,A00,807436,Metcalf; Kathryne Young,73,0,75,2
1739707382377,COMM 50,A00,807438,Armenta; John E,22,0,25,3
1739707383402,COMM 80,A01,807440,Campbell; Robert Harold,0,0,0,0
1739707384429,COMM 100B,A01,807446,Serlin; David,20,0,25,5
1739707384429,COMM 100B,A02,807447,Serlin; David,23,0,25,2
1739707384429,COMM 100B,A03,807450,Serlin; David,25,0,25,0
1739707384429,COMM 100B,A05,807453,Serlin; David,23,0,25,2
1739707384429,COMM 100B,A06,807454,Serlin; David,25,0,25,0
1739707384429,COMM 100B,A07,807455,Serlin; David,18,0,25,7
1739707384429,COMM 100B,A08,807458,Serlin; David,22,0,25,3
1739707384429,COMM 100B,A09,807459,Serlin; David,21,0,25,4
1739707384429,COMM 100B,A10,807462,Serlin; David,25,0,25,0
1739707384429,COMM 100B,A11,807464,Serlin; David,25,0,25,0
1739707385459,COMM 101,A01,807470,Davis; Zeinabu I.,15,0,15,0
1739707385459,COMM 101,A02,807513,Davis; Zeinabu I.,15,0,15,0
1739707385459,COMM 101,A03,807516,Davis; Zeinabu I.,15,0,15,0
1739707385459,COMM 101,A04,807517,Davis; Zeinabu I.,14,0,15,1
1739707386488,COMM 101D,A00,807570,Halm; Gavin Patrick,18,0,18,0
1739707387512,COMM 101K,A00,807571,Martinico; Daniel J,16,0,16,0
1739707388540,COMM 101N,A00,807572,Martinico; Daniel J,16,0,16,0
1739707389567,COMM 101T,A00,807573,Halm; Gavin Patrick,17,0,18,1
1739707389567,COMM 101T,B00,807588,Dewey; Matthew D,10,0,10,0
1739707389567,COMM 101T,C00,807592,Dewey; Matthew D,9,0,10,1
1739707390593,COMM 102C,A01,807604,Campion; Camille E,6,0,6,0
1739707390593,COMM 102C,A02,807605,Campion; Camille E,6,0,6,0
1739707390593,COMM 102C,A03,807612,Campion; Camille E,3,0,6,3
1739707391620,COMM 102M,A01,807638,Ahn; Patricia Jeehyun,9,0,9,0
1739707391620,COMM 102M,A02,807639,Ahn; Patricia Jeehyun,7,0,9,2
1739707392646,COMM 106F,A00,807672,McKenna; Denise,69,0,75,6
1739707393672,COMM 106I,A00,807926,Irani; Lilly C,71,0,75,4
1739707394697,COMM 109P,A00,807927,Jack; Caroline Sarah,40,0,40,0
1739707395721,COMM 110M,A00,807928,Abuelhiga; Soraya Jill,40,0,40,0
1739707396746,COMM 113T,A00,807929,Dominguez Rubio; Fernando,39,0,40,1
1739707397771,COMM 114A,A00,807930,Zilberg; Elana,37,0,40,3
1739707398797,COMM 114F,A00,808016,Rojo Solis; Juan Jose,38,0,40,2
1739707399823,COMM 114P,A00,808034,Abuelhiga; Soraya Jill,38,0,40,2
1739707400847,COMM 114W,A00,808035,Walkover; Lillian B,17,0,20,3
1739707401872,COMM 115,A00,808037,Alac; Morana,33,0,35,2
1739707402900,COMM 132,A00,808058,McKenna; Denise,37,0,40,3
1739707403923,COMM 139,A00,808063,Davis; Zeinabu I.,22,0,30,8
1739707404949,COMM 143,A00,808064,Rojo Solis; Juan Jose,38,0,40,2
1739707405972,COMM 146,A00,808068,Ahn; Patricia Jeehyun,34,0,35,1
1739707407000,COMM 155,A00,808072,Pavon Aramburu; Maria Laur,39,0,40,1
1739707408026,COMM 158,A00,808073,Fields; Gary,40,0,40,0
1739707409051,COMM 171,A00,808082,Zilberg; Elana,24,0,25,1
1739707410077,COMM 172,A00,808083,Staff,23,0,25,2
1739707411101,COMM 173,A00,808091,Alac; Morana,25,0,25,0
1739707412126,COMM 180,A00,808162,Leuning; Grant Maurstad,25,0,25,0
1739707413153,COMM 190,A00,808168,Dominguez Rubio; Fernando,22,0,23,1
1739707413153,COMM 190,B00,808169,Harb; Anthony Joseph,22,0,23,1
1739707413153,COMM 190,C00,808170,Rojo Solis; Juan Jose,22,0,23,1
1739707413153,COMM 190,D00,870218,Boateng; Boatema,22,0,23,1
1739707414179,COMM 194,A00,851599,Staff,0,0,0,0
1739707415208,CSE 6R,A01,842851,Moshiri; Niema,142,0,149,7
1739707415208,CSE 6R,B01,876602,Moshiri; Niema,50,0,50,0
1739707416231,CSE 8A,A50,842974,Porter; Leonard Emerson,38,0,38,0
1739707416231,CSE 8A,A51,843001,Porter; Leonard Emerson,37,0,38,1
1739707416231,CSE 8A,A52,843011,Porter; Leonard Emerson,38,0,38,0
1739707416231,CSE 8A,A53,843012,Porter; Leonard Emerson,37,0,38,1
1739707416231,CSE 8A,A54,874345,Porter; Leonard Emerson,38,0,38,0
1739707416231,CSE 8A,A55,874414,Porter; Leonard Emerson,35,0,38,3
1739707416231,CSE 8A,A56,874418,Porter; Leonard Emerson,38,0,38,0
1739707417259,CSE 11,A01,860850,Ochoa; Benjamin Lawrence,300,0,320,20
1739707418285,CSE 12,A01,860851,Cao; Yingjun,117,0,120,3
1739707418285,CSE 12,B01,865865,Cao; Yingjun,109,0,120,11
1739707419309,CSE 20,A01,865892,Jones; Miles E,97,0,100,3
1739707419309,CSE 20,A02,865908,Jones; Miles E,97,0,100,3
1739707420333,CSE 21,A01,865911,Jones; Miles E,97,0,100,3
1739707420333,CSE 21,A02,865914,Jones; Miles E,94,0,100,6
1739707421365,CSE 29,A50,843454,Solares; Edwin A,9,0,10,1
1739707421365,CSE 29,A51,843459,Solares; Edwin A,10,0,10,0
1739707421365,CSE 29,A52,843460,Solares; Edwin A,8,0,10,2
1739707421365,CSE 29,A53,843549,Solares; Edwin A,5,0,5,0
1739707421365,CSE 29,B50,843559,Soosai Raj; Adalbert Geral,5,0,10,5
1739707421365,CSE 29,B51,843750,Soosai Raj; Adalbert Geral,4,0,10,6
1739707421365,CSE 29,B52,843757,Soosai Raj; Adalbert Geral,8,0,10,2
1739707421365,CSE 29,B53,843758,Soosai Raj; Adalbert Geral,4,0,5,1
1739707422389,CSE 30,A01,864415,Chin; Bryan W.,120,0,125,5
1739707422389,CSE 30,B01,864419,Chin; Bryan W.,99,0,100,1
1739707423415,CSE 87,A00,875925,Moshiri; Niema,20,0,20,0
1739707424438,CSE 89,A00,872519,Minnes Kemp; Mor Mia,100,0,100,0
1739707424438,CSE 89,B00,872520,Minnes Kemp; Mor Mia,100,0,100,0
1739707425464,CSE 95,A00,843802,Cao; Yingjun,100,0,100,0
1739707426493,CSE 100,A01,864420,Sahoo; Debashis,100,0,120,20
1739707427518,CSE 101,A01,860868,Impagliazzo; Russell,0,0,10,10
1739707427518,CSE 101,A02,860869,Impagliazzo; Russell,0,0,10,10
1739707427518,CSE 101,A03,860870,Impagliazzo; Russell,6,0,10,4
1739707428543,CSE 105,A01,864426,Lovett; Shachar,222,0,250,28
1739707429571,CSE 107,A01,864427,Bellare; Mihir,92,0,96,4
1739707430597,CSE 110,A50,843823,Powell; Thomas Allan,111,0,116,5
1739707430597,CSE 110,A51,843827,Powell; Thomas Allan,93,0,116,23
1739707430597,CSE 110,A52,843828,Powell; Thomas Allan,106,0,116,10
1739707431621,CSE 120,A01,860871,Ousterhout; Amy,299,0,328,29
1739707432646,CSE 124,A01,864431,Porter; George M,138,0,196,58
1739707433669,CSE 125,A00,843848,Voelker; Geoffrey M.,30,0,30,0
1739707434699,CSE 127,A01,865915,Fernandes; Earlence T,172,0,192,20
1739707435724,CSE 130,A01,865928,Polikarpova; Nadezhda,176,0,192,16
1739707436750,CSE 131,A01,865936,Ding; Yufei,65,0,75,10
1739707437779,CSE 140,A01,865937,Eldon; John,184,0,196,12
1739707438803,CSE 140L,A01,843892,Eldon; John,173,0,196,23
1739707439827,CSE 141,A01,865939,Pannuto; Patrick William,165,0,192,27
1739707440852,CSE 141L,A01,843910,Eldon; John,158,0,196,38
1739707441880,CSE 145,A00,843915,Kastner; Ryan Charles,25,0,25,0
1739707442907,CSE 150A,A01,860873,Bonjour; Trevor,181,0,196,15
1739707443933,CSE 150B,A01,864429,Gao; Sicun,329,0,362,33
1739707444962,CSE 151A,A01,860874,Dasgupta; Sanjoy,297,0,325,28
1739707445988,CSE 151B,A01,864435,Yu; Qi,164,0,192,28
1739707447013,CSE 152B,A01,874283,Chandraker; Manmohan Krishna,57,0,70,13
1739707448038,CSE 153,A01,872732,McAuley; Julian John,181,0,196,15
1739707449068,CSE 153R,A01,872798,McAuley; Julian John,215,0,250,35
1739707449068,CSE 153R,B01,877492,Staff,50,0,50,0
1739707450094,CSE 165,A01,844081,Weibel; Nadir,23,0,35,12
1739707451120,CSE 168,A01,860875,Ramamoorthi; Ravi,23,0,28,5
1739707451120,CSE 168,A02,860876,Ramamoorthi; Ravi,26,0,28,2
1739707452145,CSE 175,A01,865941,Kumar; Rakesh,50,0,50,0
1739707454206,CSE 182,A01,851596,Bafna; Vineet,44,0,49,5
1739707455237,CSE 185,A01,844113,Moshiri; Niema,25,0,45,20
1739707455237,CSE 185,A02,844118,Moshiri; Niema,38,0,45,7
1739707456261,CSE 190,A00,844121,Grier; Daniel T,52,0,52,0
1739707456261,CSE 190,B00,844124,Soosai Raj; Adalbert Geral,81,0,100,19
1739707456261,CSE 190,C00,881308,Prithviraj; Ammanabrolu,45,0,50,5
1739707456261,CSE 190,D00,844127,Stefan; Deian,50,0,50,0
1739707457285,CSE 191,A00,844133,Minnes Kemp; Mor Mia,9999,0,9999,0
1739707458312,CSE 205A,A00,844166,Vianu; Victor Dan,0,0,0,0
1739707459339,CSE 209A,A00,844205,Impagliazzo; Russell,0,0,0,0
1739707460417,CSE 209B,A00,844216,Bellare; Mihir,0,0,0,0
1739707461443,CSE 217,A01,844235,Weibel; Nadir,0,0,0,0
1739707462467,CSE 219,A00,844246,Irani; Lilly C & Shvartzberg Carrio; Manuel,0,0,0,0
1739707463491,CSE 223B,A00,844249,Snoeren; Alex C.,0,0,0,0
1739707464515,CSE 224,A01,864433,Porter; George M,0,0,0,0
1739707465540,CSE 227,A00,844270,Stefan; Deian,0,0,0,0
1739707466567,CSE 229A,A00,844274,Ousterhout; Amy,0,0,0,0
1739707467594,CSE 229C,A00,844280,Fernandes; Earlence T,0,0,0,0
1739707468618,CSE 230,A00,844311,D'Antoni; Loris,0,0,0,0
1739707469646,CSE 237D,A00,844312,Kastner; Ryan Charles,0,0,0,0
1739707470672,CSE 239A,A00,844313,Vianu; Victor Dan,0,0,0,0
1739707471698,CSE 239B,A00,844314,Coblenz; Michael J,0,0,0,0
1739707472722,CSE 240A,A00,844315,Zhao; Jishen,0,0,0,0
1739707473745,CSE 241A,A00,844316,Kahng; Andrew Byun,0,0,0,0
1739707474772,CSE 250A,A00,844317,Bonjour; Trevor,0,0,0,0
1739707475799,CSE 251B,A01,864438,Yu; Qi,0,0,0,0
1739707476824,CSE 252D,A00,844320,Chandraker; Manmohan Krishna,0,0,0,0
1739707477847,CSE 253,A01,872796,McAuley; Julian John,0,0,0,0
1739707478873,CSE 253R,A01,872838,McAuley; Julian John,0,0,0,0
1739707480922,CSE 276F,A01,872476,Su; Hao,0,0,0,0
1739707481950,CSE 283,A00,844332,Bafna; Vineet & Zhong; Sheng,0,0,0,0
1739707482975,CSE 290,A00,844338,Gao; Sicun,0,0,0,0
1739707482975,CSE 290,B00,844366,Pannuto; Patrick William,0,0,0,0
1739707482975,CSE 290,C00,844379,Stefan; Deian,0,0,0,0
1739707482975,CSE 290,D00,881470,Yu; Qi,0,0,0,0
1739707482975,CSE 290,E00,844387,Chern; Albert Ren-Haur,0,0,0,0
1739707482975,CSE 290,F00,891163,Ding; Yufei,0,0,0,0
1739707484004,CSE 291,A00,844398,Bandeira; Nuno Filipe Cabrita,0,0,0,0
1739707484004,CSE 291,B00,844401,Li; Tzumao,0,0,0,0
1739707484004,CSE 291,C00,844402,Heninger; Nadia A,0,0,0,0
1739707484004,CSE 291,D00,844407,Chern; Albert Ren-Haur,0,0,0,0
1739707484004,CSE 291,E00,844409,Savage; Stefan,0,0,0,0
1739707484004,CSE 291,F00,881310,Niethammer; Marc S,0,0,0,0
1739707484004,CSE 291,H00,844419,Kahng; Andrew Byun,0,0,0,0
1739707485042,CSE 293,001,877922,Bafna; Vineet,9999,0,9999,0
1739707485042,CSE 293,002,877923,Bellare; Mihir,9999,0,9999,0
1739707485042,CSE 293,003,877942,Berg-Kirkpatrick; Taylor D,9999,0,9999,0
1739707485042,CSE 293,004,877943,Chandraker; Manmohan Krishna,9999,0,9999,0
1739707485042,CSE 293,005,877945,Cheng; Chung Kuan,9999,0,9999,0
1739707485042,CSE 293,006,877947,Christensen; Henrik I,9999,0,9999,0
1739707485042,CSE 293,007,877950,Coblenz; Michael J,9999,0,9999,0
1739707485042,CSE 293,008,877951,Cottrell; Garrison W,9999,0,9999,0
1739707485042,CSE 293,009,877952,Deutsch; Alin Bernard,9999,0,9999,0
1739707485042,CSE 293,010,877954,Esmaeilzadeh; Hadi,9999,0,9999,0
1739707485042,CSE 293,011,878049,Freund; Yoav,9999,0,9999,0
1739707485042,CSE 293,012,878145,Griswold; William G.,9999,0,9999,0
1739707485042,CSE 293,013,878152,Gymrek; Melissa Ann,9999,0,9999,0
1739707485042,CSE 293,014,878207,Heninger; Nadia A,9999,0,9999,0
1739707485042,CSE 293,015,878221,Impagliazzo; Russell,9999,0,9999,0
1739707485042,CSE 293,016,878223,Jhala; Ranjit,9999,0,9999,0
1739707485042,CSE 293,017,878262,Kahng; Andrew Byun,9999,0,9999,0
1739707485042,CSE 293,018,878267,Kane; Daniel Mertz,9999,0,9999,0
1739707485042,CSE 293,019,878270,Kriegman; David J,9999,0,9999,0
1739707485042,CSE 293,020,878273,Kumar; Arun Kumar,9999,0,9999,0
1739707485042,CSE 293,021,878275,Lerner; Sorin,9999,0,9999,0
1739707485042,CSE 293,022,878276,Lovett; Shachar,9999,0,9999,0
1739707485042,CSE 293,023,878311,McAuley; Julian John,9999,0,9999,0
1739707485042,CSE 293,024,878312,Micciancio; Daniele,9999,0,9999,0
1739707485042,CSE 293,025,878313,Orailoglu; Alex,9999,0,9999,0
1739707485042,CSE 293,026,878314,Pannuto; Patrick William,9999,0,9999,0
1739707485042,CSE 293,027,878315,Paturi; Ramamohan,9999,0,9999,0
1739707485042,CSE 293,028,878330,Polikarpova; Nadezhda,9999,0,9999,0
1739707485042,CSE 293,029,878358,Politz; Joseph Gibbs,9999,0,9999,0
1739707485042,CSE 293,030,878392,Porter; George M,9999,0,9999,0
1739707485042,CSE 293,031,878399,Porter; Leonard Emerson,9999,0,9999,0
1739707485042,CSE 293,032,878415,Ramamoorthi; Ravi,9999,0,9999,0
1739707485042,CSE 293,033,878416,Riek; Laurel D,9999,0,9999,0
1739707485042,CSE 293,034,878417,Sahoo; Debashis,9999,0,9999,0
1739707485042,CSE 293,035,878418,Saul; Lawrence,9999,0,9999,0
1739707485042,CSE 293,036,878419,Savage; Stefan,9999,0,9999,0
1739707485042,CSE 293,037,878420,Schulze; Jurgen P.,9999,0,9999,0
1739707485042,CSE 293,038,878421,Snoeren; Alex C.,9999,0,9999,0
1739707485042,CSE 293,039,878422,Shang; Jingbo,9999,0,9999,0
1739707485042,CSE 293,040,878423,Stefan; Deian,9999,0,9999,0
1739707485042,CSE 293,041,878424,Su; Hao,9999,0,9999,0
1739707485042,CSE 293,042,878425,Swanson; Steven James,9999,0,9999,0
1739707485042,CSE 293,043,878460,Tullsen; Dean Michael,9999,0,9999,0
1739707485042,CSE 293,044,878476,Vaccaro; Kristen Marie,9999,0,9999,0
1739707485042,CSE 293,045,878517,Voelker; Geoffrey M.,9999,0,9999,0
1739707485042,CSE 293,046,878541,Zhao; Jishen,9999,0,9999,0
1739707485042,CSE 293,047,878663,Zhou; Yuan-Yuan,9999,0,9999,0
1739707485042,CSE 293,048,878664,Gao; Sicun,9999,0,9999,0
1739707485042,CSE 293,049,878665,Weibel; Nadir,9999,0,9999,0
1739707485042,CSE 293,050,878666,Gupta; Rajesh K.,9999,0,9999,0
1739707485042,CSE 293,051,878667,Soosai Raj; Adalbert Geral,9999,0,9999,0
1739707485042,CSE 293,052,891170,Tu; Zhuowen,9999,0,9999,0
1739707486068,CSE 294,A00,844429,Voelker; Geoffrey M.,0,0,0,0
1739707487096,CSS 1,A01,864447,Staff,34,0,36,2
1739707487096,CSS 1,A02,864476,Staff,30,0,36,6
1739707487096,CSS 1,A03,864511,Staff,34,0,36,2
1739707487096,CSS 1,A04,864512,Staff,36,0,36,0
1739707488122,CSS 100,A01,864537,Trott; Sean Thomas,30,0,36,6
1739707488122,CSS 100,A02,864538,Trott; Sean Thomas,36,0,36,0
1739707489145,CSS 120,A01,864563,Mignozzetti; Umberto,28,0,28,0
1739707489145,CSS 120,A02,864564,Mignozzetti; Umberto,28,0,30,2
1739707490171,CSS 206,A00,812747,Mukamel; Eran A,6,0,24,18
1739707491197,CSS 209,A00,864566,Mignozzetti; Umberto,27,0,45,18
1739707492225,CSS 296,001,864568,Mignozzetti; Umberto,0,0,0,4
1739707492225,CSS 296,002,864569,Mignozzetti; Umberto,0,0,0,3
1739707492225,CSS 296,003,864571,Leas; Eric Craig,0,0,0,1
1739707492225,CSS 296,004,864577,Okonkwo; Holly,0,0,0,1
1739707492225,CSS 296,005,864605,Fleischer; Jason G,0,0,0,1
1739707492225,CSS 296,006,864634,Creel; Sarah,0,0,0,1
1739707492225,CSS 296,007,864661,Patel; Hemal,0,0,0,1
1739707492225,CSS 296,008,864688,Martin; Isaac,0,0,0,0
1739707492225,CSS 296,009,864697,Styler; William Francis,0,0,0,1
1739707492225,CSS 296,010,864751,Grigoryan; Aram,0,0,0,1
1739707492225,CSS 296,011,864752,Bonjour; Trevor,0,0,0,1
1739707492225,CSS 296,012,864753,Martin; Isaac,0,0,0,2
1739707493251,DDPM 210,A00,814899,Ma; Joseph David,29,0,32,3
1739707494277,DDPM 211,A00,814901,Ma; Joseph David,29,0,32,3
1739707495302,DDPM 214,A00,814907,Ma; Joseph David,29,0,32,3
1739707496326,DERM 296,001,866221,Eichenfield; Dawn Zhang,4,0,5,1
1739707496326,DERM 296,002,866222,Staff,5,0,5,0
1739707496326,DERM 296,003,866229,Staff,5,0,5,0
1739707497358,DOC 3,A01,813868,Staff,0,0,0,0
1739707497358,DOC 3,A02,813884,Staff,0,0,0,0
1739707497358,DOC 3,A03,813885,Staff,0,0,0,0
1739707497358,DOC 3,A04,813886,Staff,0,0,0,0
1739707497358,DOC 3,A05,813887,Staff,0,0,0,0
1739707497358,DOC 3,A06,813888,Staff,0,0,0,0
1739707497358,DOC 3,A07,813889,Staff,0,0,0,0
1739707497358,DOC 3,A08,813890,Staff,0,0,0,0
1739707497358,DOC 3,A09,813891,Staff,0,0,0,0
1739707497358,DOC 3,A10,813892,Staff,0,0,0,0
1739707497358,DOC 3,A11,813893,Staff,0,0,0,0
1739707497358,DOC 3,A12,813894,Staff,0,0,0,0
1739707497358,DOC 3,A13,813895,Staff,0,0,0,0
1739707497358,DOC 3,A14,813896,Staff,0,0,0,0
1739707497358,DOC 3,A15,813897,Staff,0,0,0,0
1739707497358,DOC 3,A16,813898,Staff,0,0,0,0
1739707497358,DOC 3,B01,813900,Staff,0,0,0,0
1739707497358,DOC 3,B02,813901,Staff,0,0,0,0
1739707497358,DOC 3,B03,813902,Staff,0,0,0,0
1739707497358,DOC 3,B04,813903,Staff,0,0,0,0
1739707497358,DOC 3,B05,813904,Staff,0,0,0,0
1739707497358,DOC 3,B06,813905,Staff,0,0,0,0
1739707497358,DOC 3,B07,813906,Staff,0,0,0,0
1739707497358,DOC 3,B08,813907,Staff,0,0,0,0
1739707497358,DOC 3,B09,813908,Staff,0,0,0,0
1739707497358,DOC 3,B10,813910,Staff,0,0,0,0
1739707497358,DOC 3,B11,813911,Staff,0,0,0,0
1739707497358,DOC 3,B12,813913,Staff,0,0,0,0
1739707497358,DOC 3,B13,813914,Staff,0,0,0,0
1739707497358,DOC 3,B14,813915,Staff,0,0,0,0
1739707497358,DOC 3,B15,813916,Staff,0,0,0,0
1739707497358,DOC 3,B16,813917,Staff,0,0,0,0
1739707497358,DOC 3,C01,813919,Staff,0,0,0,0
1739707497358,DOC 3,C02,813920,Staff,0,0,0,0
1739707497358,DOC 3,C03,813921,Staff,0,0,0,0
1739707497358,DOC 3,C04,813922,Staff,0,0,0,0
1739707497358,DOC 3,C05,813923,Staff,0,0,0,0
1739707497358,DOC 3,C06,813926,Staff,0,0,0,0
1739707497358,DOC 3,C07,813927,Staff,0,0,0,0
1739707497358,DOC 3,C08,813928,Staff,0,0,0,0
1739707497358,DOC 3,C09,813929,Staff,0,0,0,0
1739707497358,DOC 3,C10,813931,Staff,0,0,0,0
1739707497358,DOC 3,C11,813932,Staff,0,0,0,0
1739707497358,DOC 3,C12,813933,Staff,0,0,0,0
1739707497358,DOC 3,C13,813936,Staff,0,0,0,0
1739707497358,DOC 3,C14,813937,Staff,0,0,0,0
1739707497358,DOC 3,C15,813938,Staff,0,0,0,0
1739707497358,DOC 3,C16,813939,Staff,0,0,0,0
1739707497358,DOC 3,D01,813942,Staff,0,0,0,0
1739707497358,DOC 3,D02,813943,Staff,0,0,0,0
1739707497358,DOC 3,D03,813944,Staff,0,0,0,0
1739707497358,DOC 3,D04,813945,Staff,0,0,0,0
1739707497358,DOC 3,D05,813979,Staff,0,0,0,0
1739707497358,DOC 3,D06,813981,Staff,0,0,0,0
1739707497358,DOC 3,D07,813985,Staff,0,0,0,0
1739707497358,DOC 3,D08,813986,Staff,0,0,0,0
1739707497358,DOC 3,D09,813988,Staff,0,0,0,0
1739707497358,DOC 3,D10,813991,Staff,0,0,0,0
1739707497358,DOC 3,D11,813993,Staff,0,0,0,0
1739707497358,DOC 3,D12,813994,Staff,0,0,0,0
1739707497358,DOC 3,D13,814000,Staff,0,0,0,0
1739707497358,DOC 3,D14,814002,Staff,0,0,0,0
1739707497358,DOC 3,D15,814003,Staff,0,0,0,0
1739707497358,DOC 3,D16,814012,Staff,0,0,0,0
1739707497358,DOC 3,D17,814014,Staff,0,0,0,0
1739707498385,DOC 100D,A00,814015,Pass; Natalye,24,0,25,1
1739707498385,DOC 100D,B00,814017,Pass; Natalye,24,0,25,1
1739707499411,DSC 10,A01,841644,Tiefenbruck; Janine LoBue,146,0,146,0
1739707499411,DSC 10,B01,870243,Tiefenbruck; Janine LoBue,143,0,146,3
1739707500448,DSC 20,A01,841647,Langlois; Marina,60,0,60,0
1739707500448,DSC 20,B01,841649,Langlois; Marina,60,0,60,0
1739707501476,DSC 30,A01,841651,Liao; Soohyun Nam,189,0,190,1
1739707501476,DSC 30,B01,841653,Liao; Soohyun Nam,188,0,190,2
1739707502510,DSC 40A,A01,841659,Shannon; Kyle Michael,143,0,146,3
1739707503534,DSC 40B,A01,841663,Eldridge; Justin Matthew,175,0,180,5
1739707504560,DSC 80,A01,841667,Rahman; Tauhidur,116,0,120,4
1739707505589,DSC 95,A01,841669,Tiefenbruck; Janine LoBue,40,0,40,0
1739707506750,DSC 100,A01,841671,Salimi; Babak,146,0,146,0
1739707507774,DSC 102,A01,841674,Staff,293,0,300,7
1739707508805,DSC 106,B01,841679,Lau; Samuel Ethan,98,0,100,2
1739707508805,DSC 106,C01,841681,Lau; Samuel Ethan,100,0,100,0
1739707509833,DSC 140A,A01,841683,Ustun; Tevfik Berk,150,0,150,0
1739707510860,DSC 140B,A01,841687,Weng; Tsui-Wei (lily),121,0,125,4
1739707511885,DSC 161,A00,841688,Roberts; Margaret Earling,40,0,40,0
1739707512915,DSC 190,A01,841690,Silberman; Jack,30,0,30,0
1739707512915,DSC 190,B01,841692,Langlois; Marina,99,0,100,1
1739707512915,DSC 190,C01,841694,Weng; Tsui-Wei (lily),28,0,30,2
1739707512915,DSC 190,D01,841696,Ustun; Tevfik Berk,30,0,30,0
1739707513944,DSC 197,001,841699,Eldridge; Justin Matthew,9999,0,9999,0
1739707514977,DSC 204A,A00,841700,Bellur; Umesh,0,0,0,0
1739707516001,DSC 208R,A01,841703,Jin; Haojian,34,0,40,6
1739707517025,DSC 212,A00,841705,Staff,77,0,90,13
1739707518050,DSC 214,A00,841706,Wang; Yusu,0,0,60,60
1739707519076,DSC 232R,A01,841708,Solares; Edwin A,49,0,80,31
1739707520103,DSC 240,A00,841710,Belkin; Mikhail,114,0,120,6
1739707521129,DSC 241,A00,841712,Schwartzman; Armin,20,0,90,70
1739707522156,DSC 255R,A01,841714,Staff,32,0,40,8
1739707523180,DSC 258R,A01,841716,Shang; Jingbo,35,0,60,25
1739707524207,DSC 267R,A01,841718,Danks; David J,53,0,60,7
1739707525234,DSC 291,A00,841719,Ustun; Tevfik Berk,0,0,30,30
1739707525234,DSC 291,B00,841723,Huang; Biwei,3,0,60,57
1739707525234,DSC 291,C00,841724,Weng; Tsui-Wei (lily),0,0,30,30
1739707525234,DSC 291,D00,841725,Hu; Zhiting,54,0,90,36
1739707525234,DSC 291,E00,841726,Warstadt; Alexander Scott,7,0,60,53
1739707526261,DSC 293,A00,841727,Ustun; Tevfik Berk,9995,0,9999,4
1739707527287,DSC 297,001,872917,Rahman; Tauhidur,9999,0,9999,0
1739707528313,DSE 210,A00,869159,Staff,20,0,20,0
1739707529337,DSE 230,A00,813774,Staff,25,0,25,0
1739707530360,DSE 260B,A00,813775,Staff,25,0,25,0
1739707531389,DSGN 1,A01,810429,Klemmer; Scott R,49,0,50,1
1739707531389,DSGN 1,A02,810431,Klemmer; Scott R,49,0,50,1
1739707531389,DSGN 1,A03,810434,Klemmer; Scott R,50,0,50,0
1739707531389,DSGN 1,A04,810436,Klemmer; Scott R,48,0,50,2
1739707531389,DSGN 1,A05,810438,Klemmer; Scott R,39,0,40,1
1739707532412,DSGN 2,A01,810443,Hollan; James D.,49,0,50,1
1739707533438,DSGN 100,A01,811981,Rill; Bryan,18,0,18,0
1739707533438,DSGN 100,A02,811982,Rill; Bryan,10,0,18,8
1739707533438,DSGN 100,A03,811983,Rill; Bryan,15,0,18,3
1739707533438,DSGN 100,A04,812053,Rill; Bryan,6,0,16,10
1739707534463,DSGN 119,A00,812054,Irani; Lilly C & Shvartzberg Carrio; Manuel,63,0,80,17
1739707536517,DSGN 219,A00,812273,Irani; Lilly C & Shvartzberg Carrio; Manuel,12,0,15,3
1739707537542,ECE 5,A01,816583,Morris; Karcher William,0,0,0,0
1739707537542,ECE 5,A02,816584,Morris; Karcher William,0,0,0,0
1739707537542,ECE 5,A03,816586,Morris; Karcher William,22,0,22,0
1739707537542,ECE 5,A04,816589,Morris; Karcher William,22,0,22,0
1739707538571,ECE 15,A01,816591,Sahay; Rajeev,114,0,120,6
1739707539597,ECE 16,A01,816594,Wang; Edward Jay,25,0,30,5
1739707540622,ECE 17,A01,816599,Sahay; Rajeev,67,0,75,8
1739707541658,ECE 25,A50,816722,Dey; Sujit,30,0,30,0
1739707541658,ECE 25,A51,816734,Dey; Sujit,29,0,30,1
1739707542688,ECE 30,A50,816809,Mir Arabbaygi; Siavash,25,0,30,5
1739707542688,ECE 30,A51,816811,Mir Arabbaygi; Siavash,25,0,30,5
1739707542688,ECE 30,A52,816812,Mir Arabbaygi; Siavash,30,0,30,0
1739707542688,ECE 30,A53,816814,Mir Arabbaygi; Siavash,30,0,30,0
1739707542688,ECE 30,A54,816817,Mir Arabbaygi; Siavash,27,0,27,0
1739707543719,ECE 35,A50,816821,Ndao; Abdoulaye,25,0,26,1
1739707543719,ECE 35,A51,816822,Ndao; Abdoulaye,24,0,26,2
1739707543719,ECE 35,A52,816825,Ndao; Abdoulaye,26,0,26,0
1739707543719,ECE 35,A53,816826,Ndao; Abdoulaye,26,0,26,0
1739707544746,ECE 45,A01,816828,Zeger; Kenneth A.,187,0,192,5
1739707545776,ECE 65,A50,816873,Baghdadchi; Saharnaz,28,0,30,2
1739707545776,ECE 65,A51,816874,Baghdadchi; Saharnaz,28,0,30,2
1739707545776,ECE 65,A52,816877,Baghdadchi; Saharnaz,30,0,30,0
1739707545776,ECE 65,A53,816880,Baghdadchi; Saharnaz,30,0,30,0
1739707545776,ECE 65,A54,816882,Baghdadchi; Saharnaz,30,0,30,0
1739707545776,ECE 65,A55,816883,Baghdadchi; Saharnaz,29,0,30,1
1739707545776,ECE 65,A56,816884,Baghdadchi; Saharnaz,30,0,30,0
1739707546804,ECE 100,A01,816926,Hsueh; Tzu-Chien,29,0,30,1
1739707546804,ECE 100,A02,816939,Hsueh; Tzu-Chien,26,0,30,4
1739707546804,ECE 100,A03,816945,Hsueh; Tzu-Chien,29,0,30,1
1739707546804,ECE 100,A04,816950,Hsueh; Tzu-Chien,29,0,30,1
1739707546804,ECE 100,A05,816962,Hsueh; Tzu-Chien,29,0,30,1
1739707547834,ECE 101,A01,816993,Siegel; Paul H.,57,0,60,3
1739707547834,ECE 101,A02,817165,Siegel; Paul H.,57,0,60,3
1739707548859,ECE 103,A01,817352,Nomura; Kenji,43,0,50,7
1739707549888,ECE 108,A01,817373,Kang; Mingu,98,0,120,22
1739707550924,ECE 109,A01,817418,Orlitsky; Alon,72,0,73,1
1739707550924,ECE 109,A02,817420,Orlitsky; Alon,73,0,73,0
1739707551951,ECE 111,A01,817426,Eldon; John,167,0,180,13
1739707552979,ECE 115,A01,817432,Yip; Michael,20,0,26,6
1739707554005,ECE 123,A01,817448,Sievenpiper; Daniel F.,28,0,37,9
1739707555031,ECE 125B,A50,817453,Esmaili; Gholamreza,18,0,24,6
1739707555031,ECE 125B,A51,817455,Esmaili; Gholamreza,23,0,24,1
1739707556059,ECE 134,A00,817457,Ng; Tse Nga,47,0,50,3
1739707557086,ECE 136L,A01,817459,Dayeh; Shadi Ahmad,5,0,5,0
1739707557086,ECE 136L,A02,817461,Dayeh; Shadi Ahmad,2,0,5,3
1739707557086,ECE 136L,A03,817462,Dayeh; Shadi Ahmad,3,0,5,2
1739707557086,ECE 136L,A04,817463,Dayeh; Shadi Ahmad,4,0,5,1
1739707558111,ECE 139,A00,817537,Nomura; Kenji,29,0,30,1
1739707559136,ECE 140B,A50,817654,Khoshabeh; Ramsin & Gessner; Richard K.,23,0,24,1
1739707559136,ECE 140B,A51,817662,Khoshabeh; Ramsin & Gessner; Richard K.,22,0,24,2
1739707559136,ECE 140B,A52,817663,Khoshabeh; Ramsin & Gessner; Richard K.,22,0,22,0
1739707560165,ECE 141B,A01,872372,Gessner; Richard K.,26,0,30,4
1739707561192,ECE 148,A01,817698,Silberman; Jack,22,0,26,4
1739707562220,ECE 153,A01,817703,Naghizadeh Ardabili; Parinaz,74,0,90,16
1739707563247,ECE 157A,A01,817708,Bharadia; Dinesh,21,0,25,4
1739707564273,ECE 161C,A00,817865,Harris; Frederick Joel,48,0,50,2
1739707565304,ECE 165,A51,817880,Mercier; Patrick Philip,26,0,30,4
1739707565304,ECE 165,A52,817882,Mercier; Patrick Philip,23,0,30,7
1739707565304,ECE 165,A53,817885,Mercier; Patrick Philip,27,0,30,3
1739707565304,ECE 165,A54,817888,Mercier; Patrick Philip,29,0,30,1
1739707566330,ECE 171A,A01,817892,Zheng; Yang,93,0,100,7
1739707567354,ECE 175B,A01,817899,Xie; Pengtao,47,0,50,3
1739707568379,ECE 183,A01,817903,Mookherjea; Shayan,26,0,30,4
1739707569407,ECE 185,A01,817907,Liu; Zhaowei,20,0,20,0
1739707570431,ECE 196,A00,817908,Morris; Karcher William,15,0,24,9
1739707570431,ECE 196,B00,817913,Morris; Karcher William,26,0,28,2
1739707571454,ECE 197,001,816579,Mercier; Patrick Philip,9999,0,9999,0
1739707572478,ECE 198,001,816580,Nguyen; Truong Quang,9999,0,9999,0
1739707573504,ECE 204,A00,817918,Alexandrov; Ludmil B,0,0,0,0
1739707574532,ECE 208,A00,817920,Mir Arabbaygi; Siavash,0,0,0,0
1739707575557,ECE 212CN,A00,817921,Liu; Zhaowei,0,0,0,0
1739707576582,ECE 222D,A00,817922,Sievenpiper; Daniel F.,0,0,0,0
1739707577609,ECE 227,A00,817926,Franceschetti; Massimo,0,0,0,0
1739707578634,ECE 228,A00,817928,Shi; Yuanyuan,0,0,0,0
1739707579663,ECE 236B,A00,817929,Lo; Yu-Hwa,0,0,0,0
1739707580693,ECE 238B,A00,817934,Garay; Javier,0,0,0,0
1739707581718,ECE 240C,A00,818013,Mookherjea; Shayan,0,0,0,0
1739707582745,ECE 241A,A00,818014,Rubin; Noah,0,0,0,0
1739707583781,ECE 251B,A00,818015,Vasconcelos; Manuela,0,0,0,0
1739707584809,ECE 258B,A00,818016,Milstein; Laurence B.,0,0,0,0
1739707585834,ECE 260C,A00,818017,Kahng; Andrew Byun,0,0,0,0
1739707586861,ECE 264B,A00,818018,Galton; Ian A,0,0,0,0
1739707587890,ECE 265B,A00,818019,Gudem; Prasad S.S.,0,0,0,0
1739707588917,ECE 266,A01,818021,Hall; Drew A.,0,0,0,0
1739707589942,ECE 268,A00,818022,Koushanfar; Farinaz,0,0,0,0
1739707590970,ECE 272A,A01,818064,Poveda Fonseca; Jorge,0,0,0,0
1739707591995,ECE 273,A00,818065,Wang; Jun-Kun,0,0,0,0
1739707593020,ECE 275A,A00,818066,Meyer; Florian,0,0,0,0
1739707594047,ECE 276B,A00,818067,Atanasov; Nikolay A.,0,0,0,0
1739707595079,ECE 284,A00,818068,Wang; Edward,0,0,0,0
1739707596104,ECE 285,A00,818069,Wang; Xiaolong,0,0,0,0
1739707596104,ECE 285,B00,818070,Antipa; Nicholas A,0,0,0,0
1739707596104,ECE 285,C00,818071,Xie; Pengtao,0,0,0,0
1739707597128,ECE 287,A00,872497,Gonzalez Prelcic; Nuria,0,0,0,0
1739707598155,ECON 1,A01,814026,Famulari; Melissa,118,0,120,2
1739707598155,ECON 1,A02,814028,Famulari; Melissa,114,0,115,1
1739707598155,ECON 1,A03,814029,Famulari; Melissa,115,0,115,0
1739707598155,ECON 1,B01,814039,Famulari; Melissa,46,0,50,4
1739707599184,ECON 2,A01,814045,Crane; Meredith Helen,95,0,96,1
1739707600210,ECON 3,A01,814154,Crane; Meredith Helen,91,0,95,4
1739707600210,ECON 3,A02,814155,Crane; Meredith Helen,93,0,95,2
1739707600210,ECON 3,B01,814188,Crane; Meredith Helen,95,0,95,0
1739707600210,ECON 3,B02,814195,Crane; Meredith Helen,91,0,95,4
1739707601240,ECON 4,A01,814197,Levkoff; Steven B.,50,0,54,4
1739707601240,ECON 4,A02,814210,Levkoff; Steven B.,54,0,54,0
1739707601240,ECON 4,A03,814224,Levkoff; Steven B.,54,0,54,0
1739707601240,ECON 4,B01,814273,Brooks; Marcus Raymond,3,0,3,0
1739707602272,ECON 5,A01,814495,Arnold; David Hall,66,0,72,6
1739707602272,ECON 5,A02,814507,Arnold; David Hall,72,0,72,0
1739707602272,ECON 5,A03,814508,Arnold; David Hall,71,0,72,1
1739707602272,ECON 5,A04,814509,Arnold; David Hall,71,0,72,1
1739707602272,ECON 5,A05,814510,Arnold; David Hall,72,0,72,0
1739707602272,ECON 5,B01,814513,Dai; Yinlin,44,0,45,1
1739707602272,ECON 5,B02,814514,Dai; Yinlin,39,0,45,6
1739707603296,ECON 100A,A01,814516,Newhouse; Herbert S,76,0,79,3
1739707603296,ECON 100A,A02,814517,Newhouse; Herbert S,79,0,79,0
1739707603296,ECON 100A,B01,814519,Newhouse; Herbert S,82,0,83,1
1739707603296,ECON 100A,B02,814520,Newhouse; Herbert S,73,0,75,2
1739707604320,ECON 100AH,A00,814521,Famulari; Melissa,20,0,20,0
1739707605350,ECON 100B,A01,814523,Boomhower; Judson P,74,0,85,11
1739707605350,ECON 100B,A02,814524,Boomhower; Judson P,82,0,85,3
1739707605350,ECON 100B,A03,814525,Boomhower; Judson P,78,0,80,2
1739707605350,ECON 100B,B01,814527,Boomhower; Judson P,0,0,0,0
1739707606375,ECON 100BH,A00,814528,Boomhower; Judson P,20,0,20,0
1739707607400,ECON 100C,A01,814530,Newhouse; Herbert S,95,0,98,3
1739707607400,ECON 100C,A02,814531,Newhouse; Herbert S,98,0,98,0
1739707608427,ECON 101,A00,814532,Esfahani; Sara,112,0,120,8
1739707609454,ECON 109T,A00,814533,Trevino; Isabel,20,0,20,0
1739707610534,ECON 110A,A01,814535,Candido; Maria Teresa,97,0,100,3
1739707611561,ECON 110B,A01,814537,Herreno Lopera; Juan,91,0,100,9
1739707611561,ECON 110B,A02,814538,Herreno Lopera; Juan,100,0,100,0
1739707611561,ECON 110B,A03,814539,Herreno Lopera; Juan,99,0,100,1
1739707611561,ECON 110B,A04,814540,Herreno Lopera; Juan,98,0,100,2
1739707612591,ECON 120A,A01,814542,Dai; Yinlin,90,0,95,5
1739707612591,ECON 120A,A02,814543,Dai; Yinlin,94,0,95,1
1739707612591,ECON 120A,B01,814545,Dai; Yinlin,93,0,95,2
1739707612591,ECON 120A,B02,814546,Dai; Yinlin,94,0,95,1
1739707613621,ECON 120B,A01,814548,Candido; Maria Teresa,91,0,95,4
1739707613621,ECON 120B,A02,814549,Candido; Maria Teresa,89,0,95,6
1739707613621,ECON 120B,B01,814551,Candido; Maria Teresa,91,0,95,4
1739707613621,ECON 120B,B02,814552,Candido; Maria Teresa,95,0,95,0
1739707614651,ECON 120C,A01,814554,Sun; Yixiao,38,0,40,2
1739707614651,ECON 120C,B01,814556,Sun; Yixiao,33,0,40,7
1739707614651,ECON 120C,C01,814585,Sun; Yixiao,39,0,40,1
1739707615676,ECON 125,A00,814588,Vogl; Tom Saul,96,0,100,4
1739707616704,ECON 129,A00,814589,Eckert; Fabian Paul,99,0,100,1
1739707617732,ECON 132,A00,814595,Carson; Richard T,72,0,75,3
1739707617732,ECON 132,B00,814599,Carson; Richard T,73,0,75,2
1739707618757,ECON 132T,A00,814600,Carson; Richard T,20,0,20,0
1739707619782,ECON 134,A00,814601,Gelber; Alexander Michael,47,0,50,3
1739707620809,ECON 137,A00,814602,Niehaus; Paul,20,0,20,0
1739707621835,ECON 140,A00,814630,Clemens; Jeffrey,44,0,49,5
1739707622859,ECON 142,A00,814647,Trevino; Isabel,50,0,50,0
1739707622859,ECON 142,B00,814656,Trevino; Isabel,45,0,50,5
1739707623886,ECON 147,A00,814683,Betts; Julian,100,0,100,0
1739707624923,ECON 164,A00,814684,Muralidharan; Karthik,219,0,220,1
1739707625950,ECON 168,A00,814691,Maron; Asa,74,0,80,6
1739707626974,ECON 173B,A01,814700,Levkoff; Steven B.,39,0,40,1
1739707626974,ECON 173B,B01,814734,Levkoff; Steven B.,40,0,40,0
1739707627998,ECON 191A,A00,814768,Cullen; Julie,20,0,20,0
1739707629026,ECON 200C,A00,814811,Grigoryan; Aram & Trevino; Isabel & Sobel; Joel,24,0,25,1
1739707630050,ECON 210C,A00,814815,Herreno Lopera; Juan,25,0,25,0
1739707631078,ECON 220C,A00,814816,Sun; Yixiao,23,0,25,2
1739707632103,ECON 220F,A00,814817,Carson; Richard T,28,0,30,2
1739707633131,ECON 221,A00,814818,Zhu; Ying,15,0,15,0
1739707634158,ECON 241,A00,814819,Muralidharan; Karthik,14,0,15,1
1739707635182,ECON 243,A00,814820,Niehaus; Paul & Adhvaryu; Achyuta Rasendra,15,0,15,0
1739707636206,ECON 248,A00,814821,Eckert; Fabian Paul & Trottner; Fabian Gunter We,13,0,15,2
1739707637234,ECON 250C,A00,814840,Arnold; David Hall & Betts; Julian,24,0,25,1
1739707638260,ECON 281,A00,814850,Wu; Pak Yeung & Herreno Lopera; Juan,14,0,15,1
1739707639285,ECON 285,A00,814851,Eckert; Fabian Paul,25,0,25,0
1739707640313,ECON 286,A00,814852,Hamilton; James D.,20,0,20,0
1739707640313,ECON 286,B00,814853,Shishkin; Denis,19,0,20,1
1739707641338,ECON 296,A00,814854,Eckert; Fabian Paul,24,0,25,1
1739707642364,EDS 31,A00,815023,Brydges; Stacey,17,0,20,3
1739707643388,EDS 39,A01,815025,Heinzman; Erica M.,25,0,25,0
1739707644415,EDS 102,A01,815042,Hopkins; Megan Beth,40,0,45,5
1739707646468,EDS 115,A00,815058,Jones; Gabrielle Anastasia,48,0,50,2
1739707647498,EDS 117,A01,851605,Jones; Makeba,33,0,37,4
1739707647498,EDS 117,A02,851607,Jones; Makeba,35,0,37,2
1739707647498,EDS 117,A03,851608,Jones; Makeba,38,0,38,0
1739707647498,EDS 117,A04,851610,Jones; Makeba,36,0,38,2
1739707647498,EDS 117,B01,870849,Staff,24,0,25,1
1739707647498,EDS 117,B02,870920,Staff,25,0,25,0
1739707647498,EDS 117,B03,870978,Staff,25,0,25,0
1739707647498,EDS 117,B04,870979,Staff,25,0,25,0
1739707648523,EDS 118,A00,815184,Staff,57,0,60,3
1739707649547,EDS 123,A00,815186,Brydges; Stacey,20,0,20,0
1739707650582,EDS 124AR,A00,815196,Simon; Elizabeth A,189,0,200,11
1739707650582,EDS 124AR,B00,815197,Simon; Elizabeth A,99,0,100,1
1739707650582,EDS 124AR,C00,872649,Simon; Elizabeth A,40,0,40,0
1739707651609,EDS 124BR,A00,815259,Eguchi; Emi,57,0,75,18
1739707651609,EDS 124BR,B00,872641,Eguchi; Emi,25,0,25,0
1739707652633,EDS 125,A00,815260,Aragon; Maria Jose,55,0,60,5
1739707653659,EDS 126,A01,851619,Jones; Makeba,25,0,33,8
1739707653659,EDS 126,A02,815283,Jones; Makeba,31,0,33,2
1739707653659,EDS 126,A03,815284,Jones; Makeba,33,0,34,1
1739707654684,EDS 128B,A01,815311,Pappas; Elizabeth,24,0,25,1
1739707654684,EDS 128B,A02,815312,Pappas; Elizabeth,25,0,25,0
1739707654684,EDS 128B,A03,870748,Pappas; Elizabeth,20,0,20,0
1739707655712,EDS 129C,A01,815314,Millstone; Rachel Diana,60,0,60,0
1739707656755,EDS 130,A01,815383,Mendez; Kathrina Mendoza,18,0,20,2
1739707656755,EDS 130,A02,815384,Mendez; Kathrina Mendoza,20,0,20,0
1739707656755,EDS 130,A03,815390,Mendez; Kathrina Mendoza,20,0,20,0
1739707657781,EDS 133,A01,815456,Bintliff; Amy S.V.,12,0,15,3
1739707657781,EDS 133,A02,815457,Bintliff; Amy S.V.,15,0,15,0
1739707657781,EDS 133,A03,815458,Bintliff; Amy S.V.,14,0,15,1
1739707657781,EDS 133,A04,815459,Bintliff; Amy S.V.,10,0,10,0
1739707658810,EDS 136,A01,815462,Hemans; Patricia Ann Benitez,17,0,20,3
1739707658810,EDS 136,A02,815463,Hemans; Patricia Ann Benitez,20,0,20,0
1739707658810,EDS 136,A03,815467,Hemans; Patricia Ann Benitez,20,0,20,0
1739707659839,EDS 139,A00,815469,Pappas; Elizabeth,47,0,50,3
1739707659839,EDS 139,B00,815470,Millstone; Rachel Diana,60,0,60,0
1739707659839,EDS 139,C00,815471,Mendez; Kathrina Mendoza,58,0,60,2
1739707659839,EDS 139,D00,815472,Bintliff; Amy S.V.,57,0,60,3
1739707659839,EDS 139,E00,815473,Hemans; Patricia Ann Benitez,57,0,60,3
1739707659839,EDS 139,F00,815474,Mamas; Christoforos,32,0,35,3
1739707659839,EDS 139,G00,815583,Choi; Bailey Miyeon,30,0,30,0
1739707659839,EDS 139,H00,815588,Bintliff; Amy S.V.,20,0,20,0
1739707660863,EDS 141,A00,815592,Mamas; Christoforos,34,0,35,1
1739707661892,EDS 145,A01,815629,Choi; Bailey Miyeon,13,0,15,2
1739707661892,EDS 145,A02,815630,Choi; Bailey Miyeon,15,0,15,0
1739707662917,EDS 164R,A01,815632,Staff,37,0,40,3
1739707662917,EDS 164R,B01,872639,Staff,20,0,20,0
1739707663945,EDS 165,A00,815635,Jones; Gabrielle Anastasia,29,0,30,1
1739707664971,EDS 180,A00,815642,Chapman; Thandeka K,24,0,25,1
1739707664971,EDS 180,B00,886111,Eguchi; Emi,30,0,30,0
1739707665998,EDS 190,A00,889678,Bintliff; Amy S.V.,4,0,5,1
1739707667023,EDS 205B,A00,815645,Halter; Christopher P.,48,0,50,2
1739707668048,EDS 253,A00,815646,Staff,14,0,15,1
1739707669073,EDS 266,A00,815647,Phuong; Andrew,11,0,12,1
1739707670100,EDS 282,A00,815649,Daly; Alan J.,15,0,15,0
1739707671124,EDS 287B,A00,815650,Daly; Alan J.,15,0,15,0
1739707672149,EDS 288A,A00,815651,Bjorklund; Peter,15,0,15,0
1739707673173,EDS 288B,A00,815694,Chapman; Thandeka K,19,0,20,1
1739707674198,EDS 288C,A00,815695,Staff,15,0,15,0
1739707675227,EDS 289B,A01,815710,Daly; Alan J.,15,0,15,0
1739707676252,EDS 290,A00,815711,Millstone; Rachel Diana,20,0,20,0
1739707676252,EDS 290,B00,815712,Heinzman; Erica M.,20,0,20,0
1739707676252,EDS 290,C00,815717,Choi; Bailey Miyeon,21,0,21,0
1739707676252,EDS 290,D00,815727,Black; Alison Michelle,20,0,20,0
